техника:  технику
справка:  справка
неоднократно:  неоднократно
вздыхать:  вздыхает
производный:  производные производная производной производную
предел:  предел пределы пределов пределом предела пределу пределах
небольшой:  небольшой небольшая
наполнять:  наполнять
остаться:  оставшимися осталось
чёткий:  чёткий
числовой:  числовые числовой
производныенеявно:  производныенеявно
значение:  значение значению значений значения
непрерывный:  непрерывной непрерывных непрерывная непрерывны непрерывную непрерывна
бояться:  боятся
контрольный:  контрольных
чертить:  чертим
разрыв:  разрыв разрывов разрыва разрывы разрывом
формула:  формулы формула
смотреть:  см
лаконичный:  лаконичнее
игрек:  игрека игреков игреки
остроумно:  остроумно
прийтись:  придётся
канонический:  каноническому
два:  две двух
свой:  своём своё своей свои
дифференциал:  дифференциалах дифференциала
больший:  наибольшее большие
многие:  многие
один:  одну одно одна одной
любой:  любому любая
зелёный:  зеленый зелёной зелёная зелёным
проводиться:  проводится проводятся
оформление:  оформлением оформления
сам:  самого самом саму сама самому самой
стрелка:  стрелка стрелке
число:  число числами числу чисел числа
вогнутостья:  вогнутостьи
особенность:  особенность особенности
случай:  случай случаи случая случаев случае
профессия:  профессию
условие:  условии условие условиях условий условия условию
умножение:  умножения
система:  система системе систему системы
выполнимый:  выполним
группировка:  группировок группировка
богатый:  богата
условнаясходимость:  условнаясходимость
элементарный:  элементарном элементарных элементарная
александр:  александр
ось:  ось оси
ничуть:  ничуть
баранов:  баранов
сказать:  скажете сказать
существование:  существование
который:  которые которому который которая которое которых которой
линейный:  линейные линейная линейных линейной
вниз:  вниз
работа:  работ работы работа
равенство:  равенство
пожарный:  пожарный
согласие:  согласия
криминал:  криминала
дуоперационный:  дуоперационным
базис:  базисах базису базис
оговорка:  оговорка
наиболее:  наиболее
кусочный:  кусочная кусочную кусочном кусочной кусочным
идти:  идти идет
зависимостьвектор:  зависимостьвекторов
экспонент:  экспонента
справиться:  справиться
снова:  снова
сначала:  сначала
метод:  методы методом метод
правосторонний:  правосторонний
страница:  страницу
числитель:  числителе
математический:  математическая математического математические математическим математической
данные:  данных
интеграл:  интеграл интегралов интегралы интеграла интеграле
урок:  урока урок уроке
разложение:  разложением разложение
доводиться:  доводится
подвергнуться:  подвергнется
конечный:  конечен конечное конечны конечные конечному
типовой:  типовой
попадать:  попадает
синус:  синус
икс:  икс икса
кусок:  кусок кусками кусков куска
уравнение:  уравнению уравнения уравнение уравнением уравнений
переход:  переход
нетерпение:  нетерпением
совпадать:  совпадают
продемонстрировать:  продемонстрировать
желательно:  желательно
очередь:  очередь
первый:  первое первой первом первого первый первые
цвет:  цветом цвет
практический:  практических практическую
целесообразно:  целесообразно
вертикальный:  вертикальными вертикальной
малый:  малые малых малое наименьших
связь:  связь
молодожён:  молодожёнов
подкрасться:  подкрался
точка:  точку точки точкой точках точка точками точек точке
грустный:  грустный
текст:  тексту
выглядеть:  выглядят выглядит
множество:  множестве множества
односторонний:  односторонних односторонний односторонние одностороннего
сомнение:  сомнения
простой:  простая простых простой простым
нормальный:  нормальное
кончаться:  кончается
интегральнаятеорема:  интегральнаятеоремы
корнимногочлен:  корнимногочлена
логарифмический:  логарифмическая
начать:  начнём начать
гипербола:  гиперболы гипербола
основной:  основные
бернулли:  бернулли
модуль:  модулями модуля модулем модуль
единица:  единицу единице единица единицы единиц
полярный:  полярные полярных полярной
положительный:  положительное
рассмотреть:  рассмотрим
ряд:  ряды ряда ряд ряде рядов
уровень:  уровня уровнем
факультативный:  факультативное
вычисляться:  вычисляется
доверительный:  доверительные
формулировать:  формулировать
среднееквадратический:  среднееквадратическое
момент:  моменте моменту
тип:  типа
тривиальный:  тривиальный
комбинационный:  комбинационная
обращаться:  обращается
суметь:  сумеет
выколоть:  выколите выколота
смешанноепроизведение:  смешанноепроизведение
функция:  функции функция функций функцию функциях
дисперсия:  дисперсия дисперсии дисперсию
постараться:  постарайтесь
школьный:  школьный
мы:  нам
образ:  образом
непрерывнаяслучайный:  непрерывнаяслучайная
четыре:  четыре
ибо:  ибо
прямо:  прямо
длина:  длина
материал:  материал материала материалов материалы
посмотреть:  посмотреть посмотрим
немного:  немного
мочь:  могут можем
знакопостоянство:  знакопостоянства
доопределить:  доопределить
интервал:  интервале интервала интервалах интервалы интервал
градиент:  градиент
догадаться:  догадались
линия:  линия линии линиями
вспомнить:  вспомним
бесконечный:  бесконечном бесконечен бесконечный бесконечны
наш:  наших нашем наш нашу нашей нашими наша
тонкость:  тонкости
комбинаторика:  комбинаторике
случайнаявеличина:  случайнаявеличина
бесконечно:  бесконечно
давать:  даёт давайте
прийти:  придут
встречаться:  встречался встречалось
форма:  формы
равный:  равны равен равный равна
задача:  задачу задаче задачей задачи задач
статья:  статьи статье статью
методичка:  методичке
жирно:  жирно
обратный:  обратную обратная
график:  графиком графиках графиков график
третий:  третий
готовый:  готовых готово
просто:  просто
получить:  получены получи
приём:  приём приёмы приёме
ещё:  ещё
обычный:  обычная обычный
часть:  частей частям части
быть:  буду будут будем
нарушить:  нарушено
любимый:  любимыми
частый:  чаще
картинка:  картинка
разнообразный:  разнообразным
подобный:  подобных
данный:  данного данном данный
убирать:  убираем
производныефункция:  производныефункции
средний:  средняя
область:  области область
плюс:  плюс
далеко:  далеко
математик:  математика
переменный:  переменных переменной
пример:  пример примеров примере примерами примерах примеры
др:  др
уныло:  уныло
разность:  разность
несовместный:  несовместные
строгий:  строгим
независимыеслучайный:  независимыеслучайные
вверх:  вверх
никакой:  никакого
следовательно:  следовательно
модель:  модель модели
непрерывность:  непрерывность непрерывности непрерывностью
минус:  минус
навевать:  навевают
допускаться:  допускается
функциис:  функциис
полный:  полной полным полных полный полное полного
зеркало:  зеркало
второй:  втором второго второй
читатель:  читатели читателям
значит:  значит
исходный:  исходная
пирсон:  пирсона
некоторый:  некоторую некоторых некоторое
вопрос:  вопрос вопросы
аналогичный:  аналогичные
межгрупповой:  межгрупповая
ортогональный:  ортогональное
нсв:  нсв
почерпнуть:  почерпнуть
вроде:  вроде
упасть:  упал
биография:  биографии
отрезка:  отрезке
красный:  красный красная
нехороший:  нехорошим нехорошие
величина:  величина величин величины
решение:  решению решение решением решения решений
оставаться:  остаются остаётся
внимательно:  внимательно
запись:  запись записью
задумка:  задумке
жирный:  жирную
фишка:  фишек
карандаш:  карандашом карандаша карандаш
методика:  методике
парабола:  параболе параболы парабола
самый:  самая самое
детерминация:  детерминации
сторона:  стороны
обязательно:  обязательно
отрицательный:  отрицательное отрицательной
выполнить:  выполнить выполнены выполнено
дифференциальныеуравнение:  дифференциальныеуравнения
анализ:  анализу анализа анализ
название:  названия название
прямой:  прямая прямой прямые прямую
будничный:  будничную
постоянный:  постоянных
стокс:  стокса
схема:  схема схеме
предполагать:  предполагает
ручной:  ручной
самостоятельно:  самостоятельно
жизнь:  жизнь жизни
уместный:  уместнее
заключительный:  заключительных
дробовик:  дробовик
пункт:  пунктам пункты
математика:  математике математики
векторный:  векторное векторного
ваш:  ваши
вероятностия:  вероятностии
скалярный:  скалярное
совершенно:  совершенно
значимость:  значимости
отрывать:  отрывая
строить:  строить
дать:  дана данному данная данные данной
построение:  построения построение построению
её:  её
ворваться:  ворвавшиеся
частный:  частное частные
парный:  парной
перечислять:  перечислять
оптимистичный:  оптимистичны оптимистичного
примерный:  примерный
несколько:  несколько
найти:  найдём найти найдите
сборник:  сборники
пренебрежение:  пренебрежение
параметрический:  параметрическом параметрической
практика:  практика практике
распространить:  распространённой распространённую
часто:  часто
законспектировать:  законспектировать
первоначальный:  первоначальной
получаться:  получается
хороший:  хороший хорошим
надеяться:  надеюсь
другой:  другая другое другие
кадр:  кадр
форум:  форум форуме
увлекательный:  увлекательная
книга:  книги книга
интуитивно:  интуитивно
провести:  провести
рекомендовать:  рекомендовал рекомендую
заходить:  заходим
пунктир:  пунктир
задание:  задание задания
вектор:  векторы векторов
действовать:  действующими
вращение:  вращения
упрощение:  упрощение
именно:  именно
сообразить:  сообразишь
копирование:  копирование
выражение:  выражения выражение
вещь:  вещей
противоположный:  противоположные
роль:  роль роли
отблагодарить:  отблагодарить
являться:  являются является
поверхностный:  поверхностный поверхностные
байес:  байеса
выгодно:  выгодно
решать:  решать
делить:  делённое делённая
минута:  минуты
триллер:  триллер
отличать:  отличать
теория:  теория теорию теории
схематический:  схематический схематического
дополнительно:  дополнительно
называть:  называют
асимптота:  асимптотами асимптоте асимптоты асимптотой
константа:  константе константы
двумерный:  двумерная
устранимый:  устранимым устранимый устраним
послабление:  послабление
задать:  заданной задайте
популярный:  популярной
тело:  тела
циркуляция:  циркуляция
слева:  слева
тяжёлый:  тяжёлом
ветка:  ветка ветки ветке
плоскость:  плоскости плоскость
коснуться:  коснулись
формальный:  формальную
общий:  общим общая общий общем
странно:  странно
поздний:  позже
определителяй:  определителяи
итог:  итогу
заставить:  заставить
закон:  законы
справа:  справа
дробь:  дроби дробей
впечатление:  впечатление
догадываться:  догадываются
ситуация:  ситуацию ситуация
вероятность:  вероятностей вероятность вероятности
уравненийв:  уравненийв
отрезок:  отрезок
рвануть:  рванул
грин:  грина
суть:  сути
несложный:  несложные
эйлер:  эйлера
уделить:  уделим
возможный:  возможный
символизировать:  символизирует
геометрический:  геометрический геометрические геометрическими геометрическая геометрическое
качаться:  качается
каждый:  каждого каждой каждая
остальной:  остальные остального
дискретный:  дискретный
знакочередоваться:  знакочередующиеся
рассказать:  рассказать
бесконечность:  бесконечности бесконечность
голова:  голову
произвольный:  произвольных
сложный:  сложной сложного сложные сложных
рубеж:  рубеж
фурье:  фурье
поле:  поля
гипотеза:  гипотез гипотеза гипотезы
свойство:  свойства свойство
содержание:  содержанием
исследование:  исследование исследования
вариант:  варианте
свериться:  сверьтесь
семилетний:  семилетней
вариация:  вариации
основа:  основы основе
изобразить:  изображён изобразить изобразим
кош:  коши
раскопать:  раскопаю
выше:  выше
нарисовать:  нарисовать
упоминаться:  упоминалось
чайник:  чайников чайник
соответствующий:  соответствующих соответствующие
чистовой:  чистовым
вычисленияс:  вычисленияс
матричный:  матричные матричных матричный
проверка:  проверке проверку проверка
заметить:  заметили заметьте
качественный:  качественного качественным
перенести:  перенести
однородный:  однородные однородным
вычислить:  вычислить
очень:  очень
фон:  фоне
матрица:  матрицу матрицы матрицами
этап:  этапе
испытанияй:  испытанияи
интегралыть:  интегралыв
перегруппировка:  перегруппировка
пойти:  пойдёт
помощь:  помощью
вариационный:  вариационный
сокращение:  сокращение
страничка:  страничек
стандартно:  стандартно
исключение:  исключением
чистовик:  чистовик
блог:  блог
высокий:  высших высшей высшая
формулироваться:  формулируется
пространство:  пространстве
удобный:  удобный
курс:  курс
упад:  упаду
координата:  координаты координат координатах
ордината:  ординат
помогать:  помогают
сообщить:  сообщите
сделать:  сделать сделан
аналитический:  аналитическая аналитической
понижение:  понижение понижением
окрестность:  окрестностей
определить:  определить определено определена
финальный:  финальный
левый:  левой левый левого
центр:  центр
терпеть:  терпит
преобразование:  преобразованиях преобразования преобразованиями преобразований
считаться:  считается
реальность:  реальность
новизна:  новизна
просьба:  просьбам
линейнойкорреляционный:  линейнойкорреляционной
синий:  синяя синий
действие:  действия
время:  время времени
существующий:  существующим
сила:  силу силы
почему:  почему
распределениякритерия:  распределениякритерий
квадратичный:  квадратичной квадратичные
хотеть:  хотел
читаться:  читается
уберечь:  убережёт
аргумент:  аргумента
предстоять:  предстоит
поточечный:  поточечному поточечное
несобственный:  несобственные
выполнять:  выполнять
касательная:  касательная
ответ:  ответ ответы
задачис:  задачис
правило:  правила правило
функциия:  функциии
возможно:  возможно
степенной:  степенного степенные
завершать:  завершающем
функцийдвуха:  функцийдвух
выборка:  выборке
соответствовать:  соответствовать
функцийнесколький:  функцийнескольких
подготовка:  подготовки
показатель:  показателя показатели
любить:  любят
человек:  человека
положительно:  положительно
множественнойлинейный:  множественнойлинейной
потребоваться:  потребуются потребовалось
детализироваться:  детализируется
тема:  темы
распределение:  распределение распределения
забывать:  забываем забывая
скороговорка:  скороговорка
задачипо:  задачипо
прицел:  прицел
востребовать:  востребованную
термин:  термин
особенный:  особенными
приблизить:  приближенные
знак:  знаку знак
изучить:  изучить
брат:  брат
образец:  образец
примечание:  примечание
выкладка:  выкладки выкладками
зависимый:  зависимые
отклонение:  отклонение
освоить:  освоим
таблица:  таблицы
произведение:  произведение
вполне:  вполне
случайный:  случайных случайные
дуга:  дуги
частность:  частности
отрезкать:  отрезкав
играть:  играет
дивергенция:  дивергенция
чертёж:  чертежа чертёж чертеже
спасибо:  спасибо
уничтожать:  уничтожает уничтожаем
характерный:  характерные
сайт:  сайт сайты сайта
графика:  графики графика
думать:  думал думают думаю
подробный:  подробнее подробную
точный:  точная точный
эпсилон:  эпсилон
возрастание:  возрастание
эмпирический:  эмпирические
найтись:  нашлось
аналогично:  аналогично
указать:  указать
иррациональный:  иррациональных
определение:  определению определение определения
квадратичнуюформ:  квадратичнуюформу
карта:  карта
косинус:  косинус
вычисление:  вычисления вычисление
начертить:  начертить
они:  ними
справедливый:  справедливыми
род:  родом рода
закомментировать:  закомментировал
право:  право
логика:  логики
спирмена:  спирмена
следующий:  следующим следующих следующая следующем
вид:  виду виды виде вида
оказаться:  оказалось
возникать:  возникает
завершить:  завершить
близко:  близко
лишь:  лишь
св:  св
оформиться:  оформится
иметь:  имеет имею имеете
достаточно:  достаточно
показательный:  показательное
фамилия:  фамилии
технический:  технические
противоречить:  противоречит
учиться:  учащихся учимся
диффура:  диффурами
относиться:  относится
этот:  эта
перейти:  перейдём
подразумевать:  подразумевает
выговорить:  выговорить
сообщать:  сообщает
статистика:  статистика
лицо:  лицами
подставлять:  подставляем
оранжевый:  оранжевая
биномиальный:  биномиальное
пренебрегать:  пренебрегать
линиюв:  линиюв
шутка:  шутки
расписаться:  расписаться
неотрицательный:  неотрицателен
самостоятельный:  самостоятельного самостоятельных
отношение:  отношении
хотеться:  хочется
обязательный:  обязательна
везде:  везде
смысл:  смысл смыслом
чёрный:  чёрный чёрную
классифицировать:  классифицировать
решить:  решить
дуприближённо:  дуприближённо
левосторонний:  левосторонний левостороннего
событие:  события
повторный:  повторные
различный:  различны различных
учитывать:  учитывая
состоять:  состоит
преобразовать:  преобразуем
нижеследующий:  нижеследующий
фнп:  фнп
простейшее:  простейшие
конец:  конце
двойной:  двойные двойной
встреча:  встреч
несобство:  несобств
бумага:  бумаги
нелинейный:  нелинейная
означать:  означают
преобразованиеквадратичный:  преобразованиеквадратичной
функциональный:  функциональные
участок:  участок
абсолютный:  абсолютная
строй:  строю
тот:  тому той
сложенияй:  сложенияи
раскрывать:  раскрываем
регрессия:  регрессии регрессия
взять:  возьмите взять взятая
требовать:  требуют
раскрываться:  раскрывается
исчисление:  исчисления
оторвать:  оторвать
близнец:  близнец
локальный:  локальная
ожидание:  ожидание
лаплас:  лапласа
такой:  таким такие такое такого такая таких
перегиб:  перегиба
предыдущий:  предыдущем предыдущему
сходимость:  сходимости сходимость
ход:  ходу
ду:  ду
далее:  далее
коэффициент:  коэффициент
неопределённый:  неопределенный неопределенном
собственный:  собственные
близкий:  ближайший
признак:  признак признаки
действительный:  действительных
поэтому:  поэтому
вместо:  вместо
подряд:  подряд
принцип:  принципе
неравенство:  неравенство неравенства
малиновый:  малиновая
исследовать:  исследуем исследовать
коль:  коль
асимметрия:  асимметрия
грусть:  грусть
главный:  главную
сводиться:  сводящиеся
замена:  замены
характер:  характер
результат:  результате
например:  например
решенияопределённый:  решенияопределенных
интересовать:  интересовать
задаваться:  задаётся
письмо:  письма
хотя:  хотя
классификация:  классификация классификацию
фихтенгольц:  фихтенгольц
тангенс:  тангенса
коэффициентковариация:  коэффициентковариации
конкретный:  конкретными
пройти:  пройден пройдёт
процент:  процентах
накатать:  накатанной
обозначать:  обозначает
перечисленный:  перечисленные
абсцисса:  абсцисс
лопиталя:  лопиталя
называться:  называется
матана:  матана
обычно:  обычно
ставить:  ставим
поляформула:  поляформула
фехнера:  фехнера
напрашиваться:  напрашивающаяся
эффективный:  эффективные
независимо:  независимо
условный:  условные
эллипс:  эллипс
ноль:  ноль
минимальный:  минимального
поговорить:  поговорим
сократить:  сократить
кирпичик:  кирпичиком
версия:  версии
представлять:  представляете
даламбер:  даламбера
теорема:  теоремы
факт:  факт
двойка:  двойка
повторнойя:  повторнойи
естественно:  естественно
комплексный:  комплексные комплексного комплексный комплексными
скобка:  скобки
ранг:  ранг
кривая:  кривой
тяжестиплоска:  тяжестиплоской
ненавистник:  ненавистники
подразделяться:  подразделяются
преподаватель:  преподаватель
носить:  носит
построить:  построить
прыгнуть:  прыгнула
максимальный:  максимального
внимание:  внимание
лейбниц:  лейбница
встретиться:  встретится
поток:  поток
ехать:  едем
представить:  представили
реальный:  реальных
медиана:  медиана
фиксироваться:  фиксируется
бывать:  бывает
направлениюй:  направлениюи
единственный:  единственное единственная
гостевой:  гостевая
многочлен:  многочлены
скоро:  скоро
переписать:  перепишем
кроме:  кроме
аккуратно:  аккуратно
добрый:  доброго
основание:  основание
говорить:  говорить говоря
понятно:  понятно
вывод:  вывод
внутригрупповаяй:  внутригрупповаяи
алгебра:  алгебры
сумма:  сумму сумма
выделять:  выделяют
наоборот:  наоборот
пониматься:  понимается
существовать:  существует существовать существуют
остановиться:  остановлюсь остановился
прямоугольник:  прямоугольников
добавка:  добавка
эксцессэмпирический:  эксцессэмпирического
десятка:  десятки
оценка:  оценка оценки
криволинейный:  криволинейные
библиотека:  библиотека
фото:  фото
наименьшеезначение:  наименьшеезначения
вычислимый:  вычислим
системылинейный:  системылинейных
нужно:  нужно
смело:  смело
последствие:  последствий
зависимость:  зависимость
увидеть:  увидели увидеть
интересный:  интересного интересных
категория:  категории
математически:  математически
пять:  пять
замкнутый:  замкнутому
должный:  должен должно должна
очевидный:  очевидно очевидны
терять:  теряет
забивать:  забивать
важный:  важных
автоматизм:  автоматизма
площадьс:  площадьс
пошутить:  пошутить
большинство:  большинстве
рутинный:  рутинной
убыванией:  убываниеи
шаблон:  шаблоны
повышенный:  повышенной
статистический:  статистическая статистические
также:  также
интегрирование:  интегрирование
ничто:  ничему
рациональный:  рациональные
пока:  пока
нуль:  нулю нуля
интервальный:  интервальный
скачок:  скачком скачок
вообще:  вообще
принадлежать:  принадлежит
оценкия:  оценкии
неявный:  неявной
несобственныхинтеграл:  несобственныхинтегралов
вероятностибиномиальный:  вероятностибиномиального
обывательский:  обывательский
гаусс:  гаусса
хитро:  хитро
параграф:  параграфе
скорый:  скорых
экстремальный:  экстремальные
склеить:  склеить
повтор:  повтором
нормаль:  нормали
бычок:  бычок
определитель:  определитель
выпуклость:  выпуклость
элемент:  элементы
знаменатель:  знаменатель знаменателе
сложность:  сложности
значенияй:  значенияи
нужный:  нужной
редкий:  редка
кстати:  кстати
дельта:  дельта
классическоеопределение:  классическоеопределение
инормаль:  инормаль
тетрадь:  тетради
точность:  точность
далёкий:  дальше
пирамида:  пирамида
помнить:  помните
информация:  информацию
автор:  автор автора
делимый:  делим
дифференциальный:  дифференциальные
уравненияс:  уравненияс
онлайн:  онлайн
разобрать:  разберём
геометрия:  геометрии геометрия
затруднение:  затруднений
фрагмент:  фрагмент
новый:  новому
произвольныйтройный:  произвольныйтройной
дизайн:  дизайна
это:  это
прога:  проги
вечный:  вечного
малопонятный:  малопонятно
подставить:  подставьте подставить
поляй:  поляи
опечатка:  опечатку
поиск:  поиску
способ:  способом
решающий:  решающую
речь:  речь
стараться:  стараюсь
методомоперационный:  методомоперационного
бесповторный:  бесповторной
правильно:  правильно
ошибка:  ошибку ошибок
л:  л
помочь:  поможет
степень:  степени
несложно:  несложно
секунда:  секунд
касательный:  касательных
относить:  относят
большой:  большой
типовыхзадача:  типовыхзадач
ранговойкорреляция:  ранговойкорреляции
критерий:  критерий
отдельно:  отдельно
полезный:  полезном
полуинтервал:  полуинтервалах полуинтервале
давность:  давности
разделаться:  разделаемся
подходить:  подходим
наказывать:  наказывают
поверхность:  поверхности
линейныйкоэффициент:  линейныйкоэффициент
нахождение:  нахождении
несобственныйинтеграл:  несобственныйинтеграл
отмечаться:  отмечаться отмечалось
доступно:  доступно
понятие:  понятия понятие
логично:  логично
задавать:  задаваемые
ветвь:  ветви
ипример:  ипримеры
требоваться:  требуется требовался
правый:  правого
наглядный:  нагляден
причём:  причем
фигура:  фигуры
пуассон:  пуассона
однако:  однако
осмыслить:  осмыслить
математическоеожидание:  математическоеожидание
надуманный:  надуманный
школа:  школа
напомнить:  напомню
неоднородный:  неоднородные
необходимо:  необходимо
проверять:  проверяем
пристальный:  пристальное
прибегнуть:  прибегнуть
устранить:  устранён
оформить:  оформить
спрашивать:  спрашивали
кратное:  кратные
системудифференциальный:  системудифференциальных
тон:  тоном
каков:  каков
уметь:  уметь
слово:  слова
последовательность:  последовательностей
стык:  стыка
попадаться:  попадаются
объём:  объем
стремиться:  стремится
проверить:  проверить
усвоение:  усвоения
поточный:  поточнее
поскольку:  поскольку
гипергеометрическоераспределение:  гипергеометрическоераспределение
оба:  обоих оба
перспектива:  перспективы
обратить:  обратите
сложно:  сложно
подробно:  подробно
равномерный:  равномерная равномерное
треугольный:  треугольная
использовать:  используйте
пожалуйста:  пожалуйста
следовать:  следует
квадрат:  квадратов
пробивать:  пробивать
сразу:  сразу
функциюкомплексный:  функциюкомплексной
напоминать:  напоминаю
лишний:  лишней
мода:  мода
свойстваэлементарный:  свойстваэлементарных
выплывать:  выплывает
низкий:  низким
краткий:  краткое
стандартный:  стандартной
калькулятор:  калькулятор
научиться:  научиться
происходить:  происходит
всякий:  всякими всякий
любопытно:  любопытно
приближаться:  приближаться приближается
раскрытие:  раскрытия
определённый:  определенный определенного
тренировка:  тренировки
действительно:  действительно
экстремум:  экстремумы
горнера:  горнера
альфа:  альфа
функцийв:  функцийв
ознакомиться:  ознакомиться
уловить:  уловить
довольно:  довольно
вычесть:  вычесть
незамедлительно:  незамедлительно
понимать:  понимать
три:  трёх
дискретнойслучайный:  дискретнойслучайной
ждать:  ждали
счастливый:  счастливы
сложиться:  сложиться
соответствие:  соответствии
последний:  последних
буквально:  буквально
крамер:  крамера
основный:  основных
тройка:  тройки
обращать:  обращает
начало:  начале
установить:  установим
правда:  правда
вразумительный:  вразумителен
общепринятый:  общепринят
поставить:  поставленный
функциидвуха:  функциидвух
запретить:  запрещено
черновик:  черновике черновика
емелин:  емелин
вычисленияопределенный:  вычисленияопределенных
проследить:  проследить
задачин:  задачина
замечательный:  замечательные
системый:  системыи
удовлетворяетлить:  удовлетворяетли
аккорд:  аккорд
ох:  ох
тригонометрический:  тригонометрических
знать:  знать
аналитически:  аналитически
чётко:  чётко
переносить:  переносим
заданав:  заданав
стыковой:  стыковых
огонь:  огня
порядок:  порядка порядков
что:  чём
всё:  всё
убивать:  убиваем
лекция:  лекции
тройной:  тройные
деление:  деления
контуруформула:  контуруформула
иной:  иной
дело:  деле
ка:  ка
незаметно:  незаметно
элементарно:  элементарно
независимый:  независимые
основополагающий:  основополагающим
подход:  подход
привести:  привести
весь:  всей
группа:  группы
студент:  студенты
корреляция:  корреляции
доска:  доска
прорисовать:  прорисован
заочник:  заочников
максимально:  максимально
повторять:  повторяем
