вспоминаться:  вспоминаться
скобка:  скобками скобку скобок скобки скобках
раскрывать:  раскрывать раскрываем
переписать:  перепишите перепишем
третий:  третьим третий
последний:  последнюю последнем
нечётность:  нечётность нечётности
верхний:  верхнего верхний
профессорский:  профессорский
неоднократно:  неоднократно
производный:  производные производная производной производную
предел:  предел пределы пределов
ввиду:  ввиду
вуалироваться:  вуалируется
числовой:  числовые числового числовая
путаться:  путаемся
точнее:  точнее
производныенеявно:  производныенеявно
значение:  значение значениям значению значений значения значении
разрыв:  разрыв разрыва разрывы разрывом
чертить:  чертим
дальнейший:  дальнейшем дальнейшие дальнейших
формула:  формулы формулой формулам формула формул формулу
найдить:  найдённые
смотреть:  см
читатель:  читатель читателей
произвольный:  произвольном произвольного произвольных произвольное
отрицательный:  отрицательный отрицательных
прийтись:  придётся пришлось
канонический:  каноническому
поймать:  поймал
поддаваться:  поддаются
отрезок:  отрезку отрезок отрезками отрезка
два:  две двум двух
дифференциал:  дифференциалах дифференциала
слиться:  сольётся
больший:  наибольшее большие большими больших большем
нередко:  нередко
называть:  называемые называют
различный:  различные различных
подробный:  подробные
проводиться:  проводится
избавляться:  избавляемся
правый:  правая правой правую правый
луна:  луны
сторонка:  сторонке
число:  число числами числа
вогнутостья:  вогнутостьи
кусок:  куском кусок куску куске кусков куска
многий:  многих
экипаж:  экипажа
формулировка:  формулировки формулировке формулировкой
период:  период периодах периоде периодом периоды периода периодов
убедиться:  убедиться
профессия:  профессию
участвовать:  участвует
вуз:  вуза
удобно:  удобно
умножение:  умножения
предмет:  предмет
система:  система системе систему системы
группировка:  группировок группировка
познакомиться:  познакомимся
условнаясходимость:  условнаясходимость
александр:  александр
ось:  ось оси
зря:  зря
термин:  термины термина
многочисленный:  многочисленные
который:  которые которому который которая которое которую которого которых которой
редко:  редко
линейный:  линейные линейная линейных линейной
работа:  работ работы работа
коэффициент:  коэффициентов коэффициентом коэффициент коэффициенты коэффициента
упрощаться:  упрощается упрощаются
изолировать:  изолированным изолированному
равенство:  равенство равенства
частичный:  частичная частичную частичной
запись:  записи
согласие:  согласия
опыт:  опыт опыта
нечётный:  нечётных нечётные нечётная нечётными нечётным нечётной
дуоперационный:  дуоперационным
прошивать:  прошивает
базис:  базисах базису базис
бохан:  бохана
технический:  техническая технического технических
зависимостьвектор:  зависимостьвекторов
снова:  снова
справиться:  справиться
оно:  оно
периодичный:  периодична
сначала:  сначала
некоторый:  некоторый некоторую некоторых некоторые
метод:  методы методом метод
правосторонний:  правосторонний
тема:  теме тему
страница:  страницу страницы странице
математический:  математическая математического математическому математические математической
данные:  данных
непростой:  непростой
интеграл:  интеграл интегралов интегралах интегралы интеграла интегралом интеграле
урок:  урока уроке
похожий:  похожее
разложение:  разложением разложениях разложении разложение разложения разложению
косинус:  косинусы косинусам косинус косинуса косинусов
друг:  друга друг другом
типовой:  типовой
синус:  синус синусы синуса синусов синусам
икс:  икс
сумма:  суммой суммы сумме сумму сумма
уравнение:  уравнению уравнения уравнение уравнений
переход:  переход
подойти:  подойти подошёл
симметрично:  симметрично
получиться:  получилось
симметрия:  симметрии
раздел:  разделов
примелькаться:  примелькавшихся
существо:  существу
заметка:  заметку
желательно:  желательно
очередь:  очередь
цвет:  цветом
практический:  практических практическим практический практическими практические практического
целесообразно:  целесообразно
малопонятный:  малопонятны
малый:  малые малое наименьших
связь:  связь
точка:  точку точки точках точкам точек точке
обвивать:  обвивает
нормальный:  нормальное
делаться:  делается
интегральнаятеорема:  интегральнаятеоремы
корнимногочлен:  корнимногочлена
логарифмический:  логарифмическая
отряд:  отряд
умалчивать:  умалчивает
условие:  условие условию
прикрепить:  прикреплю
рад:  рад
начать:  начнём начать
сведение:  сведения
основной:  основные
функция:  функцией функции функция функций функциям функцию функциями
бернулли:  бернулли
нужный:  нужен нужной нужное
полярный:  полярные полярных полярной
положительный:  положительное положительному
рассмотреть:  рассмотрим рассмотрите рассмотренное рассмотреть
средний:  средней средняя среднее
ряд:  ряды ряда ряд рядах ряде рядов
уровень:  уровня
поднадоесть:  поднадоели
должный:  должны должно
применение:  применением применения
удачный:  удачного
доверительный:  доверительные
форма:  форме формы
мысль:  мыслей мысли
среднееквадратический:  среднееквадратическое
наказать:  наказать
решение:  решениями решение решением решения решений
комбинационный:  комбинационная
папка:  папка
смешанноепроизведение:  смешанноепроизведение
проясниться:  прояснился
сподручный:  сподручнее
дисперсия:  дисперсия дисперсии дисперсию
проверка:  проверки проверке проверку проверка
постараться:  постарайтесь
знакомый:  знакомого
школьный:  школьный
мы:  нам
образ:  образом
непрерывнаяслучайный:  непрерывнаяслучайная
другой:  других другие
четыре:  четыре
прямо:  прямо
длина:  длина
материал:  материал материалов материалы материалам
немного:  немного
мочь:  могут
знакопостоянство:  знакопостоянства
алгоритм:  алгоритму алгоритм
проводить:  проводить проводим
растиражировать:  растиражировать
интервал:  интервале интервала интервалах интервалы интервал
неплохо:  неплохо
градиент:  градиент
линия:  линия линии линиями
повторяться:  повторяется повторяться
внимание:  внимания внимание
бесплатно:  бесплатно
комбинаторика:  комбинаторике
случайнаявеличина:  случайнаявеличина
мой:  моих моей
бесконечно:  бесконечно
уделять:  уделяем
желать:  желающих желающие
задача:  задачу задаче задачей задачи задач задачах задача
знание:  знания
отметить:  отметить
статья:  статьи статью
центральный:  центральном центрального центральный
обратный:  обратную обратная
дополнительный:  дополнительные дополнительным дополнительную
готовый:  готовых готовые готово
конкретный:  конкретном
просто:  просто
приём:  приём
ещё:  ещё
вернуться:  вернёмся
включить:  включил
размножить:  размножить
порядок:  порядком порядок порядка порядков
свой:  своих своё своей
быть:  буду
отличаться:  отличается отличаются
зелёный:  зелёный зелёная зелёного зелёным
запас:  запасов
сходиться:  сходится сходятся
данный:  данного данном данное данный
непрерывный:  непрерывных непрерывный непрерывная непрерывна
тригонометрический:  тригонометрический тригонометрические тригонометрическим тригонометрических тригонометрического
производныефункция:  производныефункции
припоминать:  припоминаю
порассуждать:  порассуждаем
знак:  знаком знаках знак
обязать:  обязан
область:  области область
извлечь:  извлечь
далеко:  далеко
предположим:  предположим
математик:  математика
переменный:  переменных переменной переменная
пример:  пример примера примеров примерам примере примерах примеры
др:  др
упрощение:  упрощения
посмотреть:  посмотрим
раскладывать:  раскладывать раскладывали раскладываем
несовместный:  несовместные
вынести:  вынесена
половина:  половины
независимыеслучайный:  независимыеслучайные
выполнение:  выполнения выполнением
ответ:  ответа ответ ответы
искать:  ищем
модель:  модель модели моделью
непрерывность:  непрерывность
минус:  минус
содержать:  содержит
функциис:  функциис
право:  правом
полный:  полной полных полную полное полная
зеркало:  зеркало
значит:  значит
исходный:  исходная исходным исходной исходную
пирсон:  пирсона
реальный:  реальной
вопрос:  вопрос вопроса вопросами вопросы
межгрупповой:  межгрупповая
ортогональный:  ортогональное
чёрный:  чёрным чёрная чёрный
назвать:  названный назвать
ровнёхонький:  ровнёхонько
нсв:  нсв
вглядываться:  вглядываемся
стать:  стал стать
промежуточный:  промежуточных промежуточной
открывать:  открываем
вроде:  вроде
упасть:  упал
ход:  ходе
рассчитываться:  рассчитываются
отрезка:  отрезке
красный:  красный красные красным красными красной
остаться:  оставшихся
стержень:  стержень
величина:  величина величин величины
крайний:  крайней крайнее крайнюю
раздражитель:  раздражителей
поверхность:  поверхность поверхности
работать:  работал работает
интегрировать:  интегрируем интегрируемы интегрируема интегрировать
продолжение:  продолжения продолжение
детерминация:  детерминации
конечный:  конечное
двойной:  двойным двойные двойной
обязательно:  обязательно
следующий:  следующие следующее следующим следующем
трудный:  трудные труднее
важный:  важные
предполётный:  предполётные
выполнить:  выполнить
старт:  старту
дифференциальныеуравнение:  дифференциальныеуравнения
анализ:  анализу анализа анализ
усложнить:  усложнённой усложнённым
прямой:  прямая прямой прямую
подстановка:  подстановке подстановка подстановку
постоянный:  постоянных
стокс:  стокса
схема:  схема
окружающий:  окружающем
имя:  именем
самостоятельно:  самостоятельно
член:  члена член членов
дифференцирование:  дифференцирования
плющить:  плющило
дробовик:  дробовик
получить:  получен получено получена получили получи
сформулировать:  сформулирована
математика:  математике математики
векторный:  векторное векторного
сам:  самом сама само самой
вероятностия:  вероятностии
пила:  пилой
поделить:  поделить
скалярный:  скалярное
задание:  заданиях заданию задание задании задания
наш:  нашем наше наш наша
значимость:  значимости
амплитуда:  амплитуд
строить:  строить строим
очевидный:  очевидным очевидно
мысленно:  мысленно
дать:  дана данная данные данной
промежуток:  промежутках промежутки промежутке промежутка
волнение:  волнением
такой:  такую таким такие такое таких
изложить:  изложить
участие:  участия
её:  её
частный:  частное частные
парный:  парной
новый:  новые новому нового
симметричный:  симметричному симметричное
примерный:  примерный
найти:  найдём найдены найти
сборник:  сборники
войти:  вошедшие
параметрический:  параметрическом параметрической
версия:  версия
раскрыть:  раскрыть раскрыл
часто:  часто
неправильно:  неправильно
обрубка:  обрубки
надобность:  надобность
получаться:  получается получаются
способ:  способа способом
находить:  находим
далёкий:  далекие
форум:  форум форуме
записывать:  записывать записываем
книга:  книги книга
ровный:  ровный
проявлять:  проявляем проявлять
внутренний:  внутренние
чётный:  чётную чётных чётным чётная чётными чётные чётна чётной
разложить:  разложим разложить
устно:  устно
вектор:  векторы векторов
личный:  личной
вращение:  вращения
лапа:  лапы
принять:  принято
именно:  именно
копирование:  копирование
давать:  давайте даём
выражение:  выражения выражение
натуральный:  натуральном натуральные
совпадать:  совпадает
парабола:  параболы парабола
значок:  значок
отблагодарить:  отблагодарить
построить:  постройте построить построенный построим
байес:  байеса
простой:  проще простейший простой попроще
решать:  решать
результат:  результат результате
теория:  теория теорию теории
дополнительно:  дополнительно
маскировать:  маскируют
двумерный:  двумерная
коллега:  коллегу коллеги
периодический:  периодические периодическим периодических периодическая периодическую
задать:  заданной заданную задайте задана
тело:  тела
циркуляция:  циркуляция
мигалка:  мигалку мигалки
слева:  слева
слабый:  слабые
рамка:  рамки
плоскость:  плоскости плоскость
общий:  общим общая общие общий общем общую
выход:  выходом выходе
определителяй:  определителяи
выносить:  выносим
пункт:  пункты пункта пункте
выделить:  выделить выделено
закон:  законы
справа:  справа
затруднение:  затруднения
рассматривать:  рассматривая рассматриваемого рассматриваемом
соблюдать:  соблюдать
действие:  действий действия действие
упражнение:  упражнения упражнений
вероятность:  вероятностей вероятность вероятности
заняться:  заняться
любой:  любое любая любом
уравненийв:  уравненийв
соответствовать:  соответствующем
окончательный:  окончательные
грин:  грина
эйлер:  эйлера
заказ:  заказ
лад:  ладах
надевать:  надеваем
навязчивый:  навязчивых
закачать:  закачать
предложить:  предложенному предложенная
остальной:  остальные остальное
дискретный:  дискретный дискретная
знакочередоваться:  знакочередующиеся
полупериод:  полупериода полупериодом полупериод
заметно:  заметно
арифметический:  арифметическое
пожалуй:  пожалуй
упрощённо:  упрощённо
практически:  практически
объём:  объёмом объем
сложный:  сложной сложнее сложные сложных сложен
сердце:  сердца
мотив:  мотив
отнестись:  отнестись
фурье:  фурье
поле:  поля
гипотеза:  гипотез гипотеза гипотезы
свойство:  свойства
момент:  момент
исследование:  исследование исследования
корабль:  корабля
весь:  всем всём
проблема:  проблем
вариация:  вариации
основа:  основы
слишком:  слишком
матанализ:  матанализу
кош:  коши
усугубляться:  усугубляется
чайник:  чайников чайникам
умолчать:  умолчать
вычисленияс:  вычисленияс
модуль:  модуля
матричный:  матричные матричных матричный
определённый:  определённых определённом определённые определенный определенного
лишний:  лишними
заметить:  заметили заметьте
качественный:  качественного
однородный:  однородные однородным
скафандр:  скафандры
вычислить:  вычислить вычислена
обнулить:  обнулим
очень:  очень
черчение:  черчением
матрица:  матрицу матрицы матрицами
этап:  этапе
испытанияй:  испытанияи
интегралыть:  интегралыв
экземпляр:  экземпляр
перегруппировка:  перегруппировка
каждый:  каждое каждой каждый каждые
помощь:  помощью
изобразить:  изображен изобразить изобразит изображена изобразим
начало:  начало начала начале
вариационный:  вариационный
жесть:  жесть
казаться:  кажется казалось
блог:  блог
высокий:  высших высшей высшая
применяться:  применяться
пространство:  пространстве
именитый:  именитые
убавить:  убавило
удобный:  удобный удобнее
курс:  курс
начинающий:  начинающим
координата:  координаты координат координатах
ордината:  ординат ордината ординату
окончательно:  окончательно
сообщить:  сообщите
сделать:  сделать сделано сделал сделали
аналитический:  аналитическая аналитической
понижение:  понижение понижением
выражаться:  выражается
центр:  центр
принцип:  принципы
автомат:  автомате
видеть:  видеть видите
скачок:  скачка
нахождение:  нахождение нахождении
интегрироваться:  интегрируется
терпеть:  терпит
считаться:  считается
самый:  самую самый самое
затем:  затем
построение:  построение построении
внешний:  внешних
осуществляться:  осуществляется
природа:  природе
линейнойкорреляционный:  линейнойкорреляционной
время:  время
прибор:  прибора
кой:  коих
пора:  пор пора
сила:  силу силы
почему:  почему
распределениякритерия:  распределениякритерий
хотеть:  хотел хочет
кратко:  кратко
подозрительный:  подозрительной
аргумент:  аргумента аргументом аргумент
использовать:  использован используем используя использовать используйте
несобственный:  несобственные
выполнять:  выполнять выполняем
зрение:  зрения
гелевый:  гелевый
появиться:  появилась появится
завершать:  завершаем завершающем
процесс:  процесс процессов
полностью:  полностью
касательная:  касательная
задачис:  задачис
константа:  константой константа константу
ненужный:  ненужный
курить:  курит
правило:  правила правило
функциия:  функциии
степенной:  степенного степенные
возможно:  возможно
функцийдвуха:  функцийдвух
выборка:  выборке
задаться:  задаться
использование:  использовании
входить:  входят
чётность:  чётность чётностью чётности
функцийнесколький:  функцийнескольких
прилагаться:  прилагается
учебник:  учебнику учебнике
стык:  стыках стыка
множественнойлинейный:  множественнойлинейной
откинуться:  откинувшись
потребоваться:  потребуются
добросовестно:  добросовестно
распределение:  распределение распределения
забывать:  забываем забывая
квадратный:  квадратных квадратными
задачипо:  задачипо
пополам:  пополам
сравнимый:  сравнимо
востребовать:  востребованную
приблизить:  приближенные
изучить:  изучить изучите изучим
паника:  паники
образец:  образец образцы
хотеться:  хотелось
зависимый:  зависимые
сапа:  сапой
отклонение:  отклонение
таблица:  таблицы
произведение:  произведение
знать:  знаете знали знать
внимательный:  внимательный
случайный:  случайных случайные
пропускать:  пропускать
дуга:  дуги
частность:  частности
дробь:  дробь дробей
стандартный:  стандартная стандартное
отрезкать:  отрезкав
дивергенция:  дивергенция
чертёж:  чертежа чертёж чертеже чертежами
сайт:  сайт сайты сайта
графика:  графики графика
оформление:  оформления
простор:  просторы
равный:  равным равен равна
предлагаться:  предлагается
расположить:  расположены
возрастание:  возрастание
эмпирический:  эмпирические
решить:  решённые решить
подставить:  подставим подставьте
найтись:  нашлось
этот:  этих эта
аналогично:  аналогично
вряд:  вряд
обратиться:  обратитесь
иррациональный:  иррациональных
повод:  поводу
располагаться:  располагается
определение:  определению определения
квадратичнуюформ:  квадратичнуюформу
карта:  карта
аккуратность:  аккуратность
гипербола:  гипербола
начертить:  начертить
они:  ними
понимать:  понимаю понимать
закономерный:  закономерный
логика:  логики
фраза:  фразы
спирмена:  спирмена
спектр:  спектра
вид:  виду виды вид виде
короткий:  короткая коротким
комментарий:  комментариях комментариями
возникать:  возникает
выдерживать:  выдерживая
заключить:  заключить
св:  св
второй:  второго второй вторым вторую
похожесть:  похожести
коснуться:  коснёмся
иметь:  имеет иметь
предыдущий:  предыдущих предыдущем предыдущего
пара:  пара
достаточно:  достаточно
показательный:  показательное
преобразование:  преобразования преобразований
внести:  внесли
нулевой:  нулевого нулевом нулевой
раскладываться:  раскладывается
низ:  низа
диффура:  диффурами
соответствующий:  соответствующие
узнать:  узнать
впоследствии:  впоследствии
разумный:  разумные
невесомость:  невесомости
вычисление:  вычисление вычислений
представлять:  представляет представляют
статистика:  статистика
пунктир:  пунктиром
подставлять:  подставляем
коварно:  коварно
биномиальный:  биномиальное
подводить:  подводить подводим
линиюв:  линиюв
расписать:  распишу распишем
самостоятельный:  самостоятельного
изощрённый:  изощрённых
отношение:  отношении
категорически:  категорически
космос:  космос
посетитель:  посетителей
везде:  везде
смысл:  смысл
нижний:  нижнего нижний
дуприближённо:  дуприближённо
левосторонний:  левосторонний
асимптота:  асимптоты
событие:  события
хомячок:  хомячка
повторный:  повторные
обидно:  обидно
выспаться:  выспавшимися
насущный:  насущными
учитывать:  учитывая
состоять:  состоит
панель:  панель
тетрадь:  тетрадь
фнп:  фнп
необходимый:  необходимы
выделять:  выделяем
графический:  графический
простейшее:  простейшие
конец:  конце концах концу
часть:  частям часть части
середина:  середина серединам
несобство:  несобств
настать:  настал
нелинейный:  нелинейная
применить:  применить
брать:  берём
преобразованиеквадратичный:  преобразованиеквадратичной
никто:  никому
расписываться:  расписываются
функциональный:  функциональные
привыкать:  привыкаем
участок:  участок
глаз:  глаз глазах
сто:  сто
аквариумный:  аквариумных
геометрический:  геометрическая геометрическое
абсолютный:  абсолютная
соседний:  соседние соседних
провокационный:  провокационно
встречаться:  встречаются встречались
особый:  особый особое
сложенияй:  сложенияи
регрессия:  регрессии регрессия
взять:  возьмите взять
уважаемый:  уважаемый
пошаговый:  пошагово
оказываться:  оказываются
требовать:  требуют требует
эквивалент:  эквивалент
упрощать:  упрощает
исчисление:  исчисления
дисплей:  дисплее
подведение:  подведения подведение
тягота:  тяготах
степень:  степеней
локальный:  локальная
сказать:  сказать
ожидание:  ожидание
лаплас:  лапласа
перегиб:  перегиба
сходимость:  сходимости сходимость
поехать:  поехали
космонавт:  космонавтов космонавтом
концентрация:  концентрации концентрация
посередине:  посередине
ду:  ду
далее:  далее
неопределённый:  неопределенный неопределенном
собственный:  собственные
признак:  признак признаки
разложим:  разложима
открытый:  открытый
рядом:  рядом
звёздный:  звёздные
поэтому:  поэтому
практика:  практике
разделить:  разделить
вместо:  вместо
разумеется:  разумеется
менять:  меняет
увидеть:  увидите увидеть
объяснить:  объясню
ритм:  ритм ритмом
асимметрия:  асимметрия
шаг:  шаге
главный:  главную
сверхаккуратность:  сверхаккуратность
сводиться:  сводящиеся
замена:  замены
записать:  запишем записать
маленький:  меньше
составить:  составим составить
трезвый:  трезвыми
например:  например
решенияопределённый:  решенияопределенных
теплопроводность:  теплопроводности
вызвать:  вызвать
выглядеть:  выглядит
готовиться:  готовимся
коэффициентковариация:  коэффициентковариации
зависеть:  зависящая зависит
злополучный:  злополучную
обозначать:  обозначает
расслабиться:  расслабимся
заключать:  заключаем
абсцисса:  абсцисс
звено:  звенья
строгий:  строгие
случай:  случаев случае
лопиталя:  лопиталя
крайне:  крайне
обычно:  обычно
ставить:  ставим
поляформула:  поляформула
наверное:  наверное
фехнера:  фехнера
эффективный:  эффективные
тильда:  тильда
первый:  первому первая первом первого первый
условный:  условные
эллипс:  эллипс
ноль:  ноль
пи:  пи
теорема:  теорему теоремы
количество:  количество
левый:  левая левом левый левое левую
самочувствие:  самочувствие
приближение:  приближение
даламбер:  даламбера
детский:  детская
факт:  факт
повторнойя:  повторнойи
ровно:  ровно
ваш:  ваше
комплексный:  комплексные комплексного комплексный комплексными
дело:  делах дела деле дело
звёздочка:  звёздочкой
ранг:  ранг
кривая:  кривой
немалый:  немалая
тяжестиплоска:  тяжестиплоской
относительно:  относительно
ставиться:  ставится
отобразить:  отобразит
эквивалентный:  эквивалентной
разобраться:  разберёмся
подход:  подходы
лейбниц:  лейбница
подозрение:  подозрение
неравенство:  неравенства
терять:  теряем теряют
поток:  поток
представить:  представили представить
медиана:  медиана
бывать:  бывает
отправиться:  отправиться
техника:  техники
направлениюй:  направлениюи
приближать:  приближает приближать
гостевой:  гостевая
рыбка:  рыбок
тренировочный:  тренировочного
богатство:  богатство
кроме:  кроме
полёт:  полёт полётом
аккуратно:  аккуратно
нижеследующий:  нижеследующих
понятно:  понятно
главное:  главное
внутригрупповаяй:  внутригрупповаяи
он:  нём
алгебра:  алгебры
нумеровать:  нумеровать
существовать:  существует существуют
прямоугольник:  прямоугольников
эксцессэмпирический:  эксцессэмпирического
эмоция:  эмоций
слагаемое:  слагаемых
оценка:  оценка оценки
криволинейный:  криволинейные
библиотека:  библиотека
настолько:  настолько
зануда:  занудой
наименьшеезначение:  наименьшеезначения
вычислимый:  вычислим
системылинейный:  системылинейных
нужно:  нужно
определить:  определена
чистовой:  чистового
зависимость:  зависимость
замкнутый:  замкнутому
противоположный:  противоположным
проверить:  проверим проверить
немедленно:  немедленно
проходить:  проходит
показатель:  показатели
сильно:  сильно
площадьс:  площадьс
эль:  эль
убыванией:  убываниеи
повышенный:  повышенной
статистический:  статистическая статистические
также:  также
интегрирование:  интегрирование интегрирования интегрировании
легко:  легко
рациональный:  рациональные
посметь:  посмел
пока:  пока
нуль:  нулю нуля
ситуация:  ситуация
подставляться:  подставляются
интервальный:  интервальный
провести:  проведена
удваивать:  удваивать
соответственно:  соответственно
мера:  мере
вообще:  вообще
космический:  космического
оценкия:  оценкии
неявный:  неявной
несобственныхинтеграл:  несобственныхинтегралов
вероятностибиномиальный:  вероятностибиномиального
род:  рода
гаусс:  гаусса
родственник:  родственник
мечта:  мечта
полезно:  полезно
выразить:  выразить
экстремальный:  экстремальные
дирихло:  дирихле
начинать:  начинали
нормаль:  нормали
путешествие:  путешествия
определитель:  определитель
разрывный:  разрывна
выпуклость:  выпуклость
редкий:  редкие
элемент:  элементы
сложность:  сложность сложности
интересно:  интересно
менее:  менее
загромождённость:  загромождённости
фантазия:  фантазий
значенияй:  значенияи
искренне:  искренне
никуда:  никуда
кстати:  кстати
труд:  труда
классическоеопределение:  классическоеопределение
инормаль:  инормаль
точность:  точность
компактный:  компактным
солидный:  солидного
лёгкий:  лёгкого
вновь:  вновь
пирамида:  пирамида
отдохнуть:  отдохнувшими
сторонний:  сторонних
автор:  автор автора
интерпретация:  интерпретация
понимание:  понимания
недостаточный:  недостаточный
сравнить:  сравнил
ссылка:  ссылки
близкий:  ближайшем
дифференциальный:  дифференциальные
уравненияс:  уравненияс
онлайн:  онлайн
разобрать:  разберём
взаимоуничтожать:  взаимоуничтожаем
геометрия:  геометрии геометрия
стратегический:  стратегических
пилообразный:  пилообразный
хватить:  хватить
деться:  деться
произвольныйтройный:  произвольныйтройной
ниже:  ниже
нуждаться:  нуждается
дизайн:  дизайна
этаж:  этажа
это:  это
поляй:  поляи
находиться:  находится
опечатка:  опечатку
бескрайний:  бескрайние
плотно:  плотно
невероятный:  невероятным
тщательный:  тщательным
продолжаться:  продолжается
непременно:  непременно
методомоперационный:  методомоперационного
бесповторный:  бесповторной
правильно:  правильно
ошибка:  ошибку
л:  л
водить:  водят
сокращённо:  сокращённо
важно:  важно
банк:  банке
приятный:  приятным
слово:  слову
касательный:  касательных
нехороший:  нехороших
разбираться:  разбираемся
замечание:  замечаний
типовыхзадача:  типовыхзадач
воспользоваться:  воспользоваться
ранговойкорреляция:  ранговойкорреляции
палец:  пальцах
лукавство:  лукавством
искомое:  искомое
жизнь:  жизни
исследовать:  исследовать
тихий:  тихой
показаться:  показаться
нетрудно:  нетрудно
совпасть:  совпал
линейныйкоэффициент:  линейныйкоэффициент
отличный:  отличной
несобственныйинтеграл:  несобственныйинтеграл
доступно:  доступно
удобство:  удобства
причём:  причём
логично:  логично
учиться:  учимся
задавать:  задаваемые
напоминать:  напоминает напоминаю напоминать
интересный:  интересен
упоминаться:  упоминавшиеся
ипример:  ипримеры
обрадовать:  обрадую
множество:  множества
требоваться:  требуется
поверхностный:  поверхностные
фигура:  фигуры
пуассон:  пуассона
изучение:  изучению
однако:  однако
отрешиться:  отрешиться
несмотря:  несмотря
кусочный:  кусочным
фактически:  фактически
благополучно:  благополучно
математическоеожидание:  математическоеожидание
обычный:  обычную
небольшой:  небольшая
школа:  школа
браться:  берётся
неоднородный:  неоднородные
необходимо:  необходимо
миллиметр:  миллиметра
пристальный:  пристальное
возрастать:  возрастает
оформить:  оформить
картинка:  картинку
думать:  думаю
кратное:  кратные
системудифференциальный:  системудифференциальных
первообразный:  первообразной
медицинский:  медицинского
экспедиция:  экспедицию
помимо:  помимо
полуинтервал:  полуинтервале
рабочий:  рабочие
сохраняться:  сохраняются
последовательность:  последовательностей последовательность
квадратичный:  квадратичные
известный:  известен
периодичность:  периодичности
поскольку:  поскольку
архив:  архиве
чувствовать:  чувствую
гипергеометрическоераспределение:  гипергеометрическоераспределение
обратить:  обратите обратить
подробно:  подробно
равномерный:  равномерная равномерное
иначе:  иначе
треугольный:  треугольная
среднее:  среднего
опустеть:  опустеет
пожалуйста:  пожалуйста
следовать:  следует
себя:  собой
квадрат:  квадратов
сразу:  сразу
функциюкомплексный:  функциюкомплексной
относиться:  относятся
единственный:  единственный
заодно:  заодно
мода:  мода
свойстваэлементарный:  свойстваэлементарных
принимать:  принимает
закомментировать:  закомментирую
калькулятор:  калькулятор
научиться:  научиться
приборный:  приборную
кресло:  креслах
фихтенголец:  фихтенгольца
марс:  марс
похоже:  похоже
оба:  оба
преамбула:  преамбула
раскрытие:  раскрытия
оказаться:  оказался
действительно:  действительно
экстремум:  экстремумы
горнера:  горнера
отмечаться:  отмечалось
случайно:  случайно
видный:  виден
применять:  применяем
получать:  получаем
предельный:  предельная
хоровод:  хороводы
функцийв:  функцийв
ознакомиться:  ознакомиться
созерцать:  созерцая
тиражировать:  тиражируем
сойтись:  сойдётся
безусловный:  безусловные
среди:  среди
три:  трёх
создать:  создал
дискретнойслучайный:  дискретнойслучайной
ум:  уме
верх:  верха
прекрасно:  прекрасно
изучать:  изучать
буквально:  буквально
крамер:  крамера
синусоида:  синусоида
правда:  правда
выноситься:  выносится
повторимый:  повторим
интерес:  интерес
функциидвуха:  функциидвух
запретить:  запрещено
черновик:  черновике
емелин:  емелин
пять:  пяти
пристреляться:  пристреляться
вычисленияопределенный:  вычисленияопределенных
источник:  источниках
сломать:  сломанной
задачин:  задачина
замечательный:  замечательные
системый:  системыи
удовлетворяетлить:  удовлетворяетли
возмущаться:  возмущались
подготовка:  подготовку
срединный:  срединным
приходиться:  приходится
сей:  сих
преимущество:  преимущества
любовь:  любовь
возвращаться:  возвращайтесь
воссоединение:  воссоединению
молчок:  молчок
щёлкаться:  щёлкаться
сильный:  сильных
аналитически:  аналитически
скромно:  скромно
змий:  змий
консервы:  консервы
заданав:  заданав
уверенно:  уверенно
всё:  всё
что:  чём
тройной:  тройные
деление:  деления
являться:  является
контуруформула:  контуруформула
график:  график
встретиться:  встретилось
хрестоматийный:  хрестоматийным
либо:  либо
рекомендовать:  рекомендую
эн:  эн
независимый:  независимые
студент:  студентам
привести:  привести
мир:  мире
аналог:  аналог
корреляция:  корреляции
французский:  французского
идеал:  идеале
заочник:  заочников
подынтегральный:  подынтегральная
максимально:  максимально
говорить:  говоря
повторять:  повторяем
миниатюра:  миниатюра
