вектор:  векторы векторов
эффективный:  эффективное эффективные
цель:  целях цель
готовый:  готовым готовых готово
экономить:  экономит
приводить:  приводит приводим
вращение:  вращения
дифференциальный:  дифференциальные
уравненияс:  уравненияс
онлайн:  онлайн
геометрия:  геометрии геометрия
использоваться:  используется используются
копирование:  копирование
использовать:  используют использую используйте используем
справка:  справка
решить:  решить
разрыв:  разрыва
работа:  работа работе работы
выражение:  выражения выражении выражение
сумма:  сумма сумме сумму суммы
справочник:  справочник
производный:  производные производная производной производную
прямой:  прямой прямую прямая
дуприближённо:  дуприближённо
новый:  новому нового
предел:  предел пределы пределов
слагаемое:  слагаемые слагаемом
произвольныйтройный:  произвольныйтройной
модель:  модели модель
посетить:  посетите
основный:  основного основное
асимптота:  асимптоты
дизайн:  дизайна
это:  это этим
событие:  события
отблагодарить:  отблагодарить
являться:  являются являться является
повторный:  повторные
байес:  байеса
числовой:  числовые
дисперсия:  дисперсию дисперсия дисперсии
табличный:  табличный табличную табличной
решать:  решать
производныенеявно:  производныенеявно
пример:  примере примеры пример примера
точнее:  точнее
таблица:  таблицу таблицы таблица таблице
скорее:  скорее
решение:  решений решением решение решения
поляй:  поляи
интеграл:  интегралы интеграла интеграл интеграле интегралов интегралах интегралами
находиться:  находится находился находятся
тонуть:  тонет
опечатка:  опечатку
общий:  общему общим общая общий общее
тождество:  тождества тождество
случай:  случаях случай случае
получить:  полученного получи
теория:  теория теории
математический:  математические математическая математической
находить:  находить находим
гемор:  гемор
выгодный:  выгоднее
способ:  способом способами способ
речь:  речь
формула:  формулы формул формулах формула формулу формуле
данный:  данном данное данный
задание:  заданий
вспоминать:  вспоминая вспоминаем
приходиться:  приходилось приходится
замена:  замену замене замены замена
статья:  статье
фнп:  фнп
пособие:  пособия
пропорция:  пропорции
чётный:  чётные чётных четная
особенно:  особенно
выделять:  выделяем
канонический:  каноническому
продолжать:  продолжать
простейшее:  простейшие
дифференцирование:  дифференцировании
владеть:  владеть
гипотеза:  гипотезы гипотез гипотеза
дифференциал:  дифференциалах дифференциала дифференциал
двумерный:  двумерная
больший:  наибольшее
эффективность:  эффективность
методомоперационный:  методомоперационного
задать:  заданной задайте
конец:  конце
направление:  направлении
часть:  частям части
нередко:  нередко
друг:  друг друга
тело:  тела
циркуляция:  циркуляция
бесповторный:  бесповторной
один:  одну одна
образно:  образно
степень:  степенях степени степенями степень
рассмотреть:  рассмотрен рассмотрим рассмотренном
двойной:  двойные двойной
ошибка:  ошибку
четвёртый:  четвертой
плоскость:  плоскости плоскость
проводиться:  проводится
несобство:  несобств
избавляться:  избавляемся
л:  л
нелинейный:  нелинейная
брать:  берём берем
получиться:  получится получиться
полный:  полные полное полных полного полной полный
применить:  применить применили
преобразованиеквадратичный:  преобразованиеквадратичной
определителяй:  определителяи
выносить:  выносим
вогнутостья:  вогнутостьи
напрашиваться:  напрашивается
вид:  виде виды вида виду
нечётный:  нечетная нечетной
положение:  положении
понижение:  понижения понижением понижение
закон:  законы
выяснить:  выяснить
допустимый:  допустима допустимо
дробь:  дроби дробей
подынтегральный:  подынтегральном подынтегральное подынтегральные подынтегральной подынтегральную
функциональный:  функциональные
разделение:  разделение
возводить:  возводим
комментарий:  комментарии
касательный:  касательных
косинус:  косинусами косинусом косинусы косинус
длинный:  длинным
константа:  константу
профессия:  профессию
понижать:  понижаем понижая
понизить:  понизить понизив
удобный:  удобной удобнее удобный
геометрический:  геометрическая геометрическое
абсолютный:  абсолютная
графика:  графика графики
типовыхзадача:  типовыхзадач
универсальный:  универсальная универсальную универсальной
умножение:  умножения
тригонометрический:  тригонометрическими тригонометрическое тригонометрической тригонометрические тригонометрическая тригонометрических тригонометрического тригонометрическую
вероятность:  вероятностей вероятность вероятности
взгляд:  взгляд
знаменатель:  знаменателю знаменателе знаменатель
ранговойкорреляция:  ранговойкорреляции
система:  система систему системе системы
частный:  частные частный частное
функция:  функций функцию функции функциями функция
выполнимый:  выполним
непрерывный:  непрерывная непрерывных
группировка:  группировок группировка
условнаясходимость:  условнаясходимость
сложенияй:  сложенияи
уравненийв:  уравненийв
раскрывать:  раскрываем
сложение:  сложение
регрессия:  регрессии регрессия
величина:  величин величина величины
упростить:  упростить
мучиться:  мучается
александр:  александр
резервировать:  резервируем
остаться:  осталось остались
выполнить:  выполнил выполнить выполнили
зря:  зря
рассматривать:  рассматриваемом
грин:  грина
который:  которые котором которого которых которая
исчисление:  исчисления исчислении
линейный:  линейные линейная линейных линейной
эйлер:  эйлера
метод:  метода методы методов методом метод
подведение:  подведения
двойка:  двойку
путём:  путем
приём:  приемов приём приёмом приемами приёма
ошибиться:  ошибся
подходить:  подходит
умножить:  умноженный
согласие:  согласия
гораздо:  гораздо
локальный:  локальная
вычисление:  вычислениям вычисление
привести:  приведено привести
ожидание:  ожидание
математика:  математики математике
лаплас:  лапласа
перегиб:  перегиба
накопление:  накопления
такой:  таким такие такое такого
сходимость:  сходимости сходимость
дуоперационный:  дуоперационным
исследовать:  исследовать
обозначить:  обозначили обозначить
дискретный:  дискретный
базис:  базисах базис базису
поверхность:  поверхности
помощь:  помощи помощью
знакочередоваться:  знакочередующиеся
задача:  задачи
следующий:  следующая следующие следующим
векторный:  векторного векторное
объяснить:  объяснил
страница:  странице страницу
ду:  ду
методический:  методические
заметно:  заметно
наиболее:  наиболее
зависимостьвектор:  зависимостьвекторов
линейныйкоэффициент:  линейныйкоэффициент
неудобный:  неудобном
делать:  делать
снова:  снова
нахождение:  нахождении нахождением
синус:  синусами синус синусы синусом
коэффициент:  коэффициент
неопределённый:  неопределенный неопределенном неопределенного
будущий:  будущий
сначала:  сначала
несколько:  несколькими несколько
собственный:  собственные
числитель:  числителе числитель
несобственныйинтеграл:  несобственныйинтеграл
признак:  признак признаки
произвольный:  произвольных
подстановка:  подстановка подстановку подстановки
данные:  данных данным
сложный:  сложной сложного сложное сложных сложные
смотреть:  смотрим
доступно:  доступно
работать:  работает
фурье:  фурье
учиться:  учимся
поле:  поля
урок:  урока урок уроку уроке
разложение:  разложением разложение
задавать:  задаваемые
свойство:  свойства свойство
вместо:  вместо
некоторый:  некоторыми некоторых некоторая некоторые
практика:  практике
увидеть:  увидите
сидеть:  сидит
какой:  каких
исследование:  исследование
принцип:  принципе
опыт:  опыта
решаться:  решаются решается
ипример:  ипримеры
плоский:  плоской
уравнение:  уравнению уравнений уравнения уравнение
жанр:  жанра
точка:  точки точке
арксинус:  арксинусом
множество:  множества
найти:  найти
оценка:  оценки оценка
ухищрение:  ухищрениям
переход:  переход
вариация:  вариации
асимметрия:  асимметрия
комплексный:  комплексными комплексные комплексного комплексный
основа:  основы
поверхностный:  поверхностные
студент:  студент
интервал:  интервалы
книга:  книга книги
главный:  главную
кош:  коши
причём:  причем
основной:  основной основные
координата:  координат координаты координатах
фигура:  фигуры
подытоживать:  подытоживая
пуассон:  пуассона
подобный:  подобные
успех:  успехов
сводиться:  сводящиеся
чайник:  чайников чайника
собственно:  собственно
упоминаться:  упоминалось
преобразование:  преобразований преобразования
эквивалентный:  эквивалентными
вычисленияс:  вычисленияс
однако:  однако
глаз:  глазами
целесообразно:  целесообразно
малый:  малые наименьших
разобрать:  разобраны разобрать
связь:  связь
котангенс:  котангенсы котангенсов котангенса котангенсом
маленький:  меньше
таки:  таки
потихоньку:  потихоньку
матричный:  матричные матричных матричный
всякий:  всяких
обратный:  обратном обратная обратную
результат:  результате результатом
произведение:  произведении произведения произведение
заметить:  заметили
применение:  применение применением применения
математическоеожидание:  математическоеожидание
дать:  данной данная
однородный:  однородные однородным
решенияопределённый:  решенияопределенных
вычислить:  вычислить
нормальный:  нормальное
очень:  очень
комбинация:  комбинациях
школа:  школа
интегральнаятеорема:  интегральнаятеоремы
корнимногочлен:  корнимногочлена
логарифмический:  логарифмическая
матрица:  матрицу матрицы матрицами
условно:  условно
испытанияй:  испытанияи
интегралыть:  интегралыв
привыкнуть:  привык
неоднородный:  неоднородные
необходимо:  необходимо
перегруппировка:  перегруппировка
замечать:  замечаем
правило:  правило правила правилу правилом
помучаться:  помучаетесь
тангенс:  тангенса тангенсом тангенсы тангенс тангенсов
выражать:  выражаем выражаю
раскрытие:  раскрытием
чистовой:  чистовое чистовом
бернулли:  бернулли
найтись:  найдется нашлось
полярный:  полярные полярной полярных
коэффициентковариация:  коэффициентковариации
исходный:  исходный
ряд:  ряд ряды ряда рядов
подготовка:  подготовкой
вариационный:  вариационный
уровень:  уровня
предпосылка:  предпосылкой
второй:  второй второго
должный:  должны должен
критерий:  критерия
вопрос:  вопросы вопрос
кратное:  кратные
исключение:  исключением
системудифференциальный:  системудифференциальных
арктангенс:  арктангенс арктангенсом
пользоваться:  пользоваться
перечисленный:  перечисленные
блог:  блог
доверительный:  доверительные
простой:  простейших
высокий:  высших высшей высшая высоких
стараться:  стараются
типовой:  типовых
помнить:  помнить
среднееквадратический:  среднееквадратическое
пространство:  пространстве
нужный:  нужное нужной
лопиталя:  лопиталя
разделить:  разделил
вышеперечисленный:  вышеперечисленные
последовательность:  последовательностей
комбинационный:  комбинационная
навешивать:  навешиваю
курс:  курс
оба:  обе оба
трудоёмкий:  трудоемким
квадратичный:  квадратичные
нафаршировать:  нафаршированы
научный:  научного
смешанноепроизведение:  смешанноепроизведение
свестись:  свелось
объём:  объем
превратиться:  превратится
проверить:  проверить
поляформула:  поляформула
наверное:  наверное
сообщить:  сообщите
сделать:  сделать сделано сделаем
линия:  линиями линии линия
фехнера:  фехнера
аналитический:  аналитическая аналитической
характерный:  характерный
поскольку:  поскольку
школьный:  школьный
мы:  нам
производить:  производим
центр:  центр
образ:  образом
гипергеометрическоераспределение:  гипергеометрическоераспределение
условный:  условные
непрерывнаяслучайный:  непрерывнаяслучайная
другой:  других другую другие
последний:  последняя
свободно:  свободно
эллипс:  эллипс
третий:  третьем
раз:  раза
обратить:  обратите
поступить:  поступить
поговорить:  поговорим
длина:  длина
любой:  любой
степенной:  степенной степенного степенные
понять:  поймем
сайт:  сайта сайты сайт
квадрат:  квадрата квадратов квадрат
мочь:  могут
знакопостоянство:  знакопостоянства
производная:  производных
подробно:  подробно
равномерный:  равномерная равномерное
иначе:  иначе
треугольный:  треугольная
проводить:  проводить проводим
неплохо:  неплохо
поэтому:  поэтому
идти:  идут идет
попробовать:  попробуйте попробовать
градиент:  градиент
определение:  определения определению
трудность:  трудности
обозначать:  обозначать
пожалуйста:  пожалуйста
даламбер:  даламбера
ориентироваться:  ориентироваться
основать:  основаны
теорема:  теоремы
факт:  факт
комбинаторика:  комбинаторике
затем:  затем
ужасный:  ужасный
случайнаявеличина:  случайнаявеличина
повторнойя:  повторнойи
сокращаться:  сокращается
уничтожаться:  уничтожаются
построение:  построение
следовать:  следует
проверка:  проверку проверка
бесконечно:  бесконечно
линейнойкорреляционный:  линейнойкорреляционной
получаться:  получались получается
действие:  действия
распечатать:  распечатать
ранг:  ранг
время:  время
расписывать:  расписывать
скобка:  скобки скобок
кривая:  кривой
превращать:  превращает
форма:  формы
параграф:  параграфам параграф
тяжестиплоска:  тяжестиплоской
особо:  особо
отметить:  отметить
готовить:  готовим
распределениякритерия:  распределениякритерий
окончательный:  окончательный
функциюкомплексный:  функциюкомплексной
значок:  значком
напоминать:  напоминаю
область:  область области
реализоваться:  реализуется
аргумент:  аргумента аргумент
построить:  построить
анализировать:  анализируем
несобственный:  несобственные
просто:  просто
видеть:  видим
мода:  мода
подводить:  подводим
свойстваэлементарный:  свойстваэлементарных
внимание:  внимание
икс:  иксы икса
зрение:  зрения
калькулятор:  калькулятор
лейбниц:  лейбница
научиться:  научиться
неравенство:  неравенства
поток:  поток
кто:  кого
касательная:  касательная
ответ:  ответ ответа ответы
задачис:  задачис
интегрирование:  интегрированию интегрирование интегрирования
использование:  использованием использования использование
буква:  букву
алгоритм:  алгоритмом
недавно:  недавно
разный:  разных
разобраться:  разобраться
медиана:  медиана
функциия:  функциии
записать:  записать
частый:  чаще
возможно:  возможно
расписать:  расписал
взлёт:  взлёт
функцийдвуха:  функцийдвух
четырехэтажность:  четырехэтажности
направлениюй:  направлениюи
определённый:  определенный определенного
выборка:  выборке
единственный:  единственное
гостевой:  гостевая
осуществление:  осуществления
распределение:  распределения распределение
экстремум:  экстремумы
постараться:  постараюсь
горнера:  горнера
вернуться:  вернуться
производныефункция:  производныефункции
средний:  средняя
равный:  равен
понятно:  понятно
функцийнесколький:  функцийнескольких
случайно:  случайно
вывод:  вывод
ориентир:  ориентир ориентиры
отщипывать:  отщипываем
закрепление:  закрепления
внутригрупповаяй:  внутригрупповаяи
зависеть:  зависит
применять:  применяем
алгебра:  алгебры
куба:  кубе
число:  числами числа
математик:  математика
функцийв:  функцийв
переменный:  переменных переменной
ознакомиться:  ознакомиться
несовместный:  несовместные
попытаться:  попытаться
независимыеслучайный:  независимыеслучайные
множественнойлинейный:  множественнойлинейной
потребоваться:  потребуются
наоборот:  наоборот
раздобыть:  раздобыть
анализ:  анализ анализа
классика:  классика
интегральный:  интегральном
прямоугольник:  прямоугольников
непрерывность:  непрерывность
минус:  минус
эксцессэмпирический:  эксцессэмпирического
причёсывать:  причесываем
заострять:  заостряю
хороший:  хорошего
функциис:  функциис
зеркало:  зеркало
различный:  различных различным
криволинейный:  криволинейные
пирсон:  пирсона
библиотека:  библиотека
три:  трёх
этот:  этими
межгрупповой:  межгрупповая
ортогональный:  ортогональное
пятый:  пятой
дискретнойслучайный:  дискретнойслучайной
задачипо:  задачипо
два:  двумя двух
востребовать:  востребованную
наименьшеезначение:  наименьшеезначения
нсв:  нсв
сила:  силы
приблизить:  приближенные
знак:  знак
знать:  знаешь
лекция:  лекциях
вариант:  вариант
системылинейный:  системылинейных
пояснять:  поясняем
нужно:  нужно
вроде:  вроде
рациональный:  рациональный рациональные
примечание:  примечание
упасть:  упал
зависимый:  зависимые
последствие:  последствий
прочитать:  прочитать
зависимость:  зависимость
отклонение:  отклонение
крамер:  крамера
отрезка:  отрезке
материал:  материалы материалами материалов
избегать:  избегать
прибегать:  прибегать
похожий:  похожий похожих
вполне:  вполне
одновременно:  одновременно
сохранять:  сохраняют
случайный:  случайных случайные
замкнутый:  замкнутому
дуга:  дуги
отрезкать:  отрезкав
желать:  желаю
дивергенция:  дивергенция
парабола:  парабола
линейность:  линейности
выноситься:  выносится
обещать:  обещанное
форум:  форуме форум
показатель:  показатели
повышаться:  повышаться
наш:  наш нашем наши
отличие:  отличие
зачёт:  зачёте
рамка:  рамках
взаимно:  взаимно
короче:  короче
площадьс:  площадьс
выполнять:  выполняем
функциидвуха:  функциидвух
интегрировать:  интегрируем
запретить:  запрещено
статистический:  статистические статистическая
емелин:  емелин
известный:  известных
встречаться:  встречались
площадь:  площадь
вышеуказанный:  вышеуказанного
исчезать:  исчезает
убыванией:  убываниеи
вычисленияопределенный:  вычисленияопределенных
повышенный:  повышенной
возрастание:  возрастание
эмпирический:  эмпирические
детерминация:  детерминации
также:  также
задачин:  задачина
замечательный:  замечательные
обязательно:  обязательно
системый:  системыи
начать:  начать
удовлетворяетлить:  удовлетворяетли
тот:  тех ту
дифференциальныеуравнение:  дифференциальныеуравнения
иррациональный:  иррациональных
интервальный:  интервальный
сожаление:  сожалению
постоянный:  постоянных
квадратичнуюформ:  квадратичнуюформу
стокс:  стокса
схема:  схема
карта:  карта
параметрический:  параметрической параметрическом
итак:  итак
мера:  мере
гипербола:  гипербола
провести:  проведем провести
оформление:  оформление оформлении
снизиться:  снизится
самостоятельно:  самостоятельно
быть:  будут будем
прерывать:  прерываем
отщипнуть:  отщипнули
превращаться:  превращаются
дробовик:  дробовик
они:  ними
начинка:  начинкой
оценкия:  оценкии
неявный:  неявной
сократить:  сократил
несобственныхинтеграл:  несобственныхинтегралов
вероятностибиномиальный:  вероятностибиномиального
сам:  самом
вероятностия:  вероятностии
логика:  логики
род:  рода
заданав:  заданав
скалярный:  скалярное
спирмена:  спирмена
гаусс:  гаусса
интегрироваться:  интегрируются
совершенно:  совершенно
порядок:  порядка порядков
всё:  всё
концовка:  концовка
значимость:  значимости
тройной:  тройные
возникать:  возникает
деление:  деления
контуруформула:  контуруформула
точно:  точно
экстремальный:  экстремальные
график:  график
близко:  близко
весь:  весь
дело:  деле
её:  её
св:  св
парный:  парной
успешный:  успешного
нормаль:  нормали
определитель:  определитель
существовать:  существуют
выпуклость:  выпуклость
повышение:  повышение
арка:  арками
элемент:  элементы
сборник:  сборники
показательный:  показательное
тык:  тыка
рекомендовать:  рекомендую
независимый:  независимые
раскрыть:  раскрыть
менее:  менее
автор:  автора автор
сложность:  сложности
диффура:  диффурами
почленно:  почленно
часто:  часто
значенияй:  значенияи
пропадать:  пропадает
изучение:  изучения
многочлен:  многочлен
неправильно:  неправильно
справедливо:  справедливо
дилемма:  дилемма
весьма:  весьма
немного:  немного
первый:  первого
кстати:  кстати
классическоеопределение:  классическоеопределение
инормаль:  инормаль
статистика:  статистика
корреляция:  корреляции
типичный:  типичными
выделение:  выделения
биномиальный:  биномиальное
редкий:  реже
заочник:  заочников
пирамида:  пирамида
линиюв:  линиюв
повторение:  повторения
самостоятельный:  самостоятельного
справедливый:  справедливы
отношение:  отношении
делимый:  делим
говорить:  говоря
повторять:  повторяем
устно:  устно
вынести:  вынести
откусить:  откусить
выглядеть:  выглядеть
равенство:  равенства
