чертёж:  чертежом чертежу чертёж чертеже
новый:  новых новой новом новые новый новое новая новому нового
производный:  производные производная производной производную производным
предел:  предел пределы пределов
слагаемое:  слагаемые
позволять:  позволяющие позволяет
указательный:  указательный указательные указательных
задом:  задом
исходный:  исходного исходном
числовой:  числовые
производныенеявно:  производныенеявно
мирный:  мирную
матричный:  матричному матричные матричных матричным матричного матричное матричной матричный
благоприятный:  благоприятным
изображение:  изображения
формула:  формулы формулами формуле формула формул формулах
смотреть:  см смотрит смотреть
игрек:  игрека
связать:  связаны связано связать
отрицательный:  отрицательный отрицателен
канонический:  каноническому
трёхмерный:  трехмерном трёхмерном трёхмерного
тестировать:  тестируя
два:  две двух
дифференциал:  дифференциалах дифференциала
самый:  самых самым самые самое
больший:  наибольшее большие больших наибольшую большей
известно:  известно
многие:  многие
выразить:  выразим выразить выражены
брат:  брата
означать:  означает
прямоугольный:  прямоугольной прямоугольная прямоугольных
квадратный:  квадратной
правый:  правая правой правый правые правым
расположить:  расположить
вогнутостья:  вогнутостьи
многий:  многих
стать:  стали стало станем
случай:  случай случая случаев случае случаях
убедиться:  убедиться убедитесь
плохой:  хуже
профессия:  профессию
углублённый:  углубленно
пусть:  пусть
умножение:  умножения умножение умножением
выполнимый:  выполним
система:  система системой системе систему систем системы
группировка:  группировок группировка
условнаясходимость:  условнаясходимость
угол:  угол
подготовить:  подготовленных
александр:  александр
ось:  ось оси осей
остаться:  осталось
зря:  зря
который:  которые который которая которого которым которых которой
линейный:  линейные линейная линейных линейной
вниз:  вниз
осуществлять:  осуществлять осуществляя
приходить:  приходит
традиция:  традиции
равенство:  равенство равенств равенства
запись:  записи
согласие:  согласия
дуоперационный:  дуоперационным
базис:  базисах базису базисе базисов базисы базис базисом базисам базиса
наиболее:  наиболее
развернуться:  развернулась
зависимостьвектор:  зависимостьвекторов
затолкать:  затолкать
снова:  снова
день:  день дня
метод:  методы методом метод
составлять:  составляем составляет
старое:  старого старое
страница:  страницу
аффинный:  аффинные аффинных аффинную аффинной
начинаться:  начиналось начинается
математический:  математическая математические математический математической
данные:  данных
простота:  простота простотой
цифра:  цифра
интеграл:  интеграл интегралов интегралы интеграла интеграле
урок:  урока уроков уроке
разложение:  разложением разложений разложение разложения
перенос:  переносом переносе
уравнение:  уравнению уравнения уравнение уравнением уравнений
переход:  переход перехода
симметрично:  симметрично
симметрия:  симметрии симметрия
первый:  первое первым первую первыми первая первом первого первый
вектор:  векторах векторы вектором векторов вектора векторам векторами вектор
аварийный:  аварийных
практический:  практических
целесообразно:  целесообразно
малый:  малые наименьших меньшего
связь:  связь
понятие:  понятием понятие
точка:  точку точки точка точек точке
произведение:  произведении произведение
удобный:  удобные удобный
нормальный:  нормальное
интегральнаятеорема:  интегральнаятеоремы
корнимногочлен:  корнимногочлена
логарифмический:  логарифмическая
основной:  основные
бернулли:  бернулли
полярный:  полярные полярных полярной
рассмотреть:  рассмотрим рассмотренный рассмотрел рассмотренные рассмотрю
ряд:  ряды ряда ряд ряде рядов
уровень:  уровня
наперёд:  наперёд
значительно:  значительно
доверительный:  доверительные
донельзя:  донельзя
форма:  форме формы
среднееквадратический:  среднееквадратическое
основный:  основное основных
комбинационный:  комбинационная
декартов:  декартовой декартовых декартова
оба:  обе оба
смешанноепроизведение:  смешанноепроизведение
оказаться:  окажутся
расстановка:  расстановка
функция:  функции функция функций
дисперсия:  дисперсия дисперсии дисперсию
рассчитываться:  рассчитывается
школьный:  школьный школьная школьные
мы:  нам
образ:  образом
терпеться:  терпится
непрерывнаяслучайный:  непрерывнаяслучайная
другой:  других другая другому другими другие другого другую
единственно:  единственно
длина:  длина длины
материал:  материал материала материалов материалы
подавлять:  подавляющем
мочь:  могут
знакопостоянство:  знакопостоянства
градиент:  градиент
удачно:  удачно
линия:  линия линии линиями
ладонь:  ладони
разнообразие:  разнообразия
породить:  порожденных
технический:  техническим
комбинаторика:  комбинаторике
число:  числе числами числа
случайнаявеличина:  случайнаявеличина
мой:  моих мои
бесконечно:  бесконечно
равный:  равны
задача:  задачу задаче задачи задач задачах задача
отметить:  отметить
статья:  статьи статья статье
возвращаться:  возвращаемся
алгебра:  алгебре алгебры
обратный:  обратную обратная
готовый:  готовых готовый готовые
просто:  просто
ещё:  ещё
произвольный:  произвольного произвольной произвольных
вернуться:  вернёмся вернуться
быть:  буду будем
тема:  тема
единственный:  единственным
неколлинеарный:  неколлинеарных
отличаться:  отличается
нахождение:  нахождения
превратить:  превратить
частый:  чаще
читатель:  читателей читатели читателям
непрерывный:  непрерывных непрерывная
развернуть:  разверните развёрнуты
производныефункция:  производныефункции
средний:  средняя
столбцы:  столбцы столбцах
связывать:  связывают
область:  области область
перегруппировать:  перегруппируем
ссылка:  ссылке
взаимный:  взаимную
математик:  математика
синус:  синуса
переменный:  переменных переменной
пример:  пример примере примеры
несовместный:  несовместные
независимыеслучайный:  независимыеслучайные
никакой:  никакого
вверх:  вверх
координатный:  координатными координатная координатный координатных
следовательно:  следовательно
модель:  модель модели
непрерывность:  непрерывность
догадаться:  догадаться
функциис:  функциис
угодный:  угодно
полный:  полной полных полное
зеркало:  зеркало
значит:  значит
пирсон:  пирсона
член:  члены
вопрос:  вопрос вопроса вопросы
хороший:  хороших
аналогичный:  аналогичные
геометрический:  геометрических геометрический геометрическая геометрическое
межгрупповой:  межгрупповая
ортогональный:  ортогональное ортогональный
нсв:  нсв
подопытный:  подопытные подопытных
упасть:  упал
ход:  ходе
один:  одно одного одна одной
захлопнуть:  захлопнуть
отрезка:  отрезке
штрих:  штрихами штрихи
величина:  величина величин величины
присмотреться:  присмотримся
важность:  важность
заведомо:  заведомо
русло:  русло
взять:  взятого взять
перебирать:  перебирать
вести:  вести
раскрой:  раскроем
положительный:  положительные положительный
детерминация:  детерминации
сторона:  стороны сторону
следующий:  следующие следующий
тот:  тех та те ту
начать:  начать
матрица:  матрицей матрицу матрицы матрица матрицами матрице
крутить:  крути
дифференциальныеуравнение:  дифференциальныеуравнения
прямой:  прямая прямой прямую
середина:  середине
ортонормированный:  ортонормированным ортонормированный
постоянный:  постоянных
стокс:  стокса
схема:  схема схемы
самостоятельно:  самостоятельно
жизнь:  жизнь
задать:  задала заданной заданы задайте
дробовик:  дробовик
математика:  математике математики математику
векторный:  векторное векторном векторного
сам:  самом самой
вероятностия:  вероятностии
скалярный:  скалярное
начальный:  начальную
совершенно:  совершенно
наш:  нашем наши нашему нашим наше наш нашей нашего наша
значимость:  значимости
систематизировать:  систематизируем
такой:  такую таким такие такое такого
анализ:  анализа анализ
её:  её
частный:  частное частные частный
парный:  парной
координата:  координатами координаты координата координат координатах
браться:  берутся
двигаться:  движемся
найти:  найдём найдена найдем найти
непонятный:  непонятными
сборник:  сборники
параметрический:  параметрическом параметрической
часто:  часто
получаться:  получается
природа:  природы
какой:  какие
находить:  находим
надеяться:  надеюсь
решение:  решение решением решения решений
место:  место местах
форум:  форум форуме
книга:  книги книга
чувствоваться:  чувствуется
знакомство:  знакомство
вращение:  вращения
птица:  птица
именно:  именно
принять:  принято
копирование:  копирование
давать:  давайте
разрыв:  разрыва
выражение:  выражения
совпадать:  совпадает
использоваться:  используются
грубо:  грубо
отблагодарить:  отблагодарить
байес:  байеса
размерность:  размерности
решать:  решать решали
вызвать:  вызвал
свет:  свет
результат:  результат результате результаты
теория:  теория теории
нестарый:  нестарой
характеризовать:  характеризует
свериться:  свериться
называть:  называют
подстрочный:  подстрочные
двумерный:  двумерная
выбрать:  выбрал выберу
тело:  тела
циркуляция:  циркуляция
слева:  слева
плоскость:  плоскости плоскость
общий:  общим общая общие общем
поздний:  позже
определителяй:  определителяи
закон:  законы
затруднение:  затруднения
справа:  справа
качество:  качестве
товарищ:  товарищи
действие:  действий действия
буква:  буква
пункт:  пункт
столбец:  столбец
вероятность:  вероятностей вероятность вероятности
поворот:  поворотом повороте поворот поворотов поворота
уравненийв:  уравненийв
транспонировать:  транспонированная
революция:  революции
иметь:  имеют имеет иметь
срочно:  срочно
отсчёт:  отсчёта отсчёт
называться:  называются называется
грин:  грина
эйлер:  эйлера
символизировать:  символизирует
расставить:  расставить
вкупе:  вкупе
наглядность:  наглядностью
невозможно:  невозможно
дискретный:  дискретный
знакочередоваться:  знакочередующиеся
заметно:  заметно
стесняться:  стеснялись
голова:  голову
происходить:  происходят происходящие
сложный:  сложной сложные сложных
рассмотрение:  рассмотрению
работать:  работает работают
фурье:  фурье
дать:  дан данные данной
поле:  поля
гипотеза:  гипотез гипотеза гипотезы
свойство:  свойства
момент:  момент
исследование:  исследование
рассуждение:  рассуждений рассуждения
проблема:  проблем
вариация:  вариации
основа:  основы основе
мало:  мало
интервал:  интервалы
кош:  коши
выше:  выше
соответствующий:  соответствующих соответствующие соответствующими
чайник:  чайников
вычисленияс:  вычисленияс
аналитический:  аналитический аналитическая аналитической
появляться:  появляется
полюбить:  полюбят
ориентация:  ориентацию ориентации ориентация
заметить:  заметили заметьте
однородный:  однородные однородным
вычислить:  вычислить
очень:  очень
исчезать:  исчезают
эпохальный:  эпохальные
испытанияй:  испытанияи
интегралыть:  интегралыв
перегруппировка:  перегруппировка
тригонометрия:  тригонометрией
пространственный:  пространственный
помощь:  помощью
изобразить:  изображен изобразим
начало:  начало начала
вариационный:  вариационный
источник:  источнике источниках
обобщить:  обобщил
получить:  получим полученной получить получена полученных получили получи
линейно:  линейно
блог:  блог
параллельный:  параллельном параллельным
высокий:  высших высшей высшая
рассуждать:  рассуждать
измениться:  изменилась
пространство:  пространстве пространства
курс:  курс
ордината:  ординат
меняться:  меняется
весь:  всеми
знакомый:  знакомая знакомы
окончательно:  окончательно
сообщить:  сообщите
понижение:  понижение понижением
застолбить:  застолбить
левый:  левой левых левые левая левую
проанализировать:  проанализируют
центр:  центр
объяснение:  объяснений объяснение
искомый:  искомые
любой:  любой любую
преобразование:  преобразованиях преобразования преобразование преобразований
считаться:  считается
свободный:  свободная свободные
построение:  построение
проверка:  проверку проверка
линейнойкорреляционный:  линейнойкорреляционной
власть:  власть власти
время:  время
просматриваться:  просматривается
сложиться:  сложившейся
приведение:  приведения
почему:  почему
осуществить:  осуществлён
распределениякритерия:  распределениякритерий
эффект:  эффект
предстоять:  предстоит
вспомниться:  вспомнилась
несобственный:  несобственные
отсчитываться:  отсчитываться
укладывать:  укладывают укладываем
появиться:  появилась
откуда:  откуда
понять:  поймут
процесс:  процесс
касательная:  касательная
потребность:  потребность
задачис:  задачис
ответ:  ответ ответы
друг:  другом
разобраться:  разобраться
правило:  правила правило
функциия:  функциии
степенной:  степенного степенные
функцийдвуха:  функцийдвух
выборка:  выборке
осуществление:  осуществления
понятный:  понятным
зеркальный:  зеркальной зеркальная
функцийнесколький:  функцийнескольких
чисто:  чисто
градус:  градусов
налево:  налево
множественнойлинейный:  множественнойлинейной
единичный:  единичный
распределение:  распределение распределения
оранжевый:  оранжевой
тригонометрический:  тригонометрические тригонометрических
построить:  построена построить построим
подача:  подачи
икс:  икса
этот:  этими этих эта
конкретный:  конкретных
задачипо:  задачипо
востребовать:  востребованную
приблизить:  приближенные
видно:  видно
изучить:  изучить
вариант:  вариант
примечание:  примечание
прибавиться:  прибавилась
зависимый:  зависимые
отклонение:  отклонение
перемещать:  перемещай
таблица:  таблицы
знать:  знаете
вполне:  вполне
случайный:  случайных случайные
дуга:  дуги
частность:  частности
дробь:  дробь дробей
рассчитать:  рассчитаем
отрезкать:  отрезкав
дивергенция:  дивергенция
одинаково:  одинаково
сайт:  сайт сайты сайта
графика:  графики графика
идти:  идёт шла
причина:  причине причинам
возрастание:  возрастание
эмпирический:  эмпирические
левоориентировать:  левоориентированным
подставить:  подставим подставить
найтись:  нашлось
ничто:  ничто ничем
разбираться:  разбираться
вряд:  вряд
иррациональный:  иррациональных
отобразить:  отобразим отобразить
аппарат:  аппарат
определение:  определению определения
квадратичнуюформ:  квадратичнуюформу
карта:  карта
гипербола:  гипербола
индекс:  индексами индексы
они:  ними ими
логика:  логики
спирмена:  спирмена
невырожденный:  невырожденная
следствие:  следствие
вид:  виду виды вид виде
серьёзный:  серьёзные
специально:  специально
возникать:  возникает
слышать:  слышали
вовсе:  вовсе
пушистый:  пушистые
очередь:  очереди
лишь:  лишь
св:  св
второй:  второго второй вторую вторая
достаточно:  достаточно
показательный:  показательное
назвать:  назовём назвали
соответствовать:  соответствует
понимать:  понимаете понимают
диффура:  диффурами
пользоваться:  пользуясь
узнать:  узнать узнаете
весьма:  весьма
подразумевать:  подразумевает
противоположный:  противоположную
косинус:  косинуса
вычисление:  вычисление
статистика:  статистика
правоориентировать:  правоориентированным правоориентирован
бэ:  бэ
биномиальный:  биномиальное
книжный:  книжные
редкий:  реже редкий
линиюв:  линиюв
самостоятельный:  самостоятельного
плоский:  плоского
справедливый:  справедливы
отношение:  отношении отношения
любопытный:  любопытные
путаница:  путаницу
коричневый:  коричневые
смысл:  смысл
тузик:  тузика тузиков
окно:  окно
недоразумение:  недоразумений
решить:  решить
дуприближённо:  дуприближённо
нужный:  нужная нужной
информация:  информации
асимптота:  асимптоты
событие:  события
спросить:  спросить
повторный:  повторные
легендарный:  легендарный
рассматривать:  рассматриваемое
б:  б
базисный:  базисным базисными базисных
состоять:  состоит
фнп:  фнп
особый:  особую
простейшее:  простейшие простейшего
конец:  конце
часть:  частям части
большинство:  большинства большинстве
определённый:  определённое определенный определенного
двойной:  двойные двойной
компактный:  компактнее компактном
несобство:  несобств
известный:  известны
нелинейный:  нелинейная
преобразованиеквадратичный:  преобразованиеквадратичной
напрашиваться:  напрашивается
навык:  навыками
функциональный:  функциональные
разрешиться:  разрешилась
абсолютный:  абсолютная
встречаться:  встречаются встречается
сложенияй:  сложенияи
регрессия:  регрессии регрессия
рассказать:  расскажу
исчисление:  исчисления
локальный:  локальная
ожидание:  ожидание
лаплас:  лапласа
перегиб:  перегиба
предыдущий:  предыдущем
сходимость:  сходимости сходимость
справедливость:  справедливости
ду:  ду
обладать:  обладает обладают
мысль:  мысль
коэффициент:  коэффициент коэффициенты
неопределённый:  неопределенный неопределенном
собственный:  собственные
упрощаться:  упрощаются
признак:  признак признаки
недостаток:  недостаток
рядом:  рядом
поэтому:  поэтому
практика:  практике
вместо:  вместо
разумеется:  разумеется
менять:  меняет
безусловно:  безусловно
противный:  противном
коль:  коль
асимметрия:  асимметрия
шаг:  шаге шага
ненаглядный:  ненаглядным ненаглядный
главный:  главную
установить:  установить
сводиться:  сводящиеся
собственно:  собственно
замена:  замены
красивый:  красивой
записать:  запишем записать записаны
например:  например
решенияопределённый:  решенияопределенных
элементарный:  элементарна
задаваться:  задаётся
действительность:  действительности
хотя:  хотя
подобрать:  подобрал
выражать:  выражаем выражающие выражают
порешать:  порешать
коэффициентковариация:  коэффициентковариации
обозначать:  обозначает
очевидец:  очевидцами
лопиталя:  лопиталя
поменять:  поменять
недопонимание:  недопонимание
поляформула:  поляформула
наверное:  наверное
искажение:  искажение
фехнера:  фехнера
водиться:  водится
эффективный:  эффективные
условный:  условные
эллипс:  эллипс
дополнение:  дополнений
хватать:  хватает
даламбер:  даламбера
разобрать:  разобранном
теорема:  теоремы
единица:  единицы
повторнойя:  повторнойи
углубляться:  углубляясь
комплексный:  комплексные комплексного комплексный комплексными
аналогия:  аналогии
скобка:  скобки скобках
ранг:  ранг
расписывать:  расписывать
кривая:  кривой
тяжестиплоска:  тяжестиплоской
задавать:  задают задаваемые
относительно:  относительно
появление:  появление
повестка:  повестке
настоящий:  настоящей
внимание:  внимание
предназначить:  предназначена
лейбниц:  лейбница
привести:  приведу привести
протестировать:  протестировать
демонстрационный:  демонстрационном демонстрационного
преобразовать:  преобразовать
неравенство:  неравенства
пришлый:  пришлой
старый:  старом старой старых старые старым
поток:  поток
тематический:  тематических
кто:  кого
алгебраический:  алгебраических
медиана:  медиана
направлениюй:  направлениюи
гостевой:  гостевая
скоро:  скоро
переписать:  перепишем
кроме:  кроме
понятно:  понятно
наклонить:  наклоните
внутригрупповаяй:  внутригрупповаяи
пара:  пару
сумма:  сумму сумма
наоборот:  наоборот
мешать:  мешает
существовать:  существует
изучать:  изучающим
прямоугольник:  прямоугольников
эксцессэмпирический:  эксцессэмпирического
изложение:  изложения
учесть:  учесть
оценка:  оценка оценки
палец:  пальцы пальцах палец
родственный:  родственная
криволинейный:  криволинейные
различный:  различных
библиотека:  библиотека
каждый:  каждый
наименьшеезначение:  наименьшеезначения
сила:  силы
вычислимый:  вычислим
системылинейный:  системылинейных
нужно:  нужно
смело:  смело
зависимость:  зависимость
замкнутый:  замкнутому
очевидный:  очевидно
показатель:  показатели
площадьс:  площадьс
любить:  любите
убыванией:  убываниеи
повышенный:  повышенной
статистический:  статистическая статистические
наглядный:  наглядный
интегрирование:  интегрирование
легко:  легко
рациональный:  рациональные
подвергнуться:  подвергся
ситуация:  ситуация
читать:  читайте
интервальный:  интервальный
элемент:  элементов элементы
итак:  итак
соответственно:  соответственно
вообще:  вообще
желание:  желание
оценкия:  оценкии
неявный:  неявной
тандем:  тандеме
чистый:  чистом
несобственныхинтеграл:  несобственныхинтегралов
вероятностибиномиальный:  вероятностибиномиального
совместить:  совместить совместите
род:  рода
гаусс:  гаусса
параграф:  параграфе
экстремальный:  экстремальные
номер:  номер
умножить:  умножим
сохранение:  сохранением
студент:  студентов
нормаль:  нормали
определитель:  определитель
желать:  желающие
выпуклость:  выпуклость
интересно:  интересно
менее:  менее
удивительный:  удивительного
сложность:  сложности
значенияй:  значенияи
кстати:  кстати
синий:  синие
классическоеопределение:  классическоеопределение
инормаль:  инормаль
далёкий:  дальше
пирамида:  пирамида
рабочий:  рабочее
видимо:  видимо
находиться:  находятся находится
автор:  автор автора
приступить:  приступить
распоряжение:  распоряжении
дифференциальный:  дифференциальные
показаться:  показался
уравненияс:  уравненияс
онлайн:  онлайн
геометрия:  геометрии геометрия
нуль:  нуля
работа:  работа
произвольныйтройный:  произвольныйтройной
разложить:  разложить
дизайн:  дизайна
это:  это этим
принципиальный:  принципиальная
расположиться:  расположатся
поляй:  поляи
опечатка:  опечатку
речь:  речь
данный:  данном данный
технически:  технически
формулировка:  формулировка
непременно:  непременно
направление:  направлении
вызывать:  вызывает
методомоперационный:  методомоперационного
толк:  толку
бесповторный:  бесповторной
наверняка:  наверняка
правильно:  правильно
ошибка:  ошибку
соотношение:  соотношений
л:  л
важно:  важно
прижать:  прижмите
привычный:  привычный
возникнуть:  возникло
минор:  миноров
касательный:  касательных
значение:  значения
стиль:  стиль
большой:  большой
типовыхзадача:  типовыхзадач
ранговойкорреляция:  ранговойкорреляции
рука:  руки
прийти:  пришло
отдельно:  отдельно
переходить:  перехожу
независимый:  независимы независимые
исследовать:  исследовать
нетрудно:  нетрудно
порядок:  порядке порядку порядка порядков
поверхность:  поверхности
отличный:  отличны
линейныйкоэффициент:  линейныйкоэффициент
память:  памяти
контекст:  контексте
несобственныйинтеграл:  несобственныйинтеграл
доступно:  доступно
удобство:  удобства
причём:  причём
косых:  косых
учиться:  учимся
ипример:  ипримеры
множество:  множества
требоваться:  требуется требовалось
поверхностный:  поверхностные
принимать:  принимают
типовой:  типовом
фигура:  фигуры
пунктирный:  пунктирные
пуассон:  пуассона
изучение:  изучению изучения
однако:  однако
несмотря:  несмотря
математическоеожидание:  математическоеожидание
небольшой:  небольшая
школа:  школа
нарушать:  нарушает
осевой:  осевая
неоднородный:  неоднородные
необходимо:  необходимо
кратное:  кратные
добраться:  добрались
системудифференциальный:  системудифференциальных
алгоритм:  алгоритм
ориентировать:  ориентированы
последовательность:  последовательностей
квадратичный:  квадратичные
стандартный:  стандартных
объём:  объем
проверить:  проверить
поскольку:  поскольку
гипергеометрическоераспределение:  гипергеометрическоераспределение
обратить:  обратите
подстраиваться:  подстраиваются
удаться:  удастся
подробно:  подробно
равномерный:  равномерная равномерное
треугольный:  треугольная
необходимость:  необходимость
использовать:  используйте
пожалуйста:  пожалуйста
влево:  влево
следовать:  следует
себя:  собой
квадрат:  квадратов
сразу:  сразу
функциюкомплексный:  функциюкомплексной
обозначить:  обозначив
традиционный:  традиционное
вывести:  вывести
разный:  разную разной разные
мода:  мода
свойстваэлементарный:  свойстваэлементарных
считать:  считать
краткий:  краткое
калькулятор:  калькулятор
научиться:  научиться
сподручный:  сподручные
действительно:  действительно
экстремум:  экстремумы
горнера:  горнера
получать:  получаем
функцийв:  функцийв
ознакомиться:  ознакомиться
видеть:  видите
популярный:  популярный
иллюстрация:  иллюстрации
три:  трёх
отражение:  отражению
дискретнойслучайный:  дискретнойслучайной
простой:  простые
вычислять:  вычисляя
прекрасно:  прекрасно
крамер:  крамера
парабола:  парабола
строго:  строго
символический:  символические
выполнять:  выполняем
запретить:  запрещено
функциидвуха:  функциидвух
емелин:  емелин
вычисленияопределенный:  вычисленияопределенных
независимость:  независимости
задачин:  задачина
замечательный:  замечательные
знак:  знаки
системый:  системыи
удовлетворяетлить:  удовлетворяетли
соотносить:  соотносит
сегодня:  сегодня
приходиться:  приходится
аналитически:  аналитически
заданав:  заданав
всё:  всё
осложняться:  осложняется
что:  чём
тройной:  тройные
деление:  деления
почитать:  почитали
являться:  является
контуруформула:  контуруформула
частное:  частного
график:  график
дело:  деле дело
порождать:  порождает порождаемые
рекомендовать:  рекомендую
мир:  мире
обозначение:  обозначения
верный:  верном
запутать:  запутать
корреляция:  корреляции
увидеть:  увидеть
заочник:  заочников
говорить:  говоря
повторять:  повторяем
