вектор:  векторы векторов
творческий:  творческий
ось:  осью ось осями осей
вращение:  вращения
дифференциальный:  дифференциальные
первый:  первый первую первое первой первого
уравненияс:  уравненияс
программирование:  программирования
линия:  линию линиями линии линия линией
именно:  именно
пропорциональность:  пропорциональность
онлайн:  онлайн
разобрать:  разберём разобрать разобранные
смысл:  смысл смысле
геометрия:  геометрии геометрия
использоваться:  используется
копирование:  копирование
решить:  решить решим
рассмотреть:  рассмотрели рассмотрим рассмотрите
нижеследующий:  нижеследующей
разрыв:  разрыва
работа:  работа
выражение:  выражения
сумма:  сумма сумму
производный:  производные производная производной производную
прямой:  прямой прямую прямых прямые прямая
дуприближённо:  дуприближённо
подход:  подхода
новый:  новому
предел:  предел пределы пределов
слагаемое:  слагаемые
прочитать:  прочитайте прочитать
модель:  модели модель
произвольныйтройный:  произвольныйтройной
информация:  информации
боксёр:  боксёра
асимптота:  асимптоты
дизайн:  дизайна
прорисоваться:  прорисовались
это:  это
необходимость:  необходимости
событие:  события
отблагодарить:  отблагодарить
являться:  являются являться является
который:  которую которые которых который которой которая
повторный:  повторные
байес:  байеса
интерес:  интереса
числовой:  числовые
размерность:  размерности
возиться:  возиться
дисперсия:  дисперсию дисперсия дисперсии
решать:  решать решаем
производныенеявно:  производныенеявно
значение:  значение значения значениями значении
скорее:  скорее
решение:  решений решением решению решение решения
маленький:  маленькими меньше
поляй:  поляи
точность:  точности
интеграл:  интегралы интеграла интеграл интеграле интегралов
двумерный:  двумерном двумерная
находиться:  находится находятся
обвести:  обведён обвести
халява:  халявы
опечатка:  опечатку
неравенство:  неравенствами неравенство неравенству неравенств неравенства неравенствам неравенстве
чертить:  чертим
входить:  входить входит
красный:  красными красные красной красный
б:  б
математический:  математические математическая математической математического
теория:  теория теории
отсутствовать:  отсутствует
выгодный:  выгоднее
расширяться:  расширяется
состоять:  состоит
данный:  данную данном данного данное
преобразовать:  преобразуем
игрек:  игрек игреки игреками
формула:  формулы формула
смотреть:  см
дополнительно:  дополнительно
нулевой:  нулевым
сам:  сами самого саму сама самих самом
статья:  статье статьи
фнп:  фнп
аналитический:  аналитическим аналитическая аналитическое аналитической
прийтись:  придётся
канонический:  каноническому
небольшой:  небольшими небольшая
простейшее:  простейшие простейшими простейшее
метод:  методе методы методом метод
положительный:  положительными положительное положителен
умножить:  умножить умножено
два:  две двумя двух
гипотеза:  гипотезы гипотез гипотеза
дифференциал:  дифференциалах дифференциала
больший:  наибольшее
подсказка:  подсказка
расчёт:  расчётов расчёты
известно:  известно
стрелка:  стрелки стрелками
задать:  заданной задайте
один:  одну одной одна
конец:  конце
часть:  частям часть части
тело:  тела
циркуляция:  циркуляция
методомоперационный:  методомоперационного
бесповторный:  бесповторной
правильно:  правильно
любой:  любую любой любая любом любого
двойной:  двойные двойной
лежать:  лежат
ошибка:  ошибку
плоскость:  плоскости плоскость
несобство:  несобств
прямоугольный:  прямоугольной
л:  л
общий:  общим общая общем общего общее
константа:  констант
нелинейный:  нелинейная
получиться:  получится
разновидность:  разновидности
оставить:  оставить
правый:  правая правую
преобразованиеквадратичный:  преобразованиеквадратичной
определителяй:  определителяи
нестрогий:  нестрогим нестрогие нестрогими нестрогому нестрогое
число:  число числами числа
вогнутостья:  вогнутостьи
степень:  степени
важно:  важно
вид:  виде виды виду
становиться:  становится
несложно:  несложно
закон:  законы
справа:  справа
водить:  водить
нижний:  нижней нижняя
функциональный:  функциональные
ломаный:  ломаной
слово:  слову словами
строгий:  строгое строгие строгим
графический:  графическое
случай:  случай случая случаев случае
взять:  взять
касательный:  касательных
строить:  строим строили строить
качество:  качестве
последний:  последнем
разбираться:  разбираемся
профессия:  профессию
неправда:  неправда
тот:  той те та
действие:  действий действия
построение:  построением построение построения
пусть:  пусть
геометрический:  геометрическая геометрический геометрическое
абсолютный:  абсолютная
типовыхзадача:  типовыхзадач
графика:  графика графики
умножение:  умножения
вероятность:  вероятностей вероятность вероятности
ранговойкорреляция:  ранговойкорреляции
система:  система систему системе системы
частный:  частные частное
функция:  функций функцию функции функция
сплошной:  сплошной
группировка:  группировок группировка
непрерывный:  непрерывная непрерывных
условнаясходимость:  условнаясходимость
обозначить:  обозначена обозначено
сложенияй:  сложенияи
уравненийв:  уравненийв
цвет:  цвет
полуплоскость:  полуплоскости полуплоскость
регрессия:  регрессии регрессия
величина:  величин величина величины
александр:  александр
ограничиться:  ограничусь
искомое:  искомое
зачесть:  зачтут
ограничить:  ограничена
ныне:  ныне
грин:  грина
полный:  полное полных полной
линейный:  линейные линейная линейное линейную линейных линейного линейной
исчисление:  исчисления
жизнь:  жизни
координатный:  координатной координатных координатные координатными координатную координатная
четверть:  четверти четверть
эйлер:  эйлера
многоугольник:  многоугольником многоугольника многоугольник
ребёнок:  дети
громоздкий:  громоздкое
актуальный:  актуален
добавляться:  добавляются добавляется
пунктирный:  пунктирная
согласие:  согласия
годиться:  годится
локальный:  локальная
глубокий:  глубоких
ожидание:  ожидание
ничегошеньки:  ничегошеньки
придерживаться:  придерживаться
математика:  математики математике
такой:  таким такие такое такими
лаплас:  лапласа
перегиб:  перегиба
присутствовать:  присутствуют
предыдущий:  предыдущем предыдущих
сходимость:  сходимости сходимость
дуоперационный:  дуоперационным
вкратце:  вкратце
амуниция:  амуницией
составить:  составленная составить составим составит
представить:  представить
дискретный:  дискретный
пригодиться:  пригодится
исследовать:  исследовать
выбрать:  выберем
базис:  базисах базис базису
серьёзность:  серьёзностью
нетрудно:  нетрудно
поверхность:  поверхности
знакочередоваться:  знакочередующиеся
задача:  задачи задачу задаче задач задачах
векторный:  векторного векторное
проанализировать:  проанализировав
член:  член
ду:  ду
далее:  далее
зависимостьвектор:  зависимостьвекторов
линейныйкоэффициент:  линейныйкоэффициент
распространить:  распространённый
снова:  снова
оно:  оно
коэффициент:  коэффициент коэффициенты
неопределённый:  неопределенный неопределенном
история:  историю история
удовлетворять:  удовлетворять удовлетворяет удовлетворяют
приходить:  приходим
сначала:  сначала
круг:  круг
дробь:  дробей
страница:  страницу
собственный:  собственные
признак:  признак признаки
несобственныйинтеграл:  несобственныйинтеграл
произвольный:  произвольных произвольную
граница:  границу
данные:  данных
сложный:  сложной сложных сложные
справка:  справку
рассмотрение:  рассмотрению
различать:  различают
принадлежащий:  принадлежащая принадлежащую принадлежащие
доступно:  доступно
причём:  причём
переноситься:  переносятся
пятёрка:  пятёрку
фурье:  фурье
урок:  урока урок уроке
поле:  поля поле
правильный:  правильный
разложение:  разложением разложение
поэтому:  поэтому
разделить:  разделить
свойство:  свойства
практика:  практике
точка:  точка точки точкой точку точках точками точкам точек точке
задавать:  задаваемые задаёт
начало:  началом начало начале
вершина:  вершинами вершины вершин вершина
напоминать:  напоминает
переносить:  переносим
исследование:  исследование
икс:  икс иксы
принцип:  принципе
опыт:  опыта
ипример:  ипримеры
уравнение:  уравнению уравнений уравнения уравнение уравнением
множество:  множества множество
мочь:  можете могут
никакой:  никаких
переход:  переход
вариация:  вариации
найти:  найти найдём
асимметрия:  асимметрия
шаг:  шаге
оценка:  оценки оценка
требоваться:  требуется
комплексный:  комплексными комплексные комплексного комплексный
основа:  основы
поверхностный:  поверхностные
остаться:  оставшуюся останется
переходить:  переходим
интервал:  интервалы
книга:  книга книги
главный:  главную
кош:  коши
сверху:  сверху
координата:  координат координаты координатах
фигура:  фигуры
выше:  выше
пуассон:  пуассона
успех:  успехов
сводиться:  сводящиеся
чайник:  чайников
смена:  сменой
замена:  замены
алгоритм:  алгоритма алгоритм
преобразование:  преобразований преобразовании преобразования
вычисленияс:  вычисленияс
однако:  однако
целесообразно:  целесообразно
малый:  малые наименьших
связь:  связь
таки:  таки
понижение:  понижением понижение
матричный:  матричные матричных матричный
всякий:  всяких
текст:  тексту
получить:  полученное полученной получено получи
любоваться:  любуемся
заметить:  заметили заметить
подопытный:  подопытной подопытную
ответ:  ответе ответ ответы
математическоеожидание:  математическоеожидание
например:  например
однородный:  однородные однородным
решенияопределённый:  решенияопределенных
дать:  данной дана данному даны
вычислить:  вычислить
определение:  определение определения определению
нормальный:  нормальное
школа:  школа
очень:  очень
задаваться:  задаётся
интегральнаятеорема:  интегральнаятеоремы
удобный:  удобнее удобный
хотя:  хотя
корнимногочлен:  корнимногочлена
логарифмический:  логарифмическая
матрица:  матрицу матрицы матрицами
голубой:  голубая
испытанияй:  испытанияи
интегралыть:  интегралыв
универсальный:  универсальный
неоднородный:  неоднородные
начать:  начнём начать
перегруппировка:  перегруппировка
правило:  правило правила
основной:  основные
свободный:  свободный
помощь:  помощью
бернулли:  бернулли
стать:  стала станет
несовместный:  несовместной несовместные
полярный:  полярные полярной полярных
коэффициентковариация:  коэффициентковариации
ряд:  ряд ряды ряда ряде рядов
средний:  средней средняя
вариационный:  вариационный
уровень:  уровня
обратный:  обратная обратную
второй:  второй втором второго вторую
должный:  должны должно должна
думать:  думаю
вопрос:  вопросы вопросам вопрос
кратное:  кратные
учиться:  учимся
определять:  определяли определяющее определяющих определяют определяет
политика:  политика
значительно:  значительно
системудифференциальный:  системудифференциальных
серьёзно:  серьёзно
чистовик:  чистовик
блог:  блог
доверительный:  доверительные
простой:  простейших простыми простейший простым
высокий:  высших высшей высшая
редкость:  редкость
помимо:  помимо
подходящий:  подходящую
вывод:  выводу вывод
среднееквадратический:  среднееквадратическое
превращать:  превращать
работать:  работать
каноничный:  каноничная
абсцисса:  абсцисс
приводить:  приводить
воз:  воз
пространство:  пространстве
долго:  долго
каков:  каков
уметь:  уметь
пример:  примеры пример примеров примерах
тип:  типа
лопиталя:  лопиталя
подбор:  подбором
называться:  называется
последовательность:  последовательностей
комбинационный:  комбинационная
курс:  курс
оба:  обе оба
итоговый:  итоговый
квадратичный:  квадратичные
обычно:  обычно
смешанноепроизведение:  смешанноепроизведение
ордината:  ординат
меняться:  меняется
лебедь:  лебедь
вспомогательный:  вспомогательный
расписать:  расписать
объём:  объем
десятка:  десятку
вместе:  вместе
поляформула:  поляформула
проверить:  проверить
проверка:  проверки проверка
сообщить:  сообщите
постараться:  постарайтесь
сделать:  сделать
фехнера:  фехнера
определить:  определить
жениться:  жениться
равняться:  равняется
поскольку:  поскольку
школьный:  школьный школьные
эффективный:  эффективные
левый:  левой левая левую
мы:  нам нами
центр:  центр
образ:  образом
гипергеометрическоераспределение:  гипергеометрическоераспределение
выбирать:  выбираем
верхний:  верхнюю верхняя верхней
условный:  условные
непрерывнаяслучайный:  непрерывнаяслучайная
неверный:  неверное
эллипс:  эллипс
перестараться:  перестарался
прямо:  прямо
прозаичный:  прозаичная
длина:  длина
искомый:  искомые искомая
материал:  материал материалы материалов
сайт:  сайта сайты сайт
немного:  немного
знакопостоянство:  знакопостоянства
подробно:  подробно
проводить:  проводить проводим
равномерный:  равномерная равномерное
каждый:  каждому каждой
неплохо:  неплохо
треугольный:  треугольная
градиент:  градиент
чертёж:  чертёж чертеже
сузиться:  сузилась
трудность:  трудности
подстановка:  подстановкой
использовать:  используйте использовать
пожалуйста:  пожалуйста
даламбер:  даламбера
сторона:  сторону стороны
попутно:  попутно
теорема:  теоремы
ясно:  ясно
комбинаторика:  комбинаторике
затем:  затем
случайнаявеличина:  случайнаявеличина
красота:  красоты
повторнойя:  повторнойи
следовать:  следует
бесконечно:  бесконечно
щука:  щуки
линейнойкорреляционный:  линейнойкорреляционной
синий:  синяя синими синие
деятельность:  деятельности
себя:  собой
лекция:  лекцию
ранг:  ранг
квадрат:  квадратов
возникнуть:  возникнут
кривая:  кривой
оставаться:  остаётся
форма:  формы
двоечник:  двоечника двоечников
тяжестиплоска:  тяжестиплоской
сразу:  сразу
распределениякритерия:  распределениякритерий
функциюкомплексный:  функциюкомплексной
третий:  третью третьего
область:  область области
читаемый:  читаем
попасть:  попадёт попали
палитра:  палитру
построить:  построить построим
готовый:  готовых
несобственный:  несобственные
просто:  просто
мода:  мода
следующий:  следующую следующий следующим
свойстваэлементарный:  свойстваэлементарных
ещё:  ещё
дэ:  дэ
рак:  рак
лейбниц:  лейбница
калькулятор:  калькулятор
встать:  встаньте
протестировать:  протестировать
ради:  ради
научиться:  научиться
нужный:  нужную нужной
прямоугольник:  прямоугольник прямоугольников
войти:  войдёт
ограниченный:  ограниченная ограниченный ограниченной
наш:  наше наш нашей
соответствовать:  соответствующую соответствует
поток:  поток
касательная:  касательная
задачис:  задачис
моделирование:  моделирования
разобраться:  разобраться
медиана:  медиана
бывать:  бывает
рациональный:  рационального рациональные
функциия:  функциии
степенной:  степенного степенные
функцийдвуха:  функцийдвух
направлениюй:  направлениюи
определённый:  определенный определенного
выборка:  выборке
гостевой:  гостевая
рисунок:  рисунок
проделать:  проделанных
айса:  айс
многовато:  многовато
сложённый:  сложены
действительно:  действительно
распределение:  распределения распределение
кроме:  кроме
экстремум:  экстремумы
перечисленный:  перечисленных
известный:  известного
насущный:  насущным
горнера:  горнера
производныефункция:  производныефункции
провести:  проведённого проведена провести
пересечение:  пересечения пересечением
понятно:  понятно
функцийнесколький:  функцийнескольких
знак:  знаком знака знак
главное:  главное
внутригрупповаяй:  внутригрупповаяи
молния:  молниями
алгебра:  алгебры
плюс:  плюс
сплошняк:  сплошняком
далеко:  далеко
получать:  получаем
математик:  математика
хоровод:  хороводы
функцийв:  функцийв
переменный:  переменных переменную переменной переменные
независимыеслучайный:  независимыеслучайные
множественнойлинейный:  множественнойлинейной
нравиться:  нравится
анализ:  анализ анализа
следовательно:  следовательно
непрерывность:  непрерывность
отличаться:  отличаться
эксцессэмпирический:  эксцессэмпирического
способ:  способами способ
заштриховать:  заштриховать заштрихован
закомментировать:  закомментировать
функциис:  функциис
угодный:  угодно
проясниться:  прояснится
помечать:  помечаем
этот:  этому этих эта
среди:  среди
зеркало:  зеркало
криволинейный:  криволинейные
значит:  значит
различный:  различных
лёгкий:  легче
пугать:  пугать
пирсон:  пирсона
понимать:  понимать понимаем
библиотека:  библиотека
три:  трёх
считать:  считанные
идея:  идея
межгрупповой:  межгрупповая
ортогональный:  ортогональное
дискретнойслучайный:  дискретнойслучайной
задачипо:  задачипо
трудный:  трудного
востребовать:  востребованную
наименьшеезначение:  наименьшеезначения
нсв:  нсв
отмечать:  отмечаем
стиль:  стиле
сила:  силы
ясность:  ясности
приблизить:  приближенные
вычислимый:  вычислим
пометить:  помечена
большой:  велики
вариант:  вариант
системылинейный:  системылинейных
нужно:  нужно
вроде:  вроде
буквенный:  буквенные
образец:  образец
хотеться:  хотелось хочется
примечание:  примечание
упасть:  упал
чистовой:  чистового
зависимый:  зависимые
художественный:  художественную
принципиальный:  принципиальное
зависимость:  зависимость
отклонение:  отклонение
крамер:  крамера
отрезка:  отрезке
другой:  другие другая
таблица:  таблицы
произведение:  произведение
вполне:  вполне
одновременно:  одновременно
случайный:  случайных случайные
замкнутый:  замкнутому
очевидный:  очевидно очевидны
сколько:  сколько
цэ:  цэ
дуга:  дуги
внимательно:  внимательно
отрезкать:  отрезкав
желать:  желаю
дивергенция:  дивергенция
парабола:  парабола
заведомо:  заведомо
карандаш:  карандашом
утверждение:  утверждению
форум:  форуме форум
показатель:  показатели
оформление:  оформления оформлении
отличие:  отличие
словосочетание:  словосочетание
четвёртый:  четвёртую
площадьс:  площадьс
запретить:  запрещено
функциидвуха:  функциидвух
большинство:  большинстве
статистический:  статистические статистическая
черновик:  черновике
емелин:  емелин
пять:  пяти
деваться:  деваться
умножать:  умножаем
причина:  причине
самый:  самая самый
убыванией:  убываниеи
вычисленияопределенный:  вычисленияопределенных
повышенный:  повышенной
детерминация:  детерминации
возрастание:  возрастание
эмпирический:  эмпирические
интегрирование:  интегрирование
подставить:  подставим
задачин:  задачина
замечательный:  замечательные
отрицательный:  отрицательное
системый:  системыи
удовлетворяетлить:  удовлетворяетли
найтись:  нашлось
начертить:  начертим
выполнить:  выполнить
аналогично:  аналогично
нуль:  нулю
дифференциальныеуравнение:  дифференциальныеуравнения
приходиться:  приходится
иррациональный:  иррациональных
мыслительный:  мыслительных
интервальный:  интервальный
тригонометрический:  тригонометрических
постоянный:  постоянных
стокс:  стокса
квадратичнуюформ:  квадратичнуюформу
схема:  схема
карта:  карта
параметрический:  параметрической параметрическом
неформально:  неформально
многочлен:  многочлена многочлен
знать:  знать
гипербола:  гипербола
самостоятельно:  самостоятельно
жирный:  жирнее
вообще:  вообще
быть:  будут
равно:  равно
дробовик:  дробовик
они:  ними
принадлежать:  принадлежит
лично:  лично
оценкия:  оценкии
неявный:  неявной
параграф:  параграф параграфе
простота:  простоте
встречаться:  встречается
несобственныхинтеграл:  несобственныхинтегралов
вероятностибиномиальный:  вероятностибиномиального
луч:  лучами
лакомый:  лакомая
вероятностия:  вероятностии
логика:  логики
спирмена:  спирмена
скалярный:  скалярное
род:  рода
гаусс:  гаусса
заданав:  заданав
совершенно:  совершенно
порядок:  порядка порядков
всё:  всё
зелёный:  зелёными
значимость:  значимости
изобразить:  изобразим
мечта:  мечта
тройной:  тройные
деление:  деления
некоторый:  некоторая
попытаться:  попытайтесь
заключительный:  заключительный
проштудировать:  проштудировать
контуруформула:  контуруформула
какой:  каким
экстремальный:  экстремальные
некуда:  некуда
увы:  увы
график:  график
процесс:  процессов
верный:  верное
ключевой:  ключевое
её:  её
парный:  парной
св:  св
вычесть:  вычтено
нормаль:  нормали
определитель:  определитель
пытка:  пыток
секунда:  секунды
малиновый:  малиновой
существовать:  существуют
выпуклость:  выпуклость
противоположный:  противоположный
примерный:  примерный
элемент:  элементы
достаточно:  достаточно
сборник:  сборники
показательный:  показательное
либо:  либо
формальный:  формален
рекомендовать:  рекомендую
независимый:  независимые
тянутый:  тянут
менее:  менее
принципиально:  принципиально
автор:  автора автор
сложность:  сложности
диффура:  диффурами
почленно:  почленно
часто:  часто
значенияй:  значенияи
соответствующий:  соответствующие
изучение:  изучения
перейти:  перейдём
привести:  привести
поиск:  поиска
весьма:  весьма
весь:  всей
дело:  дело
открытый:  открытая
обозначение:  обозначения
получаться:  получается
кстати:  кстати
хороший:  хороший
вычисление:  вычисление
находить:  находим
труд:  труда
классическоеопределение:  классическоеопределение
инормаль:  инормаль
представлять:  представляет
статистика:  статистика
тетрадь:  тетради
пунктир:  пунктиром
корреляция:  корреляции
условие:  условию
биномиальный:  биномиальное
подруга:  подругой
включая:  включая
редкий:  реже
пирамида:  пирамида
штриховать:  штрихуем
заочник:  заочников
иметь:  иметь
разный:  разные
линиюв:  линиюв
масштаб:  масштаба
самостоятельный:  самостоятельного
отношение:  отношении
повторять:  повторяем
понимание:  понимания
второе:  второе
устно:  устно
стрелочка:  стрелочками
