окаймлять:  окаймляющих
смерть:  смерти
перебор:  перебора перебор
обязать:  обязана
третий:  третьим третью третьего третьей
столбцы:  столбцов столбцы
повстречаться:  повстречается
полезный:  полезен
справка:  справка
математический:  математических математическая математические математической
неоднократно:  неоднократно
транспонировать:  транспонируем
производный:  производные производная производной производную
предел:  предел пределы пределов
выбор:  выбор
числовой:  числовые
производныенеявно:  производныенеявно
значение:  значение
скорее:  скорее
входить:  входить
находить:  находить находим
формула:  формулы формула
смотреть:  см
новизна:  новизной
канонический:  каноническому
бояться:  боюсь
два:  две двум двух
дифференциал:  дифференциалах дифференциала
больший:  наибольшее большая больших
нередко:  нередко
многие:  многие
подробный:  подробные подробной
разработать:  разработан
означать:  означает
качественный:  качественнее
прямоугольный:  прямоугольной
квадратный:  квадратной квадратная
число:  число числе числами чисел числа
вогнутостья:  вогнутостьи
посему:  посему
многий:  многих
позволять:  позволяет
юмористический:  юмористическом
плохой:  хуже
профессия:  профессию
срезать:  срезали
направить:  направленные направлено
умножение:  умножения
жить:  живут
система:  система системе системах систему системы
задействовать:  задействовать
группировка:  группировок группировка
познакомиться:  познакомимся
условнаясходимость:  условнаясходимость
александр:  александр
ничуть:  ничуть
который:  которые который которая которое которую которых которой
линейный:  линейные линейная линейных линейной
помочь:  помогло помог
метод:  метода методы методах методом методе метод
посмотреть:  посмотрел посмотреть посмотрят
равенство:  равенство
быть:  суть буду будем будешь
согласие:  согласия
идея:  идее
рассматривать:  рассматриваемый рассматриваем рассматриваемое рассматриваемые
раскручивать:  раскручиваем
дуоперационный:  дуоперационным
базис:  базисах базису базис базиса
хитрый:  хитрой
наиболее:  наиболее
идти:  идти
работать:  работаю работать работает
зависимостьвектор:  зависимостьвекторов
шаг:  шагу шаге
неточность:  неточность
получаться:  получалось получается
снова:  снова
оно:  оно
предложный:  предложен
молодёжный:  молодёжному
сначала:  сначала
рассматриваться:  рассматривается
геометрически:  геометрически
страница:  страницу
коллега:  коллеге
ликвидация:  ликвидацию
данные:  данных
интеграл:  интеграл интегралов интегралы интеграла интеграле
урок:  урока уроках уроке
получение:  получение
разложение:  разложением разложение
друг:  друга друг
лишний:  лишние лишним
вывести:  выведем
уравнение:  уравнению уравнения уравнение уравнений
переход:  переход
находиться:  находящиеся находятся
утверждение:  утверждение
балл:  балла
определитель:  определителем определителя определителей определитель
первый:  первое первую первом первого первый первые
очередь:  очередь
вектор:  векторах векторы векторов вектора вектор
бесполезный:  бесполезен
малый:  малые наименьших малейшую
связь:  связь
понятие:  понятием понятие
добрый:  добрым
экземпляр:  экземпляре
текст:  тексту
аналогичный:  аналогичной аналогичные
нулевой:  нулевую нулевым нулевые нулевая нулевыми нулевой нулевых
плохо:  плохо
нормальный:  нормальное
расширить:  расширенная расширенную расширенной расширим
интегральнаятеорема:  интегральнаятеоремы
некоторый:  некоторой некоторых
куча:  кучи
корнимногочлен:  корнимногочлена
логарифмический:  логарифмическая
условие:  условие условию
начать:  начнём начать
основной:  основные
бернулли:  бернулли
полярный:  полярные полярных полярной
мой:  моего
рассмотреть:  рассмотрим рассмотренном рассмотренной
ряд:  ряды ряда ряд ряде рядов
уровень:  уровня
аффинный:  аффинного аффинный
должный:  должны должен
определённый:  определённого определёнными определённое определенный определенного
значительно:  значительно
безымянный:  безымянная
главный:  главным главную
доверительный:  доверительные
буква:  буквой
смысл:  смысле смысла смыслом
дать:  дадим дана данной
среднееквадратический:  среднееквадратическое
оценка:  оценку оценка оценки
американский:  американский
говориться:  говорится
комбинационный:  комбинационная
минор:  миноры минора минорами минору миноров минор минором
оба:  обе
смешанноепроизведение:  смешанноепроизведение
оказаться:  окажутся оказались оказался
функция:  функции функция функций
уложить:  уложить
дисперсия:  дисперсия дисперсии дисперсию
школьный:  школьный школьные
эпиграф:  эпиграфе
греческий:  греческой
класс:  классов
мы:  нам
образ:  образом
непрерывнаяслучайный:  непрерывнаяслучайная
другой:  других другое другие
четыре:  четыре четырёх
единственно:  единственно
длина:  длина
немного:  немного
знакопостоянство:  знакопостоянства
алгоритм:  алгоритму алгоритма алгоритм
градиент:  градиент
красный:  красного красному
линия:  линия линии линиями
комбинаторика:  комбинаторике
случайнаявеличина:  случайнаявеличина
бесконечно:  бесконечно
давать:  даёт давайте
четвёртый:  четвёртый четвёртую
форма:  формы
равный:  равны равным равен
задача:  задачу задаче задачи задач
содержательный:  содержательным
отметить:  отметить
несовместный:  несовместна несовместные несовместных
статья:  статьи статья статье
абстрактный:  абстрактны
фраза:  фразу фразой
алгебра:  алгебре алгебры
обратный:  обратную обратная обратный обратной
дополнительный:  дополнительные
ненулевой:  ненулевое ненулевой ненулевых ненулевые ненулевого
готовый:  готовых готово
просто:  просто
получить:  получены получим получено получить получена получи
ещё:  ещё
прибавить:  прибавили
вернуться:  вернёмся
картинка:  картинками
сегодняшний:  сегодняшнем
порядок:  порядком порядок порядку порядка порядков
неколлинеарный:  неколлинеарных
выражаться:  выражаясь выражаться выражаются
совпадать:  совпадающий совпадает
отличаться:  отличается отличаться
обращать:  обращаю
нахождение:  нахождения нахождении
краткий:  краткий краткое
частый:  чаще
один:  одних одно одного одна одной одном одни
читатель:  читателей
высокий:  высокого высокой высших высшей высшая
очевидный:  очевидна очевидно
данный:  данного данную данном данное данный
непрерывный:  непрерывных непрерывная
производныефункция:  производныефункции
средний:  средняя средних
пересечение:  пересечения пересечении
превзойти:  превзойдёт
единица:  единице единицы
обнаружить:  обнаружен
ориентир:  ориентир
область:  области область
последний:  последние
математик:  математика
ограничиваться:  ограничивается
переменный:  переменных переменной переменными
пример:  пример примера примеров примере примеры
независимыеслучайный:  независимыеслучайные
прогулка:  прогулку
добавить:  добавить добавим
вверх:  вверх
выяснение:  выяснения
следовательно:  следовательно
модель:  модель модели моделях
непрерывность:  непрерывность
удалять:  удаляем
остаться:  осталась останется
функциис:  функциис
угодный:  угодно
полный:  полной полных полный полное
зеркало:  зеркало
второй:  втором второго второй вторую вторая
уменьшать:  уменьшать
значит:  значит
заряжать:  заряжаем
исходный:  исходная исходным
пирсон:  пирсона
реальный:  реальной
умножить:  умножили умноженную
вопрос:  вопрос вопросе вопросом вопросы
хороший:  хороших хороший лучшего
межгрупповой:  межгрупповая
ортогональный:  ортогональное
найтись:  нашёлся нашлось
заменить:  заменить
кривой:  криво
нсв:  нсв
получать:  получаемые
схема:  схему схема схеме
вроде:  вроде
прорешана:  прорешаны
столбец:  столбце столбец столбцам столбца
придумать:  придумал
упасть:  упал
ход:  ходе ход
отрезка:  отрезке
пятый:  пятую пятый пятой
величина:  величина величин величины
важный:  важный важными важное
порой:  порой
строчка:  строчку
заведомо:  заведомо
шт:  шт
словосочетание:  словосочетание
практический:  практическое практический
количество:  количеству количества количество количеством
перебирать:  перебираем
анализировать:  анализировать
детерминация:  детерминации
обязательно:  обязательно
тот:  тех той ту
матрица:  матрицей матрицу матриц матрицы матрица матрицами матрице
дифференциальныеуравнение:  дифференциальныеуравнения
огромный:  огромной
прямой:  прямая прямой прямую
взять:  возьмём взяли взять
общепринятый:  общепринятого
гипотетичный:  гипотетично
постоянный:  постоянных
стокс:  стокса
предполагать:  предполагает
степень:  степень степени
удостаиваться:  удостаивается
дробовик:  дробовик
параграф:  параграф
математика:  математике математики
векторный:  векторное векторного
сам:  самом сама само самой
вероятностия:  вероятностии
скалярный:  скалярное
знание:  знание знаний
следующий:  следующее следующим следующему следующем
совершенно:  совершенно
наш:  нашем наши нашим наш нашего
понятный:  понятен
значимость:  значимости
записать:  записал записать записаны
анализ:  анализа анализ
построение:  построения построение построении
её:  её
частный:  частное частные
парный:  парной
координата:  координатами координаты координатам координат координатах
вычисление:  вычислении вычисления вычисление вычислений
несколько:  несколько
сборник:  сборники
параметрический:  параметрическом параметрической
признаться:  признаться
делать:  делаем
часто:  часто
выполняться:  выполняются
неплохой:  неплохие
решение:  решение решением решения решений
место:  место местами
выводить:  выводить
форум:  форум форуме
алгебраический:  алгебраической алгебраические
необходимый:  необходимом необходимы
книга:  книги книга
провести:  провести
менять:  менять меняет меняют
обратиться:  обратимся
задание:  задание заданий заданиям
вращение:  вращения
эмпирический:  эмпирическим эмпирические
копирование:  копирование
разрыв:  разрыва
выражение:  выражения выражение
подразумевать:  подразумевают подразумевает
эквивалентный:  эквивалентная эквивалентные
роль:  роль
максимум:  максимум
необходимость:  необходимости
отблагодарить:  отблагодарить
думать:  думаешь думаю
байес:  байеса
простой:  проще проста
размерность:  размерности размерность
решать:  решать
результат:  результат результате результаты
теория:  теория теории
отсутствовать:  отсутствует
называть:  называют называемого
двумерный:  двумерная
задать:  заданной задайте
тело:  тела
циркуляция:  циркуляция
непосредственно:  непосредственно
указанный:  указанном
плоскость:  плоскости плоскость
действовать:  действующим действовать
общий:  общим общая общем общее общую
странно:  странно
получиться:  получится получились
какой:  каком
поздний:  позже
определителяй:  определителяи
согласно:  согласно
закон:  законы
самый:  самым
качество:  качестве
дорожка:  дорожке
знакомый:  знакомую знакомы знакомо
ступенчатый:  ступенчатый ступенчатому
последовательно:  последовательно
действие:  действий действия действие
приём:  приёмами
догадываться:  догадываются
вероятность:  вероятностей вероятность вероятности вероятностью
человек:  человеку человека
любой:  любое любой любого любых любом
заключение:  заключение
уравненийв:  уравненийв
старый:  старую
иметь:  имеют имеет
угловой:  угловыми угловых углового
грин:  грина
эйлер:  эйлера
ядерный:  ядерные
малиновый:  малиновые малиновыми малиновый
компания:  компанию
годиться:  годится
известный:  известной известного
дискретный:  дискретный
знакочередоваться:  знакочередующиеся
информация:  информацией информации информация информацию
лестница:  лестницей
отпадать:  отпадает
являться:  являясь является
произвольный:  произвольных произвольные
сложный:  сложной сложные сложных
рассмотрение:  рассмотрению
ботинок:  ботинок
блат:  блата
советовать:  советовал
фурье:  фурье
поле:  поля
гипотеза:  гипотез гипотеза гипотезы
свойство:  свойства
сфера:  сферах
момент:  момент
служебный:  служебной
исследование:  исследование исследования
весь:  всем
точка:  точки точке
вариация:  вариации
основа:  основы
переходить:  переходим
мало:  мало
интервал:  интервалы
анекдот:  анекдота
кош:  коши
свободный:  свободных
выше:  выше
длительность:  длительность
чайник:  чайников
вычисленияс:  вычисленияс
мировой:  мировой
матричный:  матричные матричных матричный
проверка:  проверке проверку проверка
действительный:  действительное действительных
сокращение:  сокращения
заметить:  заметили заметьте заметить
однородный:  однородные однородным
записывать:  записываем
вычислить:  вычислить
очень:  очень
испытанияй:  испытанияи
интегралыть:  интегралыв
научиться:  научимся научиться
перегруппировка:  перегруппировка
теоретический:  теоретическая
доверить:  доверить
товарищ:  товарищей товарищу
помощь:  помощью помощь
истина:  истины
вариационный:  вариационный
элементарный:  элементарных элементарные
чистый:  чистую
исключение:  исключением исключения
линейно:  линейно
блог:  блог
ваш:  ваша ваш ваше
пространство:  пространстве пространства
снимать:  снимаем
удобный:  удобный
курс:  курс курсе
младший:  младший младшему
сообщить:  сообщите
сделать:  сделать
аналитический:  аналитическая аналитической
понижение:  понижение понижением
центр:  центр
сложение:  сложения
быстрый:  быстрее
сообразить:  сообразим
вспоминать:  вспоминаем
включать:  включаем
линейнойкорреляционный:  линейнойкорреляционной
нести:  несёт
время:  время времени
ассоциация:  ассоциации
оставаться:  остаётся
кой:  коих
сухой:  сухой
пора:  пор
каждый:  каждом каждой
сила:  силу силы
почему:  почему
распределениякритерия:  распределениякритерий
отлично:  отлично
беспокоиться:  беспокойтесь
ожидание:  ожидания ожидание
несобственный:  несобственные
абзац:  абзац
определять:  определяемое
зрение:  зрения
представлять:  представлять
остаток:  остаток
питомец:  питомца
полностью:  полностью
занятие:  занятия
единичный:  единичным
касательная:  касательная
ответ:  ответ ответом ответы
задачис:  задачис
правило:  правила правилом правило
функциия:  функциии
возможно:  возможно
степенной:  степенного степенные
любимый:  любимого
функцийдвуха:  функцийдвух
выборка:  выборке
ключевой:  ключевую
функцийнесколький:  функцийнескольких
удалить:  удалили удалим удалив
член:  членов
рассчитать:  рассчитать рассчитан
лоб:  лоб
множественнойлинейный:  множественнойлинейной
согласоваться:  согласуется
зависимость:  зависимости зависимость
тема:  темы
распределение:  распределение распределения
оказываться:  оказывается
задавать:  задаёт задаваемые задавали
привычка:  привычки
задачипо:  задачипо
независимый:  независимых независимы независимые
востребовать:  востребованную
способность:  способностей
приблизить:  приближенные
небольшой:  невелик
эффективный:  эффективных эффективные эффективен
образец:  образец
примечание:  примечание
зависимый:  зависимые зависимы
прочее:  прочего
отклонение:  отклонение
следовать:  следовало следует
что:  чему
таблица:  таблицы
писать:  пишет
произведение:  произведение
знать:  знаете
вполне:  вполне
существование:  существования
кто:  кому
случайный:  случайных случайные
предварительно:  предварительно
дуга:  дуги
частность:  частности
стандартный:  стандартная стандартное стандартным стандартной
отрезкать:  отрезкав
играть:  играет
дивергенция:  дивергенция
сайт:  сайт сайты сайта
графика:  графики графика
оформление:  оформления
ситуация:  ситуации
причина:  причине
возрастание:  возрастание
этот:  этих
иррациональный:  иррациональных
отличный:  отличный отлична
определение:  определению определение определения
квадратичнуюформ:  квадратичнуюформу
карта:  карта
немец:  немец
гипербола:  гипербола
равно:  равно
они:  ними
коэффициент:  коэффициентами коэффициент
логика:  логики
материал:  материалов материалы
спирмена:  спирмена
подсчёт:  подсчёта
вид:  виду виды вид виде
пропорциональный:  пропорциональны пропорциональные
возникать:  возникает
минимальный:  минимальной минимальная
продвинуть:  продвинул
вовсе:  вовсе
лишь:  лишь
св:  св
пара:  пара
коллинеарный:  коллинеарного коллинеарных
достаточно:  достаточно
показательный:  показательное
преобразование:  преобразования преобразований
маловероятный:  маловероятно
диффура:  диффурами
перейти:  перейдём
весьма:  весьма
содержать:  содержат
статистика:  статистика статистику
биномиальный:  биномиальное
линиюв:  линиюв
самостоятельный:  самостоятельного
плоский:  плоского
отношение:  отношении
жёсткость:  жёсткости
поменять:  поменяли
коричневый:  коричневые коричневых
решить:  решить
девять:  девять
дуприближённо:  дуприближённо
сложить:  сложил
конкретный:  конкретной конкретный
асимптота:  асимптоты
событие:  события
боеголовка:  боеголовки
повторный:  повторные
обидно:  обидно
содержаться:  содержится содержаться
б:  б
строка:  строку строке строкой строки строкам строка строк
преобразовать:  преобразуем
вышесказанный:  вышесказанного
фнп:  фнп
символ:  символов
простейшее:  простейшие
бабушка:  бабушки
конец:  конце конца
часть:  частям
общество:  обществе
двойной:  двойные двойной
встреча:  встреч
несобство:  несобств
нелинейный:  нелинейная
брать:  берём
применить:  применить
три:  трём трёх
преобразованиеквадратичный:  преобразованиеквадратичной
лаконичный:  лаконичной
функциональный:  функциональные
вышеприведённый:  вышеприведённого
комментарий:  комментарии
рациональный:  рациональнее рациональные
сто:  сто
геометрический:  геометрическая геометрическим геометрической геометрического геометрическое геометрическом
абсолютный:  абсолютная
одинаковый:  одинаковы
выразить:  выразил
сложенияй:  сложенияи
сказать:  сказано
экономия:  экономии
регрессия:  регрессии регрессия
мотив:  мотивам
исчисление:  исчисления
короткий:  коротким
зачастую:  зачастую
гораздо:  гораздо
локальный:  локальная
процесс:  процесса
начинать:  начиная начинаем
трогать:  трогать
лаплас:  лапласа
такой:  таким такое такого таких
перегиб:  перегиба
сходимость:  сходимости сходимость
ду:  ду
далее:  далее
синий:  синих синие
неопределённый:  неопределенный неопределенном
дробь:  дробей
собственный:  собственные
удивительно:  удивительно
признак:  признак признаки
элемент:  элемент элементы
поэтому:  поэтому
поджидать:  поджидал
практика:  практике
вместо:  вместо
крутизна:  крутизны
опыт:  опыта
максимальный:  максимальное максимальному максимальный
противный:  противном
асимметрия:  асимметрия
технический:  технической
скажем:  скажем
сводиться:  сводящиеся
замена:  замены
небоскрёб:  небоскрёба
маленький:  меньше
родный:  родным
например:  например
решенияопределённый:  решенияопределенных
хотя:  хотя
коэффициентковариация:  коэффициентковариации
разобрать:  разобрать разобранную
совместный:  совместна
выполнить:  выполненных
гарантировать:  гарантированной
задуматься:  задумаемся
рассуждение:  рассуждения
теорема:  теореме теоремы теорема
удаляться:  удаляются
повысить:  повысит
случай:  случаев случае случаях
приделывать:  приделываем
лопиталя:  лопиталя
называться:  называется
иерархия:  иерархией
крайне:  крайне
обычно:  обычно
поляформула:  поляформула
фехнера:  фехнера
условный:  условные
эллипс:  эллипс
ноль:  ноль
доказательство:  доказательство
цель:  целью целях
сократить:  сократить
путаница:  путанице
размер:  размеров
даламбер:  даламбера
предпочтительный:  предпочтителен
факт:  факт факта
повторнойя:  повторнойи
комплексный:  комплексные комплексного комплексный комплексными
успех:  успех
ранг:  ранг ранге ранга рангу рангом
переставить:  переставили
кривая:  кривой
тяжестиплоска:  тяжестиплоской
дрессировать:  дрессировать
нуль:  нули нулю нуля
касаться:  касается
построить:  построить
внимание:  внимание
лейбниц:  лейбница
привести:  приведу приведем приведём приведённой привести
встретиться:  встретится встретился
пятиэтажка:  пятиэтажка
реверанс:  реверанс
неравенство:  неравенства
поток:  поток
ехать:  едем
заставить:  заставят
медиана:  медиана
направлениюй:  направлениюи
использовать:  использовать используйте
единственный:  единственное единственный
гостевой:  гостевая
переписать:  перепишем
русский:  русский
ад:  ад
говорить:  говорить
понятно:  понятно
вывод:  вывод
внутригрупповаяй:  внутригрупповаяи
он:  нём
сумма:  сумму сумма
англичанин:  англичанин
наоборот:  наоборот
существовать:  существует существуют
намного:  намного
слово:  словом слово
прямоугольник:  прямоугольников
эксцессэмпирический:  эксцессэмпирического
выбрать:  выбрать
спутник:  спутники
криволинейный:  криволинейные
различный:  различных
библиотека:  библиотека
доля:  доля
возможность:  возможности возможностей
нога:  ноги
наименьшеезначение:  наименьшеезначения
системылинейный:  системылинейных
нужно:  нужно
безжалостно:  безжалостно
базисный:  базисные базисных
спектр:  спектр
пять:  пять
замкнутый:  замкнутому
показатель:  показатели
рамка:  рамках
площадьс:  площадьс
большинство:  большинстве
убыванией:  убываниеи
повышенный:  повышенной
статистический:  статистическая статистические
также:  также
интегрирование:  интегрирование
отождествить:  отождествить
использование:  использование
тета:  тета
пока:  пока
интервальный:  интервальный
рука:  руку
вообще:  вообще
оценкия:  оценкии
неявный:  неявной
фишка:  фишка
несобственныхинтеграл:  несобственныхинтегралов
вероятностибиномиальный:  вероятностибиномиального
обманываться:  обманываются
род:  рода
неизвестный:  неизвестных
гаусс:  гаусса
электростанция:  электростанции
полезно:  полезно
точно:  точно
скорый:  скорых
экстремальный:  экстремальные
нормаль:  нормали
приятный:  приятную
выпуклость:  выпуклость
комбинаторный:  комбинаторные
сформулировать:  сформулирую
менее:  менее
принципиально:  принципиально
сложность:  сложности
значенияй:  значенияи
нужный:  нужной
кстати:  кстати
классическоеопределение:  классическоеопределение
инормаль:  инормаль
далёкий:  дальше
терминология:  терминологию
пирамида:  пирамида
лицо:  лицом
десятый:  десятый
ограничиться:  ограничиться
автор:  автор автора
понимание:  понимания понимание
составить:  составленный
руководствоваться:  руководствоваться
тысяча:  тысячам
разница:  разница
специальный:  специальные
пригодный:  пригодна
преувеличение:  преувеличения
дифференциальный:  дифференциальные
уравненияс:  уравненияс
бублик:  бублик
однозначный:  однозначной
онлайн:  онлайн
геометрия:  геометрии геометрия
использоваться:  используется
работа:  работа
рано:  рано
новый:  новому
произвольныйтройный:  произвольныйтройной
ниже:  ниже
дизайн:  дизайна
это:  это
вычёркивание:  вычёркиванием
поляй:  поляи
опечатка:  опечатку
превосходить:  превосходит
выгодный:  выгоднее
речь:  речь
методичка:  методичках
осмыслить:  осмыслили
методомоперационный:  методомоперационного
бесповторный:  бесповторной
ошибка:  ошибку
строгий:  строгую
л:  л
обойтись:  обойтись
учитель:  учителя
измениться:  изменилось
поздно:  поздно
снизу:  снизу
внизу:  внизу
переделывать:  переделывать
касательный:  касательных
продолжить:  продолжим продолжить
типовыхзадача:  типовыхзадач
ранговойкорреляция:  ранговойкорреляции
операция:  операциями
прийти:  пришло
набить:  набили
упорядочить:  упорядоченную
адресовать:  адресован
жизнь:  жизни
переставлять:  переставлять
вздыхать:  вздыхайте
совместность:  совместность
сток:  стоки
сколько:  сколько
исследовать:  исследовать
поверхность:  поверхности
образовать:  образуют
превращать:  превращающая
соответствовать:  соответствуют
линейныйкоэффициент:  линейныйкоэффициент
привлекать:  привлекать
ампутация:  ампутацию
несобственныйинтеграл:  несобственныйинтеграл
доступно:  доступно
компланарный:  компланарных
причём:  причём
логично:  логично
учиться:  учимся
обучение:  обучения
ипример:  ипримеры
множество:  множества
найти:  найти
брат:  братья
требоваться:  требуется
поверхностный:  поверхностные
объяснить:  объяснить
фигура:  фигуры
пуассон:  пуассона
компактный:  компактной
однако:  однако
упоминать:  упоминал
вычислительный:  вычислительными
математическоеожидание:  математическоеожидание
переместить:  переместили
школа:  школа
неоднородный:  неоднородные
необходимо:  необходимо
вода:  воду
приводить:  приводим
гулять:  гуляют
обратить:  обратим обратите
втройне:  втройне
кратное:  кратные
стоить:  стоит
системудифференциальный:  системудифференциальных
альтернативный:  альтернативное
рассчитывать:  рассчитываем
свешивать:  свешиваем
помимо:  помимо
критиковать:  критикуют
традиционно:  традиционно
классический:  классическом
фирменный:  фирменная
последовательность:  последовательностей
квадратичный:  квадратичные
должность:  должность
малополезный:  малополезная
ассоциироваться:  ассоциируется
объём:  объем
мучить:  мучить
проверить:  проверить
направление:  направление направления
утверждать:  утверждать
равняться:  равняется
поскольку:  поскольку
гипергеометрическоераспределение:  гипергеометрическоераспределение
верхний:  верхнюю
равномерный:  равномерная равномерное
иначе:  иначе
треугольный:  треугольная
обозначать:  обозначать
пожалуйста:  пожалуйста
разделить:  разделили
аксиома:  аксиом
себя:  собой
выявляться:  выявляются
пятёрка:  пятёрки
квадрат:  квадратов
сразу:  сразу
функциюкомплексный:  функциюкомплексной
напоминать:  напоминаю
приложение:  приложение
мода:  мода
свойстваэлементарный:  свойстваэлементарных
считать:  считать
калькулятор:  калькулятор
зелёный:  зелёному зелёным
стандарт:  стандарта
действительно:  действительно
экстремум:  экстремумы
горнера:  горнера
предельно:  предельно
неформальный:  неформальное
функцийв:  функцийв
ознакомиться:  ознакомиться
видеть:  видите
среди:  среди
лёгкий:  легче
дискретнойслучайный:  дискретнойслучайной
начальный:  начальных
съесть:  съел
жутко:  жутко
встретить:  встретишь встретить
обоснование:  обоснование
крамер:  крамера
немало:  немало
тройка:  тройки
удивиться:  удивился
начало:  начале
принцип:  принципам
парабола:  парабола
запретить:  запрещено
к:  ко
функциидвуха:  функциидвух
емелин:  емелин
встречаться:  встречались встречается
вычисленияопределенный:  вычисленияопределенных
задачин:  задачина
замечательный:  замечательные
системый:  системыи
удовлетворяетлить:  удовлетворяетли
сегодня:  сегодня
тригонометрический:  тригонометрических
обозначаться:  обозначается
казаться:  казалось
возможный:  возможной
забраковать:  забракуют
остановиться:  остановимся
заданав:  заданав
всё:  всё
тройной:  тройные
деление:  деления
контуруформула:  контуруформула
график:  график
дело:  деле дело
доказать:  доказать
либо:  либо
тяжко:  тяжко
обозначение:  обозначения
способ:  способ
корреляция:  корреляции
размышление:  размышление
трёхмерный:  трёхмерного
заочник:  заочников
повторять:  повторяем
