вектор:  векторы векторов
посетитель:  посетителей посетители
ссылка:  ссылки ссылка
знакомство:  знакомство
вращение:  вращения
химия:  химии
дифференциальный:  дифференциальные
уравненияс:  уравненияс
наряду:  наряду
именно:  именно
онлайн:  онлайн
привет:  привет
геометрия:  геометрии геометрия
копирование:  копирование
александров:  александров
решить:  решить
разрыв:  разрыва
работа:  работа работ работы работу
выражение:  выражения
сумма:  сумма сумму
отделение:  отделении отделениях отделений
производный:  производные производная производной производную
прямой:  прямой прямую прямая прямом
дуприближённо:  дуприближённо
математический:  математических математические математическая математической математический
новый:  новому
предел:  предел пределы пределов
здоровье:  здоровье
произвольныйтройный:  произвольныйтройной
модель:  модели модель
информация:  информации информацией информация
асимптота:  асимптоты
час:  часов
больший:  большей наибольшее большим
это:  это этим
предусмотреть:  предусмотрено
событие:  события событий
отблагодарить:  отблагодарить
повторный:  повторные
байес:  байеса
расправляться:  расправляются
числовой:  числовые
простой:  проще простых
дисперсия:  дисперсию дисперсия дисперсии
зачёт:  зачетов зачетом зачеты зачетах зачет
решать:  решать
производныенеявно:  производныенеявно
дисциплина:  дисциплинам дисциплинами
интерес:  интересом
решение:  решений решения решением решение
поляй:  поляи
интеграл:  интегралы интеграла интеграл интеграле интегралов
опечатка:  опечатку
источник:  источник
общий:  общему общим общая
контрольный:  контрольных контрольные
живой:  жив
плавать:  плавали
теория:  теория теории
сегодняшний:  сегодняшний
носить:  носят
ресурс:  ресурсы ресурс
изложить:  изложенный изложенных
предлагаться:  предлагаются
панель:  панель
формула:  формулы формула
данный:  данном данный
задание:  заданий задания
забавно:  забавно
моделирование:  моделированию
наплакать:  наплакал
полезный:  полезна полезных
фнп:  фнп
разбираться:  разбираются
читатель:  читатель
министр:  министром
экран:  экрана
учебный:  учебные учебных учебными учебной
отчётный:  отчётные
канонический:  каноническому
удобный:  удобным удобный
простейшее:  простейшие
любимый:  любимый
гипотеза:  гипотезы гипотез гипотеза
дифференциал:  дифференциалах дифференциала
двумерный:  двумерная
методомоперационный:  методомоперационного
задать:  заданной задайте
многие:  многие
масса:  массой
часть:  частям
помочь:  помочь поможет
тело:  тела
циркуляция:  циркуляция
бесповторный:  бесповторной
выложить:  выложено
наверняка:  наверняка
двойной:  двойные двойной
предназначить:  предназначен
ошибка:  ошибку
освоить:  освоили
плоскость:  плоскости плоскость
автор:  авторе автора автор
несобство:  несобств
экзамен:  экзаменом экзамены экзаменов экзамен экзаменах
л:  л
практический:  практические практического практическую
специальность:  специальности специальностей
развернуть:  развернутую
написать:  написал
нелинейный:  нелинейная
пётр:  пётр
книга:  книг книга книги
сам:  самого самом
изучение:  изучение изучении изучения
преобразованиеквадратичный:  преобразованиеквадратичной
определителяй:  определителяи
степень:  степени
вогнутостья:  вогнутостьи
важно:  важно
блокнот:  блокноте
посему:  посему
вид:  виде виды виду
примета:  примете
закон:  законы
обратиться:  обратившихся
функциональный:  функциональные
секрет:  секрет
касательный:  касательных
адрес:  адресу
характерный:  характерен
доллар:  долларов
тот:  той тому ту
получаться:  получаются получается
геометрический:  геометрическая геометрическое
абсолютный:  абсолютная
графика:  графика графики
типовыхзадача:  типовыхзадач
переносный:  переносном
насколько:  насколько
удобно:  удобно
создание:  созданием
умножение:  умножения
предмет:  предмет предмете предмету
вероятность:  вероятностей вероятность вероятности
встречаться:  встречаются
развивать:  развивает
ранговойкорреляция:  ранговойкорреляции
система:  система систему системе системы
частный:  частные частное
функция:  функций функцию функции функция
непрерывный:  непрерывная непрерывных
группировка:  группировок группировка
условнаясходимость:  условнаясходимость
сложенияй:  сложенияи
доступный:  доступны доступной доступных
уравненийв:  уравненийв
образ:  образ
припомнить:  припомнить
регрессия:  регрессии регрессия
величина:  величин величина величины
офлайн:  оффлайн
александр:  александр
найти:  найдёт найти найдет найдете
свой:  свой своим своей
ценный:  ценной
откроить:  открою
уровень:  уровень уровня
крупный:  крупнейшие
осмелиться:  осмелюсь
рассказать:  расскажу
почувствовать:  почувствовали почувствуете
типовой:  типовую
грин:  грина
полный:  полное полных полной
который:  которые который
исчисление:  исчисления
линейный:  линейные линейная линейных линейной
пропустить:  пропустить
прилежный:  прилежен
эйлер:  эйлера
шаблон:  шаблон
квалификация:  квалификацию
искать:  ищут
учёба:  учёбу
заходить:  заходите
согласие:  согласия
локальный:  локальная
методичка:  методичек
ожидание:  ожидание
смешной:  смешные
математика:  математики математику математике
лаплас:  лапласа
перегиб:  перегиба
сходимость:  сходимости сходимость
дуоперационный:  дуоперационным
исследовать:  исследовать
сформулировать:  сформулировать
благодарность:  благодарность
дискретный:  дискретный
базис:  базисах базис базису
никто:  никто
поверхность:  поверхности
бохан:  бохана
знакочередоваться:  знакочередующиеся
задача:  задачи задач
авторский:  авторских авторского
базылевый:  базылева
векторный:  векторного векторное
ограниченный:  ограниченного
предположить:  предположить
несколько:  нескольких
ду:  ду
методический:  методические
юмор:  юмор юмора
зависимостьвектор:  зависимостьвекторов
линейныйкоэффициент:  линейныйкоэффициент
делать:  делать делаете
математик:  математик математика
дать:  дам
коэффициент:  коэффициент
неопределённый:  неопределенный неопределенном
лекция:  лекций лекции
история:  историю
день:  день
тысяча:  тысячи
сначала:  сначала
белый:  белого
метод:  методы методом метод
пример:  примерами примеры пример примеров
дробь:  дробей
поступить:  поступили
собственный:  собственные
расчеткать:  расчетку
страница:  страницу
практически:  практически
несобственныйинтеграл:  несобственныйинтеграл
признак:  признак признаки
произвольный:  произвольных
данные:  данных
сложный:  сложной сложных сложные
рядом:  рядом
доступно:  доступно
работать:  работает
причём:  причём
фурье:  фурье
учиться:  учимся учатся
поле:  поля
владелец:  владельцы
разложение:  разложением разложение
задавать:  задаваемые
поэтому:  поэтому
свойство:  свойства
отзыв:  отзывам
способствовать:  способствовали
ответить:  отвечу
исследование:  исследование
пожаловать:  пожаловать
весь:  всем всеми
очный:  очные
качественный:  качественными
ипример:  ипримеры
уравнение:  уравнению уравнений уравнения уравнение
точка:  точки точке
знать:  знаем знаю
карьера:  карьеры
множество:  множества множество
оценка:  оценки оценка
проблема:  проблем
переход:  переход
вариация:  вариации
мочь:  можете могут могу
сайт:  сайту сайте сайта сайты сайт
асимметрия:  асимметрия
комплексный:  комплексными комплексные комплексного комплексный
никакой:  никаких
основа:  основы основе
поверхностный:  поверхностные
студент:  студент студентов студенты
интервал:  интервалы
эконометрика:  эконометрике
кош:  коши
координата:  координат координаты координатах
фигура:  фигуры
статья:  статьей
пуассон:  пуассона
составлять:  составляет
сводиться:  сводящиеся
упоминаться:  упоминалось
чайник:  чайников
преобразование:  преобразований преобразования
замена:  замены
большинство:  большинству большинстве
вычисленияс:  вычисленияс
однако:  однако
малый:  малые наименьших
мир:  миром
связь:  связь
таки:  таки
понижение:  понижением понижение
матричный:  матричные матричных матричный
наука:  наук
результат:  результате
стоящий:  стоящий
олигарх:  олигархом
сотня:  сотни
заметить:  заметили
внушительный:  внушительный
ответ:  ответе
математическоеожидание:  математическоеожидание
дороговатый:  дороговат
внешне:  внешне
поприкалываться:  поприкалываться
однородный:  однородные однородным
решенияопределённый:  решенияопределенных
учитель:  учителям
помощь:  помощь помощью
вычислить:  вычислить
плохо:  плохо
борис:  борис
нормальный:  нормальное
доступ:  доступе
очень:  очень
отвести:  отведенных
интегральнаятеорема:  интегральнаятеоремы
корнимногочлен:  корнимногочлена
логарифмический:  логарифмическая
курс:  курса курс курсе
матрица:  матрицу матрицы матрицами
направленность:  направленность
испытанияй:  испытанияи
интегралыть:  интегралыв
самопохвала:  самопохвала
неоднородный:  неоднородные
необходимо:  необходимо
перегруппировка:  перегруппировка
заочный:  заочных заочном
правило:  правило правила
понятный:  понятными понятен
основной:  основные
около:  около
нужный:  нужные нужное нужна нужной
бернулли:  бернулли
полярный:  полярные полярной полярных
коэффициентковариация:  коэффициентковариации
другой:  другими других другие
развитие:  развитию
ряд:  ряд ряды ряда рядов
вариационный:  вариационный
один:  одном
обратный:  обратная обратную
подписываться:  подписывайтесь
думать:  думаю
вопрос:  вопросы вопрос вопросах
кратное:  кратные
свободный:  свободном
серьёзно:  серьёзно
системудифференциальный:  системудифференциальных
оставаться:  остается остаются
веб:  веб
блог:  блог
доверительный:  доверительные
выкладывать:  выкладывать
выражать:  выражаю
смысл:  смысле
высокий:  высших высшей высшая высшую
купить:  купить
благополучный:  благополучной
план:  планами
форма:  форме формы
экономика:  экономике
помимо:  помимо
год:  лет году
критиковать:  критикуют
среднееквадратический:  среднееквадратическое
представиться:  представился
также:  также
мера:  меру
строгий:  строгие
пространство:  пространстве
случай:  случаев случае
мероприятие:  мероприятия
лопиталя:  лопиталя
говориться:  говорится
условие:  условиях
последовательность:  последовательностей
комбинационный:  комбинационная
рассмотреть:  рассмотрю
квадратичный:  квадратичные
быть:  будьте буду
кончить:  кончили
такой:  такое
смешанноепроизведение:  смешанноепроизведение
распространить:  распространена
пожелание:  пожелания
объём:  объем
целый:  целая
проверить:  проверить
поляформула:  поляформула
чёрный:  чёрного
сообщить:  сообщите
линия:  линиями линии линия
фехнера:  фехнера
аналитический:  аналитическая аналитической
вычислительный:  вычислительной
таблица:  таблиц таблицы
проект:  проектом проекта
школьный:  школьный
эффективный:  эффективные
независимо:  независимо
центр:  центр
гугл:  гугла
появляться:  появляются
обзор:  обзор
гипергеометрическоераспределение:  гипергеометрическоераспределение
интернет:  интернет
условный:  условные
непрерывнаяслучайный:  непрерывнаяслучайная
навигационный:  навигационную
составляться:  составляется
эллипс:  эллипс
прямо:  прямо
длина:  длина
любой:  любой любом
статистика:  статистики статистике статистика
немного:  немного
знакопостоянство:  знакопостоянства
подробно:  подробно
равномерный:  равномерная равномерное
треугольный:  треугольная
градиент:  градиент
количество:  количество
профессиональный:  профессиональной профессиональный
научить:  научили
определение:  определения определению
необходимость:  необходимость
счастие:  счастью
использовать:  используйте используя
пожалуйста:  пожалуйста
даламбер:  даламбера
фирма:  фирм
сторона:  сторону
теорема:  теоремы
факт:  факт
бесплатно:  бесплатно
комбинаторика:  комбинаторике
своевременный:  своевременную
случайнаявеличина:  случайнаявеличина
повторнойя:  повторнойи
число:  числе числами числа
кот:  кот
построение:  построение
следовать:  следует
мой:  моих мои
бесконечно:  бесконечно
грех:  грех
линейнойкорреляционный:  линейнойкорреляционной
действие:  действия
время:  времен временем времени
деятельность:  деятельности
квадрат:  квадратов
ранг:  ранг
требоваться:  требуются
кривая:  кривой
излагать:  излагать
сфера:  сфере
тяжестиплоска:  тяжестиплоской
сразу:  сразу
почему:  почему
распределениякритерия:  распределениякритерий
функциюкомплексный:  функциюкомплексной
репетитор:  репетиторов репетитор
область:  область области
проверка:  проверка
преподаватель:  преподаватель преподавателей преподавателям
баба:  баб
завтра:  завтра
фотоальбом:  фотоальбомом
построить:  построить
готовый:  готовых готов готовые
закончить:  закончил
несобственный:  несобственные
просто:  просто
единственный:  единственный
мода:  мода
абрамович:  абрамович
свойстваэлементарный:  свойстваэлементарных
ещё:  ещё
карточка:  карточкой
впритык:  впритык
коллега:  коллег
внимание:  внимание
калькулятор:  калькулятор
лейбниц:  лейбница
избыточный:  избыточной
научиться:  научиться научитесь
лениться:  ленимся
культурология:  культурологию
толстой:  толстого
неравенство:  неравенства
наш:  наше наш
поток:  поток
фихтенголец:  фихтенгольца
полностью:  полностью
занятие:  занятия
поделиться:  поделитесь
касательная:  касательная
задачис:  задачис
ботан:  ботана
разобраться:  разобраться
медиана:  медиана
замечание:  замечания
функциия:  функциии
краткий:  краткий
техника:  техники
частый:  чаще
степенной:  степенного степенные
аспирантура:  аспирантура
возможно:  возможно
функцийдвуха:  функцийдвух
направлениюй:  направлениюи
определённый:  определенный определенного определённый
выборка:  выборке
дневный:  дневных
гостевой:  гостевая
скоро:  скоро
грамотно:  грамотно
мысль:  мысли
разработка:  разработки
действительно:  действительно
распределение:  распределения распределение
кроме:  кроме
экстремум:  экстремумы
добрый:  доброго
горнера:  горнера
производныефункция:  производныефункции
средний:  средняя
факультет:  факультет
функцийнесколький:  функцийнескольких
мастер:  мастер
подготовка:  подготовки
попасть:  попали
главное:  главное
внутригрупповаяй:  внутригрупповаяи
алгебра:  алгебры
естественный:  естественных
звать:  зовут
функцийв:  функцийв
переменный:  переменных переменной
любить:  любят любили
очки:  очках
др:  др
ознакомиться:  ознакомиться
несовместный:  несовместные
независимыеслучайный:  независимыеслучайные
множественнойлинейный:  множественнойлинейной
емелин:  емелиных емелин
добавить:  добавить
уважение:  уважением
наоборот:  наоборот
учебник:  учебник учебников
минимум:  минимум
заказать:  заказать
довольно:  довольно
сессия:  сессия
анализ:  анализ анализа
радость:  радости
тема:  темы
прямоугольник:  прямоугольников
непрерывность:  непрерывность
эксцессэмпирический:  эксцессэмпирического
подковать:  подкованных
список:  список
десятка:  десятки
функциис:  функциис
востребовать:  востребовано
зеркало:  зеркало
различный:  различных
криволинейный:  криволинейные
богатый:  богатого
пирсон:  пирсона
семья:  семья
репетиторство:  репетиторством
деньга:  деньги
вышка:  вышкой
библиотека:  библиотека
три:  трёх
выраженный:  выраженную
оттенок:  оттенок
традиция:  традициях
межгрупповой:  межгрупповая
каждый:  каждый
ортогональный:  ортогональное
глубокий:  глубокую
дискретнойслучайный:  дискретнойслучайной
известный:  известный
привести:  приведены привести
задачипо:  задачипо
пропуск:  пропуск
добро:  добро
способность:  способностей
наименьшеезначение:  наименьшеезначения
нсв:  нсв
стараться:  старается
сила:  силы
приблизить:  приближенные
стать:  стал станете
сборник:  сборников сборники
гуманитарный:  гуманитарным гуманитарных
изюминка:  изюминка
представлять:  представляю
системылинейный:  системылинейных
вконтакте:  вконтакте
вроде:  вроде
прорешана:  прорешаны
самый:  самое
кой:  коем
упасть:  упал
изучать:  изучать
прорешать:  прорешал
зависимый:  зависимые
буквально:  буквально
зависимость:  зависимость
жалоба:  жалобы
отклонение:  отклонение
крамер:  крамера
отрезка:  отрезке
материал:  материалы материала материалов
произведение:  произведение
немало:  немало
оказать:  оказать
кто:  кому
состояться:  состоялось
случайный:  случайных случайные
физика:  физики
замкнутый:  замкнутому
паблик:  паблик
пропускать:  пропускать
начало:  начале
дуга:  дуги
официальный:  официальный
отрезкать:  отрезкав
некоммерческий:  некоммерческим
желать:  желаю
дивергенция:  дивергенция
левый:  левую
правда:  правда
парабола:  парабола
разный:  разного
спасибо:  спасибо
заниматься:  занимаюсь
благо:  благо
возникнуть:  возник
форум:  форуме форум
показатель:  показатели
страна:  страны
отвечать:  отвечают
подчеркнуть:  подчеркнуть
рамка:  рамках
площадьс:  площадьс
функциидвуха:  функциидвух
запретить:  запрещено
статистический:  статистические статистическая
литература:  литературы
низкий:  низок
какой:  какому какие
убыванией:  убываниеи
вычисленияопределенный:  вычисленияопределенных
повышенный:  повышенной
возрастание:  возрастание
эмпирический:  эмпирические
детерминация:  детерминации
интегрирование:  интегрирование
легко:  легко
бесплатный:  бесплатный
решебникнуть:  решебник
задачин:  задачина
замечательный:  замечательные
передавать:  передаю
рациональный:  рациональные
системый:  системыи
начать:  начать
удовлетворяетлить:  удовлетворяетли
трудный:  трудные
найтись:  нашлось
вуз:  вузе вузов
дизайн:  дизайн
решебник:  решебника
потребоваться:  потребуется
осваивать:  осваивает
дифференциальныеуравнение:  дифференциальныеуравнения
каталог:  каталоги
ситуация:  ситуация
плечо:  плечами
иррациональный:  иррациональных
интервальный:  интервальный
сожаление:  сожалению
тригонометрический:  тригонометрических
постоянный:  постоянных
два:  двух
квадратичнуюформ:  квадратичнуюформу
стокс:  стокса
получиться:  получился
схема:  схема
карта:  карта
увенчаться:  увенчалось
обращаться:  обращаться
параметрический:  параметрической параметрическом
следить:  слежу
выборочно:  выборочно
пятилетка:  пятилетку
гипербола:  гипербола
самостоятельно:  самостоятельно
вообще:  вообще
дробовик:  дробовик
они:  ними
режим:  режиме
оценкия:  оценкии
неявный:  неявной
урок:  уроки
несобственныхинтеграл:  несобственныхинтегралов
вероятностибиномиальный:  вероятностибиномиального
экономический:  экономических
студенчество:  студенчества
советский:  советских
упустить:  упущенное
подготовить:  подготовленные
вероятностия:  вероятностии
логика:  логики
тонкий:  тонкого
род:  рода
заданав:  заданав
скалярный:  скалярное
спирмена:  спирмена
гаусс:  гаусса
совершенно:  совершенно
порядок:  порядка порядков
всё:  всё
оговорка:  оговорку
затруднительно:  затруднительно
значимость:  значимости
технический:  технических
неоценимый:  неоценимую
тип:  тип
тройной:  тройные
деление:  деления
дорого:  дорого
являться:  является
контуруформула:  контуруформула
иной:  иной
некоторый:  некоторые
доходчивый:  доходчивой
экстремальный:  экстремальные
график:  график
отдых:  отдых
дело:  деле дело
её:  её
информатика:  информатики
св:  св
парный:  парной
рябушко:  рябушко
второй:  второго
биография:  биографию
успешный:  успешного
вечером:  вечером
нормаль:  нормали
ваш:  вашей ваши
определитель:  определитель
поздний:  поздним
неустанно:  неустанно
выпуклость:  выпуклость
посещать:  посещать
элемент:  элементы
показательный:  показательное
интересно:  интересно
атанасян:  атанасяна
гмурман:  гмурмана
пользоваться:  пользуйтесь пользуясь
независимый:  независимые
кузнецов:  кузнецова
аркадиевич:  аркадьевич
сложность:  сложности
дефицит:  дефицит
диффура:  диффурами
визитный:  визитной
узнать:  узнал
часто:  часто
значенияй:  значенияи
смочь:  сможете
поиск:  поиска
назад:  назад
весьма:  весьма
сдача:  сдачи
первый:  первого
кстати:  кстати
вычисление:  вычисление
справочный:  справочной
стоить:  стоить
классическоеопределение:  классическоеопределение
инормаль:  инормаль
корреляция:  корреляции
прежде:  прежде
глобальный:  глобальный
наверстать:  наверстать
сдавать:  сдавать
интеллект:  интеллект
специалист:  специалистов
биномиальный:  биномиальное
получить:  получил
солидный:  солидного
заочник:  заочников
пирамида:  пирамида
случаем:  случаем
линиюв:  линиюв
отменять:  отменял
максимально:  максимально
отношение:  отношении
индустрия:  индустрия
повторять:  повторяем
сутки:  суток
разъяснить:  разъяснить
философия:  философию
ярко:  ярко
скачать:  скачать
оказаться:  окажется
