смешанный:  смешанном смешанным смешанное смешанного
производный:  производные производная производной производную
векторный:  векторным векторное векторном векторного векторных векторная
слагаемое:  слагаемое слагаемые слагаемом
предел:  предел пределы пределов
указательный:  указательный указательные
чёткий:  чёткий
числовой:  числовые
производныенеявно:  производныенеявно
значение:  значение значения
вырожденный:  вырожденного
контрольный:  контрольных
находить:  находить находят находили
формула:  формулы формулой формуле формула формул формулу
смотреть:  см смотрим смотреть
прийтись:  придётся
канонический:  каноническому
два:  две двумя двух
ассоциативный:  ассоциативные ассоциативным
дифференциал:  дифференциалах дифференциала
перестановка:  перестановке перестановку перестановка
больший:  наибольшее большим большая
палец:  пальца пальцы пальцах палец
выразить:  выразим
многие:  многие
один:  одну одно одного одна одной одном
образно:  образно
безымянный:  безымянный
решать:  решая решать
правый:  правая правой правую правый
стрелка:  стрелка стрелками
сам:  самого самом сами само
расположить:  расположить
число:  число числом числами числа
вогнутостья:  вогнутостьи
параллелограмм:  параллелограмм параллелограмма
выяснить:  выяснить
особенность:  особенность
случай:  случай случаев случае случаях
громоздкий:  громоздкой
профессия:  профессию
пусть:  пусть
умножение:  умножения
выполнимый:  выполним
система:  система системе систему системы
группировка:  группировок группировка
познакомиться:  познакомимся
условнаясходимость:  условнаясходимость
сокращать:  сокращает
слово:  словами слова
александр:  александр
душа:  душу
остаться:  осталось останутся остались
уметь:  умел
который:  которые который которая которого которой
линейный:  линейные линейная линейных линейной
вниз:  вниз
объём:  объём объёму объема объёма объем объему
вкус:  вкуса
равенство:  равенство
быть:  суть буду будьте будут будем
разобрать:  разобрано разберём
согласие:  согласия
доказать:  доказано доказать
пункт:  пунктах пункт пункте
знать:  знают знаете
дуоперационный:  дуоперационным
базис:  базисах базису базисе базисы базис базисами базиса
рассмотреть:  рассмотренная рассмотрим рассмотрены рассмотренную рассмотреть рассмотрели
понятный:  понятна
зависимостьвектор:  зависимостьвекторов
получаться:  получалось получается получался
снова:  снова
оно:  оно
сначала:  сначала
левоориентировать:  левоориентированных левоориентированный
метод:  методы методом метод
страница:  страницу
столбец:  столбцу
намеренно:  намеренно
математический:  математическая математические математической
данные:  данных
интеграл:  интеграл интегралов интегралы интеграла интеграле
урок:  урока урок уроке
разложение:  разложением разложение
синус:  синус синусов
прозрачный:  прозрачно
уравнение:  уравнению уравнения уравнение уравнений
переход:  переход переходе
получиться:  получилось получится
жонглировать:  жонглировать
цвет:  цветом цвета цвет
первый:  первое первой первому первом первого
вектор:  векторах векторы вектору вектором векторов вектора векторам векторами вектор векторе
прилепить:  прилепить
практический:  практических практическом практический практической практические
работа:  работах работа
малый:  малые наименьших
связь:  связь
понятие:  понятием понятие
произведение:  произведении произведения произведением произведение произведений произведению
крестик:  крестиком
нормальный:  нормальное нормальная
интегральнаятеорема:  интегральнаятеоремы
построить:  построенного построить
корнимногочлен:  корнимногочлена
логарифмический:  логарифмическая
сведение:  сведения
пирамида:  пирамидой пирамиды пирамида
место:  места местами
подчёркивать:  подчёркиваю
движуха:  движуху
основной:  основные
соответствовать:  соответствующей соответствует
бернулли:  бернулли
полярный:  полярные полярных полярной
ряд:  ряды ряда ряд рядов
уровень:  уровня
аффинный:  аффинного аффинной
живительный:  живительный
доверительный:  доверительные
буква:  буквой буквы букву
разгар:  разгаре
среднееквадратический:  среднееквадратическое
вышесказанный:  вышесказанное вышесказанного
комбинационный:  комбинационная
повторять:  повторяйте повторяем
антикоммутативность:  антикоммутативности антикоммутативностью
распространить:  распространена распространенный
смешанноепроизведение:  смешанноепроизведение
функция:  функции функция функций
дисперсия:  дисперсия дисперсии дисперсию
проверка:  проверки проверка
компланарность:  компланарность компланарности
школьный:  школьный
мы:  нам
треугольник:  треугольника треугольниками треугольники
образ:  образом
непрерывнаяслучайный:  непрерывнаяслучайная
другой:  других другие другим другую
ибо:  ибо
длина:  длина длины длину длине длинах
материал:  материал материалов материалы
немного:  немного
мочь:  могут
знакопостоянство:  знакопостоянства
площадь:  площади площадей площадь
попробовать:  попробуйте
градиент:  градиент
равный:  равных равны равен равный равна
трудность:  трудности
линия:  линия линии линиями
ладонь:  ладони
тонкость:  тонкости
комбинаторика:  комбинаторике
измениться:  изменится
случайнаявеличина:  случайнаявеличина
бесконечно:  бесконечно
определитель:  определителя определителями определитель определителе
форма:  формы
свойство:  свойствам свойствах свойства свойств свойству свойство
задача:  задачу задачи задач задачах задача
знание:  знания
отметить:  отметить отмечу
зазеркалье:  зазеркалья
опечатка:  опечатка опечатку
обратный:  обратную обратная обратном
рассматривать:  рассматривать
коротенький:  коротенький
убедиться:  убедятся убедились
складываться:  складывается
готовый:  готовых
три:  тремя трёх
просто:  просто
ещё:  ещё
произвольный:  произвольного произвольных
разбираться:  разбирались разбирается
клуб:  клуб
переставить:  переставить
взять:  взятых взяты взять
часть:  частей частям части
проверять:  проверять
тандем:  тандема
неколлинеарный:  неколлинеарных
обращать:  обращаю
группа:  группу
нахождение:  нахождения нахождение
картинка:  картинка картинкой
данный:  данного данную данном данное данный
непрерывный:  непрерывных непрерывная
вернуться:  вернётся
производныефункция:  производныефункции
средний:  средняя средние средний
столбцы:  столбцы
знак:  знаком знак
область:  области область
далеко:  далеко
уместно:  уместно
математик:  математика
переменный:  переменных переменной
пример:  пример примеров примерах примеры
умножаться:  умножается умножаются
посмотреть:  посмотрим
несовместный:  несовместные
независимыеслучайный:  независимыеслучайные
добавить:  добавить
получать:  получали получаем
вверх:  вверх
модуль:  модулю модуля модуль
очевидный:  очевидный
следовательно:  следовательно
существенный:  существенные
модель:  модель модели
минус:  минус минусы
непрерывность:  непрерывность
способ:  способами способ
добавляться:  добавляется добавляться
список:  список
функциис:  функциис
таков:  таков
полный:  полной полных полную полное полного
зеркало:  зеркало зеркалу
читатель:  читатели
второй:  втором второго второй вторую
значит:  значит
пирсон:  пирсона
вопрос:  вопрос вопросы
геометрический:  геометрических геометрический геометрическая геометрическим геометрической геометрическое
межгрупповой:  межгрупповая
ортогональный:  ортогональное ортогонален
чёрный:  чёрным чёрного
синь:  синей
нсв:  нсв
ясность:  ясности
исходный:  исходным исходные
почерпнуть:  почерпнуть
абстрактный:  абстрактным
тетраэдр:  тетраэдра тетраэдр
быстро:  быстро
упасть:  упал
писать:  пишут
отрезка:  отрезке
красный:  красный красная красными
нулевой:  нулевому нулевая
величина:  величина величин величины
одновременно:  одновременно
важный:  важный важная важным важен важную
дебри:  дебри
оставаться:  остаются
запись:  запись
прочертить:  прочерчены прочерчена
пэ:  пэ
закрытый:  закрытый
таблица:  таблица таблицы
умножать:  умножаем
допустимый:  допустимо
порадовать:  порадовать
плоский:  плоские
детерминация:  детерминации
сторона:  стороны сторон
обязательно:  обязательно
следующий:  следующие следующим
пирамидка:  пирамидки
разбирать:  разбирали разбираем
начать:  начать начните
выполнить:  выполнить
дифференциальныеуравнение:  дифференциальныеуравнения
вникнуть:  вник
прямой:  прямая прямой прямую
дистрибутивный:  дистрибутивные
постоянный:  постоянных
стокс:  стокса
контроль:  контроле
схема:  схема
заштриховать:  заштрихован
нетленный:  нетленные
синий:  синим синего
оформление:  оформление
дробовик:  дробовик
получить:  получен получим полученное получи
математика:  математике математики
ваш:  ваши вашей
подготовить:  подготовленные
вероятностия:  вероятностии
совмещаться:  совмещаются
скалярный:  скалярное скалярного скалярном
значимость:  значимости
неизбежно:  неизбежно
страшный:  страшного страшны
мысленно:  мысленно
дать:  дана данные данной даны
такой:  такую таким такое такого такая такими
вершина:  вершины вершинами
анализ:  анализа анализ
её:  её
частный:  частное частные частный
парный:  парной
заклинание:  заклинание
координата:  координатами координаты координат координатах
найти:  найдём найдем найти
несколько:  несколько
отвлечься:  отвлекусь
момент:  моменты момент
сборник:  сборники
параметрический:  параметрическом параметрической
часто:  часто
человек:  человек
хороший:  хороший хорошими
угол:  угла
надеяться:  надеюсь
разговор:  разговор
решение:  решение решением решения решений
форум:  форум форуме
записывать:  записывать записываем
наш:  наши наш нашу
книга:  книги книга
провести:  провести
пунктир:  пунктир пунктиром
задание:  задание задания
раздел:  разделе раздел раздела
внимательный:  внимательны
вращение:  вращения
именно:  именно
копирование:  копирование
разрыв:  разрыва
выражение:  выражения
предыдущий:  предыдущей предыдущих
родиться:  родились
название:  название
отблагодарить:  отблагодарить
байес:  байеса
простой:  проще простых простейшую простой простыми
выгодно:  выгодно
вылить:  выльют
отрицательный:  отрицательной отрицательным
результат:  результат результате результатом
теория:  теория теории
схематический:  схематический схематическим
дополнительно:  дополнительно
собрать:  собрать
называть:  называют
умножить:  умножить
двумерный:  двумерная
задать:  заданной задайте заданных заданными
тело:  тела
циркуляция:  циркуляция
непосредственно:  непосредственно
слева:  слева
плоскость:  плоскости плоскостью плоскость
общий:  общим общая общем
поздний:  позже
определителяй:  определителяи
выносить:  выносим
выделить:  выделить
ортонормированный:  ортонормированного ортонормированном
согласно:  согласно
закон:  законы законам
качество:  качестве
впечатление:  впечатление
действие:  действий действия действие
насколько:  насколько
вероятность:  вероятностей вероятность вероятности
заключение:  заключение
уравненийв:  уравненийв
ортогональность:  ортогональность
пространственный:  пространственные
грин:  грина
суть:  сути
эйлер:  эйлера
направо:  направо
возможный:  возможный
восстановить:  восстановить
утверждение:  утверждений
дискретный:  дискретный
направить:  направленный направлен
знакочередоваться:  знакочередующиеся
информация:  информацией информации информацию
сменить:  сменит
пожалуй:  пожалуй
сложный:  сложной сложнее сложные сложных
выбирать:  выбирать
фурье:  фурье
поле:  поля
гипотеза:  гипотез гипотеза гипотезы
закидывать:  закидываем
исследование:  исследование
весь:  всем
точка:  точки точке
проблема:  проблем
вариация:  вариации
коллекция:  коллекцию
ссылка:  ссылка
основа:  основы
выстроиться:  выстроились
мало:  мало
интервал:  интервалы
кош:  коши
выше:  выше
голова:  головы
чайник:  чайников чайникам
вычисленияс:  вычисленияс
полюбить:  полюбят
ориентация:  ориентацию ориентации ориентация
матричный:  матричные матричных матричный
понадобиться:  понадобятся
вытащить:  вытащить
заметить:  заметили заметьте
ответ:  ответе ответ ответом ответы
объект:  объект
однородный:  однородные однородным
вычислить:  вычислить вычислят
раскрытие:  раскрытии раскрытием раскрытия
очень:  очень
проводить:  проводимых
снабдить:  снабжённый
матрица:  матрицу матрицы матрицами
испытанияй:  испытанияи
интегралыть:  интегралыв
привыкнуть:  привык
предмет:  предметам
перегруппировка:  перегруппировка
пойти:  пойдёт
помощь:  помощью
явный:  явная
вариационный:  вариационный
блог:  блог
высокий:  высших высшей высшая
типовой:  типовых
вникать:  вникать
паровозик:  паровозиком
пространство:  пространстве пространства пространство
лектор:  лекторов
удобный:  удобный
прокомментировать:  прокомментировать
рассчитывать:  рассчитывали
курс:  курс курсе
буковка:  буковка
сообщить:  сообщите
аналитический:  аналитическая аналитической
понижение:  понижение понижением
выражаться:  выражается
придирка:  придирка
левый:  левой левый
шарик:  шариками
центр:  центр
компланарный:  компланарны компланарными компланарных
упираться:  упираться
разъяснить:  разъяснено
фигура:  фигура фигуры
невидимый:  невидимые
любой:  любой любую любых
съесть:  съест
правоориентировать:  правоориентированный
трёхмерный:  трёхмерных трёхмерном
ждать:  ждут
затем:  затем
диагональ:  диагональ
построение:  построение
вспоминать:  вспоминаем
линейнойкорреляционный:  линейнойкорреляционной
время:  время
особо:  особо
почему:  почему
распределениякритерия:  распределениякритерий
дальнейший:  дальнейшее
третий:  третью третьего
обозначение:  обозначений обозначение обозначения
несобственный:  несобственные
выполнять:  выполнять
зрение:  зрения
вариант:  варианты
полностью:  полностью
касательная:  касательная
задачис:  задачис
некорректный:  некорректен
друг:  другом
правило:  правила правилу правило
функциия:  функциии
возможно:  возможно
степенной:  степенного степенные
функцийдвуха:  функцийдвух
выборка:  выборке
мизинец:  мизинец
функцийнесколький:  функцийнескольких
чисто:  чисто
градус:  градусов
понять:  понять
простецкий:  простецкая
высказывание:  высказывания
обозначить:  обозначен обозначенные
множественнойлинейный:  множественнойлинейной
пренебрегать:  пренебрегают
тема:  темы
распределение:  распределение распределения
квадратный:  квадратных квадратные
определить:  определено определены
малиновый:  малиновый малинового малиновая
задачипо:  задачипо
востребовать:  востребованную
приблизить:  приближенные
хит:  хит
примечание:  примечание
зависимый:  зависимые
отклонение:  отклонение
что:  чему чём
вполне:  вполне
кто:  кому
случайный:  случайных случайные
одинаковый:  одинаковыми
дуга:  дуги
численно:  численно
свой:  свои
отрезкать:  отрезкав
дивергенция:  дивергенция
представить:  представлены
уничтожать:  уничтожает
сайт:  сайт сайты сайта
графика:  графики графика
обычный:  обычное
косточка:  косточкам
изучение:  изучении
идти:  идёт
укладывать:  укладывать укладываем
возрастание:  возрастание
эмпирический:  эмпирические
найтись:  нашлось
дрова:  дров
вряд:  вряд
иррациональный:  иррациональных
треугольный:  треугольной треугольная
определение:  определению определение определения
квадратичнуюформ:  квадратичнуюформу
карта:  карта
вычисление:  вычисления вычисление вычислений вычислениях
гипербола:  гипербола
грань:  грани
загвоздка:  загвоздка
равно:  равно
смотреться:  смотреться
образец:  образце
они:  ними
включить:  включу
логика:  логики
спирмена:  спирмена
вид:  виду виды виде
параллелепипед:  параллелепипеда параллелепипед
комментарий:  комментариях комментарии
делать:  делали делать
заключительный:  заключительный заключительной
лишь:  лишь
разбить:  разобьём
св:  св
иметь:  имеет
традиционный:  традиционной
беда:  беда
достаточно:  достаточно
показательный:  показательное
преобразование:  преобразования преобразований
ориентировать:  ориентируют
диффура:  диффурами
соответствующий:  соответствующие
скобка:  скобок скобки скобках
использовать:  используем используя использовать используйте
статистика:  статистика
замучить:  замучить
подставлять:  подставляем
бэ:  бэ
биномиальный:  биномиальное
линиюв:  линиюв
самостоятельный:  самостоятельного
справедливый:  справедливы справедлива
отношение:  отношении
штриховка:  штриховка
камин:  камина
смысл:  смысл смыслом
шестой:  шестой
решить:  решить
дуприближённо:  дуприближённо
расчёт:  расчёта
натянутый:  натянутая
закручивать:  закручивают
посетить:  посетите
асимптота:  асимптоты
событие:  события
повторный:  повторные
порядок:  порядок порядке порядка порядков
варьироваться:  варьироваться
б:  б
строка:  строку строке строкой строки строк
состоять:  состоит
константа:  константы константу
фнп:  фнп
этап:  этапа этапы
продемонстрировать:  продемонстрировано
простейшее:  простейшие
передел:  переделы
иной:  иными
конец:  конце
двойной:  двойные двойной
несобство:  несобств
нелинейный:  нелинейная
преобразованиеквадратичный:  преобразованиеквадратичной
функциональный:  функциональные
абсолютный:  абсолютная
коллинеарность:  коллинеарность
встречаться:  встречаются
сложенияй:  сложенияи
раскрывать:  раскрываем
самый:  самые самое
регрессия:  регрессии регрессия
оценка:  оценке оценка оценки
потребоваться:  потребоваться
дождаться:  дождутся
исчисление:  исчисления
локальный:  локальная
начинать:  начиная
настоятельно:  настоятельно
ожидание:  ожидание
лаплас:  лапласа
перегиб:  перегиба
сходимость:  сходимости сходимость
уголёк:  угольки
тот:  те
огонь:  огонь
ду:  ду
работать:  работают
коэффициент:  коэффициент
неопределённый:  неопределенный неопределенном
дробь:  дробей
собственный:  собственные
признак:  признак признаки
борт:  бортом
поэтому:  поэтому
практика:  практике
вместо:  вместо
разумеется:  разумеется
менять:  меняет
хватить:  хватит
принцип:  принципе
теоретический:  теоретические
коль:  коль
асимметрия:  асимметрия
шаг:  шаге
главный:  главную
сводиться:  сводящиеся
собственно:  собственно
обещать:  обещанную
замена:  замены
конструкция:  конструкции
маломальский:  маломальском
строгий:  строгом
например:  например
решенияопределённый:  решенияопределенных
маленький:  поменьше маленьким
хотя:  хотя
многочлен:  многочленов
коэффициентковариация:  коэффициентковариации
лопиталя:  лопиталя
называться:  называется
нужный:  нужного нужной
обычно:  обычно
поменять:  поменять
поляформула:  поляформула
фехнера:  фехнера
эффективный:  эффективные
условный:  условные
эллипс:  эллипс
счастие:  счастья счастье
ноль:  ноль
съедать:  съедает
сократить:  сократить
париться:  париться
чертёж:  чертёж
хватать:  хватает
остаток:  остатки
даламбер:  даламбера
теорема:  теоремы
факт:  факт
единица:  единицы
повторнойя:  повторнойи
естественно:  естественно
рассказать:  рассказал
комплексный:  комплексные комплексного комплексный комплексными
ранг:  ранг
кривая:  кривой
тяжестиплоска:  тяжестиплоской
касаться:  касается
хотеть:  хочу
разобраться:  разберёмся
внимание:  внимание
лейбниц:  лейбница
распределительный:  распределительные
неравенство:  неравенства
поток:  поток
определённый:  определённом определенный определенного
расписать:  распишем
медиана:  медиана
бывать:  бывает
записать:  записать
направлениюй:  направлениюи
благодаря:  благодаря
единственный:  единственное
гостевой:  гостевая
рисунок:  рисунок рисунке
скоро:  скоро
стать:  станет
понятно:  понятно
вывод:  вывод
главное:  главное
внутригрупповаяй:  внутригрупповаяи
пара:  пару
алгебра:  алгебры
сумма:  сумму сумма сумм
условие:  условия условию
шанс:  шансами
вещь:  вещах вещи
выделять:  выделяют
исходить:  исходя
наоборот:  наоборот
существовать:  существует существуют
прямоугольник:  прямоугольников
отличаться:  отличаться
эксцессэмпирический:  эксцессэмпирического
выбрать:  выбрать
преподаватель:  преподавателей
криволинейный:  криволинейные
различный:  различных различной
позиция:  позиции
алгебраический:  алгебраический
библиотека:  библиотека
сделать:  сделал
наименьшеезначение:  наименьшеезначения
сила:  силы
вычислимый:  вычислим
оригинал:  оригиналом
залезать:  залезаем
системылинейный:  системылинейных
нужно:  нужно
смежный:  смежных
последствие:  последствий
зависимость:  зависимость
интересный:  интересного
замкнутый:  замкнутому
нерабочий:  нерабочей
должный:  должен
цэ:  цэ
проходить:  проходит
показатель:  показатели
площадьс:  площадьс
тригонометрический:  тригонометрическая тригонометрических
любить:  любите
убыванией:  убываниеи
повышенный:  повышенной
статистический:  статистическая статистические
также:  также
интегрирование:  интегрирование
рациональный:  рациональные
пока:  пока
нуль:  нулю нуля
некоторый:  некоторых некоторое некоторые
интервальный:  интервальный
речь:  речи речь
противоположно:  противоположно
итак:  итак
соответственно:  соответственно
выборочно:  выборочно
вообще:  вообще
рабочий:  рабочих
оценкия:  оценкии
неявный:  неявной
несобственныхинтеграл:  несобственныхинтегралов
вероятностибиномиальный:  вероятностибиномиального
совместить:  совместить совместите
род:  рода
буквоедство:  буквоедством
выраженный:  выражен
гаусс:  гаусса
искомый:  искомого
достигнуть:  достичь
точно:  точно
кубический:  кубические
экстремальный:  экстремальные
номер:  номер
нормаль:  нормали
желать:  желающие
выпуклость:  выпуклость
противоположный:  противоположный
элемент:  элементы
отсечь:  отсечён
отсюда:  отсюда
доработка:  доработку
менее:  менее
сложность:  сложности
значенияй:  значенияи
справедливо:  справедливо
объяснять:  объяснять
кстати:  кстати
классическоеопределение:  классическоеопределение
инормаль:  инормаль
представлять:  представляют
вновь:  вновь
аналогичный:  аналогичный
автор:  автор автора
разница:  разница
цель:  целях
дифференциальный:  дифференциальные
погружаться:  погружаемся
уравненияс:  уравненияс
постараться:  постарался
онлайн:  онлайн
геометрия:  геометрии геометрия
использоваться:  используется
новый:  новому
произвольныйтройный:  произвольныйтройной
ниже:  ниже
разжигать:  разжигаем
дизайн:  дизайна
это:  это этим
указывать:  указываем
поляй:  поляи
отличный:  отличное
буквоед:  буквоедов
статья:  статье статью
методомоперационный:  методомоперационного
формулировать:  формулируем
бесповторный:  бесповторной
ошибка:  ошибку
л:  л
коллинеарный:  коллинеарны коллинеарных
прижать:  прижмите
касательный:  касательных
большой:  большой
типовыхзадача:  типовыхзадач
ранговойкорреляция:  ранговойкорреляции
рука:  руки
выноситься:  выносятся
проанализировать:  проанализируйте
миниатюра:  миниатюру
проверяться:  проверяется
исследовать:  исследовать
показаться:  показаться
поверхность:  поверхности
образовать:  образуют
линейныйкоэффициент:  линейныйкоэффициент
отражённый:  отражённый
несобственныйинтеграл:  несобственныйинтеграл
доступно:  доступно
опыт:  опыте
причём:  причём
учиться:  учимся
задавать:  задаваемые
напоминать:  напоминает
участвовать:  участвуют
ипример:  ипримеры
множество:  множества
требоваться:  требуется требовалось
искать:  ищите
поверхностный:  поверхностные
рассматриваться:  рассматривалась
пуассон:  пуассона
подобный:  подобные
фактически:  фактически
математическоеожидание:  математическоеожидание
школа:  школа
нижеприведённый:  нижеприведённая
неоднородный:  неоднородные
необходимо:  необходимо
приводить:  приводим
молния:  молнии
оформить:  оформить
спрашивать:  спрашивали
думать:  думаю
кратное:  кратные
системудифференциальный:  системудифференциальных
приобрести:  приобрести
подбросить:  подбросить
помимо:  помимо
каков:  каков
сверкать:  сверкают
алгоритм:  алгоритм
последний:  последнее
последовательность:  последовательностей
квадратичный:  квадратичные
координатный:  координатные
подеваться:  подевалась
проверить:  проверить
поскольку:  поскольку
безпроблемный:  безпроблемно
гипергеометрическоераспределение:  гипергеометрическоераспределение
верхний:  верхнюю
обратить:  обратите
удаться:  удастся
подробно:  подробно
равномерный:  равномерная равномерное
иначе:  иначе
мой:  моей
обозначать:  обозначать
пожалуйста:  пожалуйста
ширина:  ширина
план:  плане
следовать:  следует
успеть:  успел
себя:  собой
квадрат:  квадратов
некомпланарный:  некомпланарных
сразу:  сразу
функциюкомплексный:  функциюкомплексной
отражение:  отражение
мода:  мода
свойстваэлементарный:  свойстваэлементарных
наркомания:  наркомания
считать:  считать считаю
дэ:  дэ
краткий:  краткое
калькулятор:  калькулятор
научиться:  научиться
ловко:  ловко
происходить:  происходит
делить:  делит
похоже:  похоже
учебный:  учебной
равняться:  равнялось
говорить:  говорят говоря
оказаться:  оказался
знакомиться:  знакомиться
неполный:  неполное
действительно:  действительно
прочий:  прочих
экстремум:  экстремумы
горнера:  горнера
отмечаться:  отмечалось
основать:  основана
функцийв:  функцийв
ознакомиться:  ознакомиться
размерность:  размерность
популярный:  популярный
среди:  среди
заново:  заново
дискретнойслучайный:  дискретнойслучайной
номинальный:  номинальная
смена:  смене
сложиться:  сложиться
крамер:  крамера
правда:  правда
парабола:  парабола
базовый:  базовые
строго:  строго
спрашиваться:  спрашивалось
пора:  пора
функциидвуха:  функциидвух
запретить:  запрещено
буратино:  буратино
тонна:  тонны
емелин:  емелин
источник:  источниках
вычисленияопределенный:  вычисленияопределенных
вэ:  вэ
задачин:  задачина
замечательный:  замечательные
счастливый:  счастливый
системый:  системыи
удовлетворяетлить:  удовлетворяетли
ошибаться:  ошибаться
субъективный:  субъективной
раскрыть:  раскрыт
операция:  операции
обозначаться:  обозначается
держать:  держать
горизонт:  горизонте
поднести:  поднесите
конкретный:  конкретный
заданав:  заданав
всё:  всё
технический:  технических
стандартный:  стандартен
тройной:  тройные
деление:  деления
являться:  является
контуруформула:  контуруформула
сочетательный:  сочетательные
график:  график
дело:  деле дело
приятный:  приятному
направление:  направлению
догадываться:  догадываетесь
демонстрация:  демонстрации
либо:  либо
рекомендовать:  рекомендую
эн:  эн
независимый:  независимые
веселить:  веселящие
привести:  привести
корреляция:  корреляции
прежде:  прежде
заочник:  заочников
разный:  разные
отложить:  отложенные
максимально:  максимально
подробный:  подробную
надуманный:  надуманным
литература:  литературе
