ящик:  ящиков ящика ящиками ящиках ящике ящик
мишень:  мишени мишень
семь:  семь
производный:  производные производная производной производную
монета:  монеты монете монетами
предел:  предел пределы пределов
урна:  урны урнах урн
числовой:  числовые
производныенеявно:  производныенеявно
длинный:  длиннее
значение:  значение значения
близкий:  ближайшего
формула:  формулы формулой формула формулу
смотреть:  см
прописной:  прописными
канонический:  каноническому
два:  две двумя двух
дифференциал:  дифференциалах дифференциала
больший:  наибольшее большего большее большими
стрелка:  стрелки стрелка стрелок стрелками
потребовать:  потребуют потребует
один:  одну одно одного одной одном одному
означать:  означает
сигнализация:  сигнализации
задача:  задачам задачу задаче задачей задачами задачи задач задача
число:  число числами числа
вогнутостья:  вогнутостьи
жирный:  жирный
орудие:  орудия орудие орудий
плохой:  хуже
профессия:  профессию
условие:  условии условие условию
удобно:  удобно
умножение:  умножения
выполнимый:  выполним
система:  система системе систему системы
группировка:  группировок группировка
познакомиться:  познакомимся
станок:  станки станок станка станков
условнаясходимость:  условнаясходимость
товар:  товар
александр:  александр
роспись:  росписью
термин:  термины
который:  которые котором который которая которое
линейный:  линейные линейная линейных линейной
равенство:  равенство равенства
быть:  суть буду будут
согласие:  согласия
вычисление:  вычислением вычисления вычисление
выпадение:  выпадения
дуоперационный:  дуоперационным
пуговица:  пуговицы пуговиц
базис:  базисах базису базис
наиболее:  наиболее
идти:  идти идут идёт
зависимостьвектор:  зависимостьвекторов
снова:  снова
сначала:  сначала
метод:  методы методом метод
наудачу:  наудачу
тема:  теме тема
страница:  страницу
математический:  математическая математические математической
данные:  данных
неверный:  неверным
продажа:  продажи продаже
комбинаторика:  комбинаторики комбинаторике
головоломка:  головоломку головоломка
интеграл:  интеграл интегралов интегралы интеграла интеграле
урок:  урока урокам урок уроке
разложение:  разложением разложение
друг:  друга друг
попадать:  попадает
сумма:  суммой суммы сумме сумму сумма
уравнение:  уравнению уравнения уравнение уравнений
переход:  переход
суммировать:  суммируемых
совпадать:  совпадают
получить:  полученную получил получено получи
очередь:  очередь
типовой:  типовые
целесообразно:  целесообразно
умолчанный:  умолчанной
малый:  малые наименьших меньшее
связь:  связь
несовместный:  несовместны несовместные несовместных
нормальный:  нормальное
комбинация:  комбинациях комбинаций
интегральнаятеорема:  интегральнаятеоремы
корнимногочлен:  корнимногочлена
логарифмический:  логарифмическая
начать:  начнём начать
основной:  основные
бернулли:  бернулли
полярный:  полярные полярных полярной
рассмотреть:  рассмотрим рассмотренный рассмотренной рассмотренных
ряд:  ряды ряда ряд ряде рядов
уровень:  уровня
возгорание:  возгорании
появление:  появления появление
пользоваться:  пользоваться пользуясь
доверительный:  доверительные
буква:  буквой буквами
догадаться:  догадайтесь
среднееквадратический:  среднееквадратическое
работать:  работать работает работающих
билет:  билеты билет
извлечение:  извлечения
четыре:  четырьмя четыре четырех
комбинационный:  комбинационная
смешанноепроизведение:  смешанноепроизведение
оказаться:  окажутся
функция:  функции функция функций
дисперсия:  дисперсия дисперсии дисперсию
постараться:  постарайтесь
школьный:  школьный
мы:  нам
образ:  образом
непрерывнаяслучайный:  непрерывнаяслучайная
другой:  других другая другие другого
ибо:  ибо
прямо:  прямо
длина:  длина
процесс:  процессе
ходить:  ходить
немного:  немного
знакопостоянство:  знакопостоянства
быстрый:  быстрый быстрым
проводить:  проводить
градиент:  градиент
линия:  линия линии линиями
практический:  практическим
вспомнить:  вспомним
внимание:  внимания внимание
десятичный:  десятичными
случайнаявеличина:  случайнаявеличина
бесконечно:  бесконечно
несовместность:  несовместности
основа:  основ основы
форма:  формы
равный:  равны равна
отметить:  отметить
статья:  статьи
совместный:  совместного совместны совместных
обратный:  обратную обратная
дополнительный:  дополнительные дополнительными
завтра:  завтра
попасть:  попадёт попадет попадут
третий:  третий третьем третьего
складываться:  складывается
готовый:  готовых готовую
три:  тремя трех трёх
просто:  просто
технологический:  технологическом
ещё:  ещё
вернуться:  вернёмся
состоять:  состоят состоящие состоит состоящее
цель:  цель цели
промах:  промаха промах
группа:  группу группой
оформить:  оформлен оформлено оформлена
частый:  чаще
наступление:  наступления
любимый:  любимая
возможный:  возможных
читатель:  читателей читатели
непрерывный:  непрерывных непрерывная
завезти:  завезут
производныефункция:  производныефункции
средний:  средняя
единица:  единице
область:  области область
извлечь:  извлечь извлечено извлечён извлечена извлечены
плюс:  плюс
путь:  пути путь
далеко:  далеко
математик:  математика
переменный:  переменных переменной
пример:  пример примеру примера примеров примерам примере примерами примерах примеры
пересказать:  перескажу
умножаться:  умножается
смена:  смены
независимыеслучайный:  независимыеслучайные
нравиться:  нравится
выполнение:  выполнения
совпадение:  совпадениях
следовательно:  следовательно
теорема:  теоремам теоремой теоремами теореме теорему теоремы теорема теорем
модель:  модель модели
непрерывность:  непрерывность
способ:  способами способом способ
попадание:  попаданий попадание попадания
рациональный:  рационален рациональные
функциис:  функциис
ускоренный:  ускоренном
полный:  полной полных полную полное
зеркало:  зеркало
второй:  втором второго второй вторым
значит:  значит
пирсон:  пирсона
вопрос:  вопрос вопроса вопросов вопросы
межгрупповой:  межгрупповая
ортогональный:  ортогональное
случайный:  случайным случайных случайные
нсв:  нсв
событие:  событиям событие события событий событиях событиями
стиль:  стиле стиль
прорешана:  прорешаны
экзаменационный:  экзаменационных
осознать:  осознали
упасть:  упал
отрезка:  отрезке
хвост:  хвостов
заголовок:  заголовок
величина:  величина величин величины
пособие:  пособии
запись:  запись
учебный:  учебном
самостоятельный:  самостоятельный самостоятельного
материал:  материалом материалу материалов материалы
датчик:  датчик датчика датчиков
добрый:  добрый
рассматривать:  рассматриваемой рассматриваемого
самый:  самая самым самый самое
детерминация:  детерминации
сторона:  стороны
обязательно:  обязательно
следующий:  следующие следующим следующих следующий следующей следующем
трудный:  трудные
деталь:  детали деталей деталь
дифференциальныеуравнение:  дифференциальныеуравнения
прямой:  прямая прямой прямым прямую прямого
взять:  возьмём
одноцветный:  одноцветные одноцветными
постоянный:  постоянных
стокс:  стокса
схема:  схема
работа:  работы работа работу
самостоятельно:  самостоятельно
подсобка:  подсобке
равняться:  равняться
дробовик:  дробовик
математика:  математике математики
векторный:  векторное векторного
сам:  самом
вероятностия:  вероятностии
скалярный:  скалярное
совершенно:  совершенно
противоположный:  противоположного противоположных противоположное
значимость:  значимости
обслуживать:  обслуживает
очевидный:  очевидным очевидно
ожидаться:  ожидается
анализ:  анализа анализ
бодрящий:  бодрящих
частный:  частное частные
парный:  парной
встретиться:  встретятся встретились
поверхностный:  поверхностного поверхностные
примерный:  примерный
найти:  найдём найдем найти
сборник:  сборники
параметрический:  параметрическом параметрической
ваш:  вашем
независимость:  независимость независимости
часто:  часто
выполняться:  выполняются
никак:  никак
настойка:  настойки
получаться:  получается
какой:  какие какого
разнообразный:  разнообразны
решение:  решение решением решения решений
место:  место
форум:  форум форуме
книга:  книги книга
милитаристский:  милитаристского
белый:  белый белому белыми белых
подлежать:  подлежит
вектор:  векторы векторов
справедливый:  справедлив
вращение:  вращения
полениться:  поленюсь
наряду:  наряду
кубик:  кубик
давать:  давайте
копирование:  копирование
язык:  языке
разрыв:  разрыва
выражение:  выражения выражение
опираться:  опираясь
рабочий:  рабочий
отблагодарить:  отблагодарить
являться:  являются является
байес:  байеса
решать:  решать
выстрел:  выстрелу выстреле выстрелах
поджидать:  поджидают
результат:  результат результата результате
теория:  теория теории
переформулировать:  переформулировать
поразить:  поражена
называть:  называют
избежание:  избежание
соседний:  соседнем
двумерный:  двумерная
задать:  заданной задайте
классический:  классическим классическому классическое
тело:  тела
циркуляция:  циркуляция
непосредственно:  непосредственно
вычислить:  вычислили вычислить
тяжёлый:  тяжёлом
плоскость:  плоскости плоскость
общий:  общим общая общие общем
получиться:  получится
поздний:  позже
определителяй:  определителяи
закон:  законы
первый:  первым первом первого первый
изящно:  изящно
последовательно:  последовательно
пункт:  пункт пункта пунктом
чёрный:  черных чёрных чёрного чёрному
вероятность:  вероятностей вероятность вероятности вероятностью
логический:  логических
заключение:  заключение
уравненийв:  уравненийв
сработать:  сработает сработают
иметь:  имеют имеет
нечётный:  нечётное
сложение:  сложений сложения сложение
количество:  количества количество
грин:  грина
пропустить:  пропустить
эйлер:  эйлера
предыдущий:  предыдущим предыдущих предыдущего
запятая:  запятой
каждый:  каждого каждом каждой
придерживаться:  придерживаться
дискретный:  дискретный
знакочередоваться:  знакочередующиеся
обнаружить:  обнаружил
заметно:  заметно
зависимый:  зависимыми зависимые зависимым зависимой
упражнение:  упражнений
практически:  практически
произвольный:  произвольных
сложный:  сложной сложные сложных
фурье:  фурье
поле:  поля
гипотеза:  гипотез гипотеза гипотезы
свойство:  свойства
исследование:  исследование
рассуждение:  рассуждений
точка:  точки точке
вариация:  вариации
студент:  студент студенту
мало:  мало
интервал:  интервалы
сдать:  сдать сдаст
кош:  коши
выше:  выше
соответствующий:  соответствующих соответствующие
чайник:  чайников чайника
вычисленияс:  вычисленияс
решка:  решка
матричный:  матричные матричных матричный
выделить:  выделю
заметить:  заметили заметьте
однородный:  однородные однородным
очень:  очень
матрица:  матрицу матрицы матрицами
испытанияй:  испытанияи
интегралыть:  интегралыв
перегруппировка:  перегруппировка
лаконично:  лаконично
помощь:  помощью помощь
вариационный:  вариационный
выражать:  выражает
исход:  исходов исходах исхода
простейшее:  простейшему простейшие
бш:  бш
предложить:  предложенном
блог:  блог
высокий:  высших высшей высшая
запамятовать:  запамятовал
образовать:  образующих образуют
произведение:  произведения произведением произведение произведению
вникать:  вникать
пространство:  пространстве
красный:  красные красных
удобный:  удобный удобнее
курс:  курс курса
координата:  координаты координат координатах
сообщить:  сообщите
главный:  главном главную
аналитический:  аналитическая аналитической
понижение:  понижение понижением
определить:  определить
выражаться:  выражается
сочетание:  сочетаний
распространяться:  распространяется
центр:  центр
орёл:  орла орёл
обозначить:  обозначить обозначим
прописать:  прописана
безотказный:  безотказное
затем:  затем
построение:  построение
вспоминать:  вспоминаем
проверка:  проверку проверка
линейнойкорреляционный:  линейнойкорреляционной
действие:  действия
время:  время
пора:  пор
почему:  почему
распределениякритерия:  распределениякритерий
кратко:  кратко
бросок:  броске броска
читаться:  читается
валить:  валить
несобственный:  несобственные
абзац:  абзац
выполнять:  выполнять
зависеть:  зависеть зависит
откуда:  откуда
магазин:  магазина магазином магазин
касательная:  касательная
ответ:  ответ ответы
задачис:  задачис
забывать:  забывать
устройство:  устройств
разобраться:  разобраться
правило:  правила правило
функциия:  функциии
возможно:  возможно
степенной:  степенного степенные
функцийдвуха:  функцийдвух
выборка:  выборке
невозможный:  невозможным
функцийнесколький:  функцийнескольких
чисто:  чисто
успешный:  успешной
множественнойлинейный:  множественнойлинейной
зависимость:  зависимости зависимость
классика:  классика
распределение:  распределение распределения
потренироваться:  потренируемся
настоящий:  настоящая
конкретный:  конкретных
задачипо:  задачипо
независимый:  независимых независимыми независимы независимые
оригинал:  оригинал
востребовать:  востребованную
приблизить:  приближенные
похожий:  похожие похожей
хит:  хит хитов
тонкость:  тонкостей
образец:  образец
путём:  путём
отклонение:  отклонение
таблица:  таблицы
выбирать:  выбирайте
комбинаторный:  комбинаторное
экзамен:  экзамена экзамен экзамене
дуга:  дуги
стандартный:  стандартная стандартными стандартных стандартной
отрезкать:  отрезкав
дивергенция:  дивергенция
уточнение:  уточнением
шаблонность:  шаблонность
подробный:  подробной
сайт:  сайт сайты сайта
наш:  наш
графика:  графики графика
оформление:  оформления
арифметический:  арифметические
изучение:  изучении изучения
бесконечный:  бесконечных
возрастание:  возрастание
эмпирический:  эмпирические
найтись:  нашлось
этот:  этих эта
аналогично:  аналогично
характерный:  характерно
песня:  песнями
отказать:  откажут откажет
иррациональный:  иррациональных
определение:  определению определением определение определения
квадратичнуюформ:  квадратичнуюформу
карта:  карта
гипербола:  гипербола
они:  ними
логика:  логики
фраза:  фразы
спирмена:  спирмена
подсчёт:  подсчёта
вид:  виду виды виде
связка:  связку
следствие:  следствия
вовсе:  вовсе
лишь:  лишь
св:  св
кость:  кости
достаточно:  достаточно
показательный:  показательное
шар:  шару шар шара
преобразование:  преобразования преобразований
диффура:  диффурами
сдача:  сдачи
использовать:  используем использовать используйте
статистика:  статистика
бэ:  бэ
биномиальный:  биномиальное
записаться:  запишется
раскупить:  раскупят
линиюв:  линиюв
отношение:  отношении отношения
достаться:  достанется
хотеться:  хочется
учёба:  учёбы
равноценный:  равноценен
академичный:  академичном
однокурсник:  однокурсники
решить:  решить
дуприближённо:  дуприближённо
гибридный:  гибридный
достоверный:  достоверным
асимптота:  асимптоты
повторный:  повторные
б:  б
учитывать:  учитывая
знать:  знает знать
фнп:  фнп
продемонстрировать:  продемонстрировано
конец:  конце конца
часть:  частям
везение:  везения
двойной:  двойные двойной
компактный:  компактнее
несобство:  несобств
нелинейный:  нелинейная
никто:  никого
течение:  течение
преобразованиеквадратичный:  преобразованиеквадратичной
расписываться:  расписываются
функциональный:  функциональные
испытание:  испытания испытаний
ответить:  ответить ответит
азов:  азов
геометрический:  геометрическая геометрическое
абсолютный:  абсолютная
интересный:  интересные
сложенияй:  сложенияи
сказать:  сказано
регрессия:  регрессии регрессия
упростить:  упростить
оценка:  оценке оценка оценки
исчисление:  исчисления
короткий:  коротким
ориентир:  ориентира
безразличный:  безразлично
гораздо:  гораздо
локальный:  локальная
понятие:  понятиями
настоятельно:  настоятельно
ожидание:  ожидание
лаплас:  лапласа
такой:  таким такое такого такая
перегиб:  перегиба
сходимость:  сходимости сходимость
ход:  ходу
ду:  ду
далее:  далее
синий:  синих синие
иметься:  имеется
ввести:  ввести
коэффициент:  коэффициент
неопределённый:  неопределенный неопределенном
дробь:  дробей дробями
собственный:  собственные
признак:  признак признаки
важный:  важным важнейшие
поэтому:  поэтому
практика:  практике практики
вместо:  вместо
единый:  едином
безусловно:  безусловно
коль:  коль
асимметрия:  асимметрия
выпасть:  выпадут выпадет
снаряд:  снаряд снаряда
сводиться:  сводящиеся
собственно:  собственно
замена:  замены
алгоритм:  алгоритма
захотеться:  захочется
например:  например
решенияопределённый:  решенияопределенных
выглядеть:  выглядит
одинаковый:  одинаковой одинаковые
требовать:  требовали
действительность:  действительности
хотя:  хотя
цвет:  цвета
настрогать:  настрогал
коэффициентковариация:  коэффициентковариации
пожар:  пожаре
случай:  случаев случае
долго:  долго
лопиталя:  лопиталя
свежий:  свежий
содержательный:  содержательное содержательнее
измышление:  измышления
мимо:  мимо
недопонимание:  недопонимание
поляформула:  поляформула
вечер:  вечера
фехнера:  фехнера
эффективный:  эффективные эффективного
независимо:  независимо
условный:  условные
впервые:  впервые
эллипс:  эллипс
вымучивать:  вымучивать
хватать:  хватает
даламбер:  даламбера
факт:  факт
повторнойя:  повторнойи
комплексный:  комплексные комплексного комплексный комплексными
игральный:  игральный игральной
аналогия:  аналогии
ранг:  ранг
кривая:  кривой
тяжестиплоска:  тяжестиплоской
нудно:  нудно
зато:  зато
понятный:  понятнее
построить:  построить
разминаться:  разминаемся
лейбниц:  лейбница
неравенство:  неравенства
поток:  поток
коробка:  коробки коробке
расписать:  распишем
произвести:  произвели
медиана:  медиана
рассмотрение:  рассмотрение
записать:  записать
направлениюй:  направлениюи
гостевой:  гостевая
скоро:  скоро
кроме:  кроме
понятно:  понятно
продукция:  продукцию
внутригрупповаяй:  внутригрупповаяи
он:  нём
алгебра:  алгебры алгебру
встречаться:  встречавшимися
хлеб:  хлеб
существовать:  существует
поражение:  поражения
намного:  намного
прямоугольник:  прямоугольников
эксцессэмпирический:  эксцессэмпирического
десятка:  десятки
криволинейный:  криволинейные
различный:  различных
библиотека:  библиотека
исправлять:  исправлять
наименьшеезначение:  наименьшеезначения
сила:  силы
вычислимый:  вычислим
разница:  разницы
системылинейный:  системылинейных
нужно:  нужно
принципиальный:  принципиальное
скверный:  скверно
вдуматься:  вдумаемся
пять:  пять пяти
замкнутый:  замкнутому
проверить:  проверим проверить
кажущийся:  кажущуюся
показатель:  показатели
промахнуться:  промахнутся промахнётся
уместный:  уместен
вытекать:  вытекает
отличие:  отличие
площадьс:  площадьс
вышеуказанный:  вышеуказанного
убыванией:  убываниеи
повышенный:  повышенной
статистический:  статистическая статистические
также:  также
интегрирование:  интегрирование
благоприятствовать:  благоприятствующих
пока:  пока
непосредственный:  непосредственного
интервальный:  интервальный
зрелище:  зрелищ
гарантировать:  гарантирован
соответственно:  соответственно
простой:  простой
оценкия:  оценкии
неявный:  неявной
несобственныхинтеграл:  несобственныхинтегралов
вероятностибиномиальный:  вероятностибиномиального
нестандартный:  нестандартной
род:  рода
гаусс:  гаусса
мечта:  мечта
точно:  точно
экстремальный:  экстремальные
извлекаться:  извлекаются
нормаль:  нормали
определитель:  определитель
выпуклость:  выпуклость
вышеизложенный:  вышеизложенному
элемент:  элементы
гмурман:  гмурмана
менее:  менее
практикум:  практикуме
сложность:  сложности
значенияй:  значенияи
нужный:  нужной
кстати:  кстати
труд:  труда
классическоеопределение:  классическоеопределение
инормаль:  инормаль
вновь:  вновь
пирамида:  пирамида
информация:  информацию
любой:  любого любым
наслать:  нашли
аналогичный:  аналогичный
автор:  автор автора
разрешимый:  разрешима
однозначный:  однозначного
счёт:  счёт
дифференциальный:  дифференциальные
уравненияс:  уравненияс
онлайн:  онлайн
разобрать:  разберём
геометрия:  геометрии геометрия
новый:  новому новыми
произвольныйтройный:  произвольныйтройной
дизайн:  дизайна
это:  это
поляй:  поляи
опечатка:  опечатку
знакомиться:  знакомьтесь знакомимся знакомитесь
касаться:  касающуюся
выгодный:  выгоднее
речь:  речь
данный:  данном данное
витиеватый:  витиеватые
методомоперационный:  методомоперационного
бесповторный:  бесповторной
латинский:  латинскими
обстоятельство:  обстоятельств
ошибка:  ошибку
л:  л
переделывать:  переделывать
возникнуть:  возникло
касательный:  касательных
тот:  той
типовыхзадача:  типовыхзадач
воспользоваться:  воспользоваться
ранговойкорреляция:  ранговойкорреляции
рука:  руки
оптовый:  оптовых
шаблон:  шаблон
объект:  объектами
представить:  представить
исследовать:  исследовать
поверхность:  поверхности
итого:  итого
линейныйкоэффициент:  линейныйкоэффициент
несобственныйинтеграл:  несобственныйинтеграл
вариант:  вариантом
доступно:  доступно
учиться:  учимся
задавать:  задаваемые
ничто:  ничем
ипример:  ипримеры
особый:  особое
интересовать:  интересующее
множество:  множества
требоваться:  требуется требовалось
фигура:  фигуры
пуассон:  пуассона
появиться:  появится
однако:  однако
таки:  таки
несмотря:  несмотря
математическоеожидание:  математическоеожидание
произойти:  произошли
дать:  данной даны
небольшой:  небольшая
склад:  складов склада
школа:  школа
неоднородный:  неоднородные
необходимо:  необходимо
чёткий:  чётче
актив:  активе
стрелок:  стрелком стрелков
взяться:  взялось
содержание:  содержания
остальной:  остальных
настройка:  настройки
думать:  думаю
обратиться:  обратиться
кратное:  кратные
системудифференциальный:  системудифференциальных
тандем:  тандем
выбрать:  выбран
уметь:  уметь
результативность:  результативности
последовательность:  последовательностей
должный:  должно должна
квадратичный:  квадратичные
объём:  объем
участник:  участниками
поскольку:  поскольку
гипергеометрическоераспределение:  гипергеометрическоераспределение
раз:  раза
обратить:  обратите
включать:  включает
равномерный:  равномерная равномерное
треугольный:  треугольная
вероятный:  вероятнее
римлянин:  римляне
мой:  моей
пожалуйста:  пожалуйста
следовать:  следует
извлекать:  извлекают
квадрат:  квадратов
поставить:  поставить
расписывание:  расписывания
сразу:  сразу
функциюкомплексный:  функциюкомплексной
мода:  мода
свойстваэлементарный:  свойстваэлементарных
считать:  считать
распространить:  распространённую
калькулятор:  калькулятор
научиться:  научиться
исходный:  исходных
оба:  оба
определённый:  определенный определенного
экстремум:  экстремумы
горнера:  горнера
случайно:  случайно
естественный:  естественных
прикольный:  прикольную
функцийв:  функцийв
ознакомиться:  ознакомиться
видеть:  видите
знакомый:  знакомое
очко:  очков
страшноватый:  страшновато
понимать:  понимать
предостерегать:  предостерегаю
дискретнойслучайный:  дискретнойслучайной
альтернативный:  альтернативный
каков:  какова
пристрелить:  пристрелить
крамер:  крамера
залп:  залп
парабола:  парабола
путаница:  путаницы
установить:  установлены
базовый:  базовые
запретить:  запрещено
функциидвуха:  функциидвух
немереный:  немереное
емелин:  емелин
оформлять:  оформлять
сыронизировать:  сыронизировал
вычисленияопределенный:  вычисленияопределенных
вэ:  вэ
задачин:  задачина
замечательный:  замечательные
системый:  системыи
удовлетворяетлить:  удовлетворяетли
субъективный:  субъективной
прийти:  придёт
подарочный:  подарочные
приходиться:  приходится
сей:  сих
тригонометрический:  тригонометрических
доказательство:  доказательству
заданав:  заданав
порядок:  порядка порядков
всё:  всё
тройной:  тройные
деление:  деления
контуруформула:  контуруформула
некоторый:  некоторые
подбрасываться:  подбрасываются
график:  график
дело:  деле
стеллаж:  стеллаже
вытянуть:  вытянули
простота:  простоты
догадываться:  догадываетесь
либо:  либо
рекомендовать:  рекомендую
примерно:  примерно
привести:  привести
проехать:  проехал
основать:  основанный
куча:  кучу
основательный:  основательном
запутать:  запутать
корреляция:  корреляции
прежде:  прежде
сделать:  сделали
заочник:  заочников
файл:  файле
повторять:  повторяем
