вектор:  векторы векторов
получить:  получить получено получили получи
завод:  заводы заводу заводам завод заводов заводах
вращение:  вращения
дифференциальный:  дифференциальные
отражать:  отражает
уравненияс:  уравненияс
путаница:  путаницу
онлайн:  онлайн
провести:  провели провести
обуславливать:  обуславливают
смысл:  смысл смысле
геометрия:  геометрии геометрия
копирование:  копирование
рассмотреть:  рассмотреть рассмотрим
удачный:  удачную удачное
решить:  решить
разрыв:  разрыва
работа:  работа
выражение:  выражения
сумма:  сумма сумме сумму
неоднократно:  неоднократно
производный:  производные производная производной производную
прямой:  прямой прямую прямая
дуприближённо:  дуприближённо
математический:  математических математические математическая математической
новый:  новому новую новый новейших
предел:  предел пределах пределы пределов
слагаемое:  слагаемые
произвольныйтройный:  произвольныйтройной
модель:  модели моделей модель
ниже:  ниже
использоваться:  используются
асимптота:  асимптоты
дизайн:  дизайна
разный:  разным разными разная разных разные
это:  это этим
название:  название
фактор:  факторов фактора фактор факторы фактором факторами
очник:  очников
событие:  события
отблагодарить:  отблагодарить
сильный:  сильнее
повторный:  повторные
байес:  байеса
интерес:  интереса
числовой:  числовые
экселе:  экселе
дисперсия:  дисперсию дисперсия дисперсиями дисперсии дисперсиям дисперсий
решать:  решать
производныенеявно:  производныенеявно
точнее:  точнее
пример:  примере примеры пример примера
таблица:  таблицу таблицы
значение:  значение значения значений
скорее:  скорее
решение:  решений решением решение решения
поляй:  поляи
интеграл:  интегралы интеграла интеграл интеграле интегралов
опечатка:  опечатку
оценить:  оценить
случай:  случаях случае
б:  б
теория:  теория теории
находить:  находить
отсутствовать:  отсутствует
тарифный:  тарифным тарифного тарифные
вариационный:  вариационные вариационный вариационных
характеризовать:  характеризует
речь:  речь
формула:  формулы формула формуле
данный:  данном данного
смотреть:  см смотрим
равный:  равный равна
копировать:  копировать
заочник:  заочникам заочников
фнп:  фнп
безобразие:  безобразием
читатель:  читатель
гуманность:  гуманности
канонический:  каноническому
простейшее:  простейшие
существенность:  существенность существенности
переставить:  переставлены
гипотеза:  гипотезы гипотез гипотеза
иной:  иными
дифференциал:  дифференциалах дифференциала
двумерный:  двумерная
больший:  наибольшее
групповой:  групповая групповую групповые групповой групповых
методомоперационный:  методомоперационного
задать:  заданной задайте
многие:  многие
вызывать:  вызывает
часть:  частям часть части
различный:  различные различными различных
тело:  тела
циркуляция:  циркуляция
бесповторный:  бесповторной
расчёт:  расчёты
правильно:  правильно
двойной:  двойные двойной
означать:  означает означают
ошибка:  ошибку
вычислить:  вычислили вычислено вычислить
плоскость:  плоскости плоскость
несобство:  несобств
средневзвешенный:  средневзвешенная средневзвешенную
л:  л
общий:  общим общая общую общей
нелинейный:  нелинейная
поздний:  позже
разбросать:  разбросаны
преобразованиеквадратичный:  преобразованиеквадратичной
определителяй:  определителяи
вогнутостья:  вогнутостьи
посему:  посему
вид:  виде виды виду
закон:  законы
далее:  д далее
выяснить:  выяснить
нижний:  нижней
функциональный:  функциональные функциональной
варьироваться:  варьируются
слово:  слову словами
обусловить:  обусловлена обусловленную
касательный:  касательных
статья:  статья
плохой:  хуже
станок:  станков станки станками
профессия:  профессию
условие:  условии условиями
тот:  той тому
буква:  буква
влияние:  влияния влияние
строгий:  строгой
геометрический:  геометрическая геометрическое
абсолютный:  абсолютная
графика:  графика графики
типовыхзадача:  типовыхзадач
насколько:  насколько
удобно:  удобно
расправиться:  расправиться
умножение:  умножения
совокупность:  совокупность совокупности
вероятность:  вероятностей вероятность вероятности
встречаться:  встречаются
пункт:  пункт
ранговойкорреляция:  ранговойкорреляции
система:  система систему системе системы
частный:  частные частное
функция:  функций функции функция
выполнимый:  выполним
точность:  точностью
непрерывный:  непрерывная непрерывных
группировка:  группировок группировкой группировка группировки группировку
условнаясходимость:  условнаясходимость
сложенияй:  сложенияи
уравненийв:  уравненийв
познакомиться:  познакомимся
сложение:  сложение сложения
регрессия:  регрессии регрессия
величина:  величин величина величины
александр:  александр
найти:  найдены найти найдем
нанимать:  нанимали
рассказать:  расскажу
грин:  грина
полный:  полное полных полной
который:  которые который которым
исчисление:  исчисления
линейный:  линейные линейная линейных линейной
суть:  сути
несложный:  несложные
эйлер:  эйлера
шаблон:  шаблон
правый:  правой
взаимосвязь:  взаимосвязь
нужный:  нужны нужной
объединение:  объединения
объём:  объём объёмом объем
равенство:  равенство
согласие:  согласия
гораздо:  гораздо
локальный:  локальная
характеризоваться:  характеризуется
сказать:  сказать
ожидание:  ожидание
математика:  математики математике
лаплас:  лапласа
перегиб:  перегиба
такой:  таким такое
сходимость:  сходимости сходимость
дуоперационный:  дуоперационным
исследовать:  исследовать
дискретный:  дискретный дискретных
базис:  базисах базис базису
ход:  ходу
поверхность:  поверхности
знакочередоваться:  знакочередующиеся
задача:  задачи задачу задаче задачах задача
следующий:  следующая следующими следующем
вариация:  вариацию вариации вариация
векторный:  векторного векторное
малый:  наименьшей малые наименьших
заполнить:  заполнить заполним
ду:  ду
видеоролик:  видеоролик видеоролику
зависимостьвектор:  зависимостьвекторов
линейныйкоэффициент:  линейныйкоэффициент
межгрупповой:  межгрупповую межгрупповая межгрупповой
коэффициент:  коэффициент коэффициентах
неопределённый:  неопределенный неопределенном
щелчок:  щелчков
метод:  методы методом метод
некоторый:  некоторый
дробь:  дробей
данные:  данными данных данным
собственный:  собственные
тема:  теме тема тему
страница:  страницу
практически:  практически
несобственныйинтеграл:  несобственныйинтеграл
признак:  признак признаки
произвольный:  произвольных
сложный:  сложной сложных сложные
соображение:  соображений
доступно:  доступно
относительный:  относительные
фурье:  фурье
учиться:  учимся
поле:  поля
урок:  урока урок уроке
разложение:  разложением разложение
задавать:  задаваемые
разделить:  разделить
свойство:  свойства
поэтому:  поэтому
внутригрупповой:  внутригрупповая внутригрупповую внутригрупповой
исследование:  исследование
развить:  разовьём
весь:  всем весь всей
ипример:  ипримеры
уравнение:  уравнению уравнений уравнения уравнение
точка:  точки точке
множество:  множества
оценка:  оценки оценка
переход:  переход
получиться:  получилось получилась
поколение:  поколениями поколения поколениям
асимметрия:  асимметрия
комплексный:  комплексными комплексные комплексного комплексный
требоваться:  требуется требовалось
основа:  основы основе основу
поверхностный:  поверхностные
слишком:  слишком
технический:  технической
вариант:  вариантами варианты вариант
десятка:  десяток
причина:  причины причина причинами
интервал:  интервалы
книга:  книга книги
существо:  существу
дать:  данные даны
главный:  главную
упорядочить:  упорядочили
кош:  коши
ставить:  ставить
координата:  координат координаты координатах
фигура:  фигуры
наш:  нашим наш нашем нашей
выше:  выше
определённый:  определённые определенный определенного
пуассон:  пуассона
очередь:  очередь
объясняться:  объясняется
одиночный:  одиночными
сводиться:  сводящиеся
успех:  успехов
чайник:  чайников
преобразование:  преобразований преобразования
замена:  замены
вычисленияс:  вычисленияс
ролик:  ролик
древний:  древнейших
связь:  связь
маленький:  меньше мала
элементарный:  элементарный
понижение:  понижением понижение
матричный:  матричные матричных матричный
причинность:  причинности
результат:  результате
вставить:  вставить
заметить:  заметили заметил
группа:  группах группам групп группе группы
математическоеожидание:  математическоеожидание
например:  например
однородный:  однородные однородным
решенияопределённый:  решенияопределенных
знак:  знаки
простой:  простая проста
расчётный:  расчётную
нормальный:  нормальное
важный:  важен важный
школа:  школа
очень:  очень
интегральнаятеорема:  интегральнаятеоремы
корнимногочлен:  корнимногочлена
логарифмический:  логарифмическая
число:  чисел числами числа
матрица:  матрицу матрицы матрицами
условно:  условно
испытанияй:  испытанияи
интегралыть:  интегралыв
близкий:  ближе
неоднородный:  неоднородные
перегруппировка:  перегруппировка
правило:  правило правила правилу
логика:  логика логики
основной:  основные
размножать:  размножаем
эксплуатация:  эксплуатации
помощь:  помощью
расположить:  расположены
бернулли:  бернулли
полярный:  полярные полярной полярных
коэффициентковариация:  коэффициентковариации
другой:  другими других другие
оформить:  оформить
ряд:  ряд ряды ряда рядов
свой:  своя своих своей
средний:  средней средняя среднюю средних средние
отклонение:  отклонений отклонение
уровень:  уровня
обратный:  обратная обратную
второй:  второй второго
вопрос:  вопросы вопрос вопроса
компактность:  компактности
кратное:  кратные
системудифференциальный:  системудифференциальных
перечисленный:  перечисленные
блог:  блог
доверительный:  доверительные
первый:  первой первого
высокий:  высших высшей высшая высокий
называть:  называемое
среднееквадратический:  среднееквадратическое
мера:  меру
пространство:  пространстве
уметь:  уметь
лопиталя:  лопиталя
последовательность:  последовательностей
удобный:  удобный
комбинационный:  комбинационная
рассчитывать:  рассчитывали рассчитывать рассчитывают
курс:  курс
показатель:  показатель показатели
перекрёстный:  перекрёстную
квадратичный:  квадратичные
обычно:  обычно
смешанноепроизведение:  смешанноепроизведение
расписать:  расписать
гармонично:  гармонично
проверить:  проверить проверим
поляформула:  поляформула
сообщить:  сообщите
сделать:  сделать
линия:  линиями линии линия
фехнера:  фехнера
аналитический:  аналитическая аналитической
определить:  определить
поскольку:  поскольку
школьный:  школьный
эффективный:  эффективные
округление:  округлений
мы:  нам
центр:  центр
образ:  образом
гипергеометрическоераспределение:  гипергеометрическоераспределение
терпеться:  терпится
условный:  условные
непрерывнаяслучайный:  непрерывнаяслучайная
эллипс:  эллипс
группировочный:  группировочным группировочный группировочного
ибо:  ибо
четыре:  четыре
ноль:  ноль
страшный:  страшная страшной
поговорить:  поговорим
длина:  длина
материал:  материал материалы материалов
посмотреть:  посмотреть
статистика:  статистики статистика
сайт:  сайта сайты сайт
один:  одна одного
мочь:  могут можете можем
знакопостоянство:  знакопостоянства
немного:  немного
включать:  включает
равномерный:  равномерная равномерное
проводить:  проводить
треугольный:  треугольная
каждый:  каждому каждой
градиент:  градиент
догадаться:  догадались
определение:  определения определению
использовать:  используйте
пожалуйста:  пожалуйста
даламбер:  даламбера
понравиться:  понравились
теорема:  теоремы
комбинаторика:  комбинаторике
арифметический:  арифметическая
отдельный:  отдельный
случайнаявеличина:  случайнаявеличина
повторнойя:  повторнойи
построение:  построение
следовать:  следует
бесконечно:  бесконечно
накладываться:  накладываться
отношение:  отношению отношении
линейнойкорреляционный:  линейнойкорреляционной
действие:  действия действием
квалификация:  квалификация
квадрат:  квадратов квадраты
ранг:  ранг
время:  время
кривая:  кривой
оставаться:  остаётся
форма:  формы
тяжестиплоска:  тяжестиплоской
отметить:  отметить
сразу:  сразу
почему:  почему
распределениякритерия:  распределениякритерий
относительно:  относительно
функциюкомплексный:  функциюкомплексной
кратко:  кратко
разброс:  разброса
напоминать:  напоминаю
область:  область области
проверка:  проверка
оказывать:  оказывает
построить:  построить
готовый:  готовых
несобственный:  несобственные
просто:  просто
мода:  мода
выполнять:  выполнять
свойстваэлементарный:  свойстваэлементарных
ещё:  ещё
предложить:  предложены предложена
вернуться:  вернёмся
калькулятор:  калькулятор
лейбниц:  лейбница
научиться:  научиться
неравенство:  неравенства
происходить:  происходит
поток:  поток
быть:  буду е
влиять:  влияет
касательная:  касательная
ответ:  ответ ответы
задачис:  задачис
количество:  количестве
разбить:  разбить
медиана:  медиана
явно:  явно
нахождение:  нахождения
функциия:  функциии
возможно:  возможно
степенной:  степенного степенные
вышеприведённый:  вышеприведённой
функцийдвуха:  функцийдвух
направлениюй:  направлениюи
выборка:  выборке
формально:  формально
гостевой:  гостевая
распределение:  распределения распределение
кроме:  кроме
экстремум:  экстремумы
горнера:  горнера
отмечаться:  отмечалось
производныефункция:  производныефункции
звучать:  звучит
функцийнесколький:  функцийнескольких
единица:  единице
вывод:  вывод
рассчитать:  рассчитать рассчитали
внутригрупповаяй:  внутригрупповаяи
алгебра:  алгебры
далеко:  далеко
вникнуть:  вникнем
предположим:  предположим
математик:  математика
функцийв:  функцийв
переменный:  переменных переменной
три:  трех трёх
несовместный:  несовместные
независимыеслучайный:  независимыеслучайные
множественнойлинейный:  множественнойлинейной
никакой:  никакого
наоборот:  наоборот
научить:  научу
разряд:  разряды разрядам разряда
доля:  долю
анализ:  анализ анализа
зависимость:  зависимости зависимость
немалый:  немалом
прямоугольник:  прямоугольников
непрерывность:  непрерывность
эксцессэмпирический:  эксцессэмпирического
ютуба:  ютуб
металлоёмкость:  металлоёмкости металлоёмкость
способ:  способами
список:  список
функциис:  функциис
предыдущий:  предыдущая
зеркало:  зеркало
криволинейный:  криволинейные
начинать:  начинаю
неслучайный:  неслучайных
значит:  значит
пирсон:  пирсона
частота:  частотами
понимать:  понимать понимают
библиотека:  библиотека
ортогональный:  ортогональное
дискретнойслучайный:  дискретнойслучайной
подход:  подходе
задачипо:  задачипо
видео:  видео
востребовать:  востребованную
наименьшеезначение:  наименьшеезначения
нсв:  нсв
сила:  силы
кошмарить:  кошмарят
приблизить:  приближенные
исходный:  исходным
вычислимый:  вычислим
минута:  минут
пьеса:  пьесы
системылинейный:  системылинейных
нужно:  нужно
быстро:  быстро
примечание:  примечание
упасть:  упал
встретить:  встретить
организовать:  организовать
зависимый:  зависимые
буквально:  буквально
крамер:  крамера
отрезка:  отрезке
максимальный:  максимальная
распределять:  распределяет
математически:  математически
произведение:  произведение
знать:  знаете
внимательный:  внимательный
вполне:  вполне
лечь:  лёг
случайный:  случайных случайные
замкнутый:  замкнутому
набирать:  набираем
засечь:  засёк
должный:  должен
освоение:  освоения
очевидный:  очевидно очевиден
источник:  источников источниках
греческий:  греческая
дуга:  дуги
отрезкать:  отрезкав
желать:  желаю
дивергенция:  дивергенция
парабола:  парабола
немедленно:  немедленно
строго:  строго
форум:  форуме форум
повторимый:  повторим
принадлежать:  принадлежат
площадьс:  площадьс
равнонаполнить:  равнонаполненную
функциидвуха:  функциидвух
запретить:  запрещено
ранее:  ранее
статистический:  статистические статистическая статистической
емелин:  емелин
пять:  пяти
идти:  идёт
самый:  самая
строка:  строки
одинаковый:  одинаковые одинакова
убыванией:  убываниеи
вычисленияопределенный:  вычисленияопределенных
повышенный:  повышенной
возрастание:  возрастание возрастанию
эмпирический:  эмпирические эмпирический
детерминация:  детерминации
также:  также
интегрирование:  интегрирование
противоречие:  противоречия
задачин:  задачина
замечательный:  замечательные
обязательно:  обязательно
рациональный:  рациональные
системый:  системыи
начать:  начать
удовлетворяетлить:  удовлетворяетли
подсчитать:  подсчитали подсчитать
найтись:  нашлось
этот:  этих эта
выполнить:  выполнить
тип:  типами
пока:  пока
нуль:  нулю
кропотливый:  кропотливая
дифференциальныеуравнение:  дифференциальныеуравнения
квалицировать:  квалицированных
оборудование:  оборудования
иррациональный:  иррациональных
разбитый:  разбиты
интервальный:  интервальный
перейти:  перейти
тригонометрический:  тригонометрических
постоянный:  постоянных
квадратичнуюформ:  квадратичнуюформу
стокс:  стокса
схема:  схема
карта:  карта
параметрический:  параметрической параметрическом
вычисление:  вычисления вычисление
учитывать:  учитывает
г:  г
гипербола:  гипербола
квалифицировать:  квалифицированных
вообще:  вообще
равно:  равно
рабочий:  рабочих
дробовик:  дробовик
они:  ними
оценкия:  оценкии
неявный:  неявной
несобственныхинтеграл:  несобственныхинтегралов
вероятностибиномиальный:  вероятностибиномиального
слабо:  слабо
факт:  фактом
вероятностия:  вероятностии
объяснить:  объяснённую
род:  рода
заданав:  заданав
скалярный:  скалярное
спирмена:  спирмена
гаусс:  гаусса
порядок:  порядка порядков
всё:  всё
лежать:  лежит
различаться:  различается
значимость:  значимости
тройной:  тройные
специально:  специально
логично:  логично
возникать:  возникает
деление:  деления
контуруформула:  контуруформула
лёгкий:  лёгких
экстремальный:  экстремальные
разобрать:  разобранные
график:  график
близко:  близко
верный:  верное
лишь:  лишь
её:  её
св:  св
парный:  парной
разгромить:  разгромим
нормаль:  нормали
определитель:  определитель
просуммировать:  просуммировать
выпуклость:  выпуклость
несколько:  несколько
элемент:  элементы
достаточно:  достаточно
сборник:  сборники
простота:  простоты
верно:  верно
показательный:  показательное
независимый:  независимые
примерно:  примерно
занять:  заняли
разбирать:  разбирать
автор:  автора автор
сложность:  сложности
диффура:  диффурами
часто:  часто
значенияй:  значенияи
справедливо:  справедливо
привести:  привести
изучение:  изучения
табличка:  табличку
обозначение:  обозначения
получаться:  получается
сторона:  стороны
надеяться:  надеюсь
классическоеопределение:  классическоеопределение
инормаль:  инормаль
небольшой:  небольшую
корреляция:  корреляции
погрешность:  погрешности
рассеяние:  рассеяния
значимый:  значимо
биномиальный:  биномиальное
далёкий:  дальше
пирамида:  пирамида
сгруппировать:  сгруппировали
линиюв:  линиюв
положить:  положенный
находиться:  находятся
изменяться:  изменяется
тушеваться:  тушеваться
специфика:  спецификой
повторять:  повторяем
остаться:  оставшаяся
