производный:  производные производная производной производную
предел:  предел пределами пределы пределов предела пределе
небольшой:  небольшой
остаться:  оставшимися оставшийся
половина:  половина
числовой:  числовые числового числовой числовыми числовых
производныенеявно:  производныенеявно
значение:  значение значений значения значении
отрицательный:  отрицательные
формула:  формулы формула
смотреть:  см смотрите
ряд:  рядами ряды ряда ряд рядах рядов
нарисовать:  нарисован
канонический:  каноническому
дифференциал:  дифференциалах дифференциала
больший:  наибольшее большей
многие:  многие
различный:  различные различных
извлекать:  извлекаем
оказать:  оказана
избавляться:  избавляемся
игнорировать:  игнорируем
монотонно:  монотонно
сам:  самого
число:  число числами числу чисел числа
вогнутостья:  вогнутостьи
верный:  верный верном
двойной:  двойных двойные двойной двойного
начинаться:  начинаются
стать:  стали
случай:  случай случаи случая случае случаями случаях
принадлежность:  принадлежность
профессия:  профессию
условие:  условии условий
находиться:  находиться
сравнить:  сравнить
жарко:  жарко
умножение:  умножения
система:  система системе систему системы
группировка:  группировок группировка
познакомиться:  познакомимся
он:  нему нём
условнаясходимость:  условнаясходимость
слово:  словами
александр:  александр
необходимый:  необходимый
термин:  термины терминов
уровень:  уровень уровня
пробить:  пробил
многочисленный:  многочисленные
который:  которые котором которая которое которого которым
редко:  редко
линейный:  линейные линейная линейных линейной
знакочередоваться:  знакочередующимся знакочередующиеся
правый:  правой правый
приём:  приемов
обычный:  обычных обычный
согласие:  согласия
вычисление:  вычислениям вычисления вычисление
дуоперационный:  дуоперационным
куба:  кубы
базис:  базисах базису базис
наиболее:  наиболее
идти:  идти идут идёт
зависимостьвектор:  зависимостьвекторов
осветить:  освещен
справиться:  справиться
сходимость:  сходимостью сходимости сходимость
сначала:  сначала
метод:  методы методом метод
составлять:  составляем составляли
геометрически:  геометрически
страница:  страницу
числитель:  числителе числитель числителя
математический:  математическая математические математической
данные:  данных
интеграл:  интеграл интегралов интегралы интеграла интегралом интеграле
урок:  урока уроки уроков урок уроку уроке
разложение:  разложением разложении разложение разложению
результат:  результатов результат результате
спешить:  спешить
расходиться:  расходится расходящимся расходиться
конкретный:  конкретного
икс:  икс иксу
уравнение:  уравнению уравнения уравнение уравнений
переход:  переход
получиться:  получилось получится получился
разновидность:  разновидностью
совпадать:  совпадают совпадает
причина:  причины причине
знакочередование:  знакочередование
практический:  практических практическую
целесообразно:  целесообразно
малый:  малые наименьших
связь:  связь
степенной:  степенными степенного степенной степенных степенные
внести:  внесу
нормальный:  нормальное
интегральнаятеорема:  интегральнаятеоремы
корнимногочлен:  корнимногочлена
логарифмический:  логарифмическая
направленность:  направленность
условно:  условно
начать:  начнём начать
основной:  основные
бернулли:  бернулли
единица:  единицу единица
полярный:  полярные полярных полярной
рассмотреть:  рассмотрим рассмотренном рассмотреть
доверительный:  доверительные
интерпретация:  интерпретацию
среднееквадратический:  среднееквадратическое
момент:  моменте
тип:  типа
тривиальный:  тривиальный
убывание:  убывание
комбинационный:  комбинационная
оба:  обе обеих обоих
смешанноепроизведение:  смешанноепроизведение
функция:  функции функция функций
вместе:  вместе
дисперсия:  дисперсия дисперсии дисперсию
школьный:  школьный школьному
мы:  нам
приближённый:  приближённым
образ:  образом
распространить:  распространенный распространен распространенную
выбирать:  выбираем
непрерывнаяслучайный:  непрерывнаяслучайная
другой:  других другими другое другие
длина:  длина длины
материал:  материал материала материалов материалы
немного:  немного
мочь:  могут
знакопостоянство:  знакопостоянства
проводить:  проводить
интервал:  интервале интервала интервалы интервал интервалом
градиент:  градиент
конец:  конец конце концах
линия:  линия линии линиями
глава:  глава
комбинаторика:  комбинаторике
сокращаться:  сокращается
случайнаявеличина:  случайнаявеличина
мой:  моих
начинка:  начинка начинкой
бесконечно:  бесконечно
обеспечивать:  обеспечивает обеспечивающий
порция:  порции
форма:  формы
равный:  равны равен равна
задача:  задачу задачи задач задача
знание:  знания
отметить:  отметить
окончательный:  окончательный
обратный:  обратную обратная
модуль:  модулей модулю модуля модулем модуль
третий:  третий
сравнимый:  сравним
готовый:  готовых
просто:  просто
сократиться:  сократился сократились
ещё:  ещё
произвольный:  произвольного произвольных
приложение:  приложения
свой:  своих
часть:  частей частью частям части
быть:  буду будьте будут
влиять:  влияет
косвенно:  косвенно
холодно:  холодно
начальный:  начального
обращать:  обращаю
четырехэтажность:  четырехэтажности
любить:  любить
сходиться:  сходится сходиться сходящийся сходящимся
данный:  данного данном данный
непрерывный:  непрерывных непрерывная непрерывна
производныефункция:  производныефункции
средний:  средняя
знак:  знаком знак
отщипывать:  отщипываем
область:  области область областью
подобрать:  подобрать
плюс:  плюс
путь:  пути
математик:  математика
переменный:  переменных переменной переменная
пример:  пример примера примеров примере примерах примеры
несовместный:  несовместные
независимыеслучайный:  независимыеслучайные
выяснение:  выяснения
ответ:  ответа ответ ответы
следовательно:  следовательно
содержать:  содержать содержащих
основать:  основанная основана
модель:  модель модели
минус:  минус минусы
непрерывность:  непрерывность
расставить:  расставлены
функциис:  функциис
полный:  полной полных полное
зеркало:  зеркало
второй:  втором второго второй
значит:  значит
пирсон:  пирсона
член:  члены члена член членами
вычислить:  вычисленный вычислили вычислить
вопрос:  вопрос вопросы
прозрачный:  прозрачен
межгрупповой:  межгрупповая
ортогональный:  ортогональное
нсв:  нсв
старший:  старшая старшей старшую старшего
составление:  составлении
надоесть:  надоел
проанализировать:  проанализировать
какой:  какое
упасть:  упал
ход:  ходе
отрезка:  отрезке
повеситься:  повесился
трудно:  трудно
величина:  величина величин величины
методика:  методике
короче:  короче
положительный:  положительные положительный
умножать:  умножаем
детерминация:  детерминации
конечный:  конечное
обязательно:  обязательно
экзамен:  экзаменах
степень:  степенями степень степени
дифференциальныеуравнение:  дифференциальныеуравнения
гармонический:  гармонического гармоническим
прямой:  прямая прямой прямую
состав:  состав
середина:  середине
подстановка:  подстановке подстановки
постоянный:  постоянных
стокс:  стокса
отдышаться:  отдышавшись
схема:  схема
работа:  работы работа работу
оформление:  оформление
жизнь:  жизнь
дробовик:  дробовик
получить:  получен полученного получено полученный получи
математика:  математике математики
векторный:  векторное векторного
вероятностия:  вероятностии
скалярный:  скалярное
задание:  заданиях задание заданий задании задания
значимость:  значимости
мысленно:  мысленно
функциональный:  функциональных функциональными функциональные функционального функциональный
признак:  признака признак признаке признаку признакам признаки признаком
предельный:  предельный
анализ:  анализа анализ
частный:  частное частные
парный:  парной
успешный:  успешного
временно:  временно
несколько:  несколько
найти:  найдём найдем найден найти найденного
сборник:  сборники
параметрический:  параметрическом параметрической
являться:  являетесь являются является
часто:  часто
неправильно:  неправильно
никак:  никак
получаться:  получается
ориентир:  ориентиры
находить:  находим
решение:  решение решением решения решений
форум:  форум форуме
книга:  книги книга
начинающий:  начинающему
дополнительный:  дополнительное дополнительных
теоретический:  теоретического
вынести:  вынести
вектор:  векторы векторов
раздел:  разделе
внимательный:  внимательны
вращение:  вращения
именно:  именно
неотрицательный:  неотрицательным неотрицательные
копирование:  копирование
разрыв:  разрыва
один:  одного одна одном
выражение:  выражения
натуральный:  натуральном
мучение:  мучения
необходимость:  необходимости
значок:  значок
отблагодарить:  отблагодарить
байес:  байеса
простой:  проще простой
рассматривать:  рассматриваем рассматриваемая
выгодно:  выгодно
решать:  решать
выяснить:  выясним
теория:  теория теории
определять:  определяем
наш:  нашему наш наша
двумерный:  двумерная
друг:  друг другом
задать:  заданной задайте
популярный:  популярной
тело:  тела
циркуляция:  циркуляция
слагаемое:  слагаемого
слева:  слева
плоскость:  плоскости плоскость
отношение:  отношение отношении
общий:  общим общая общий общем общего
убывать:  убывают
оставить:  оставить
соответствовать:  соответствующим соответствующем
определителяй:  определителяи
выносить:  выносим
вычитать:  вычитаем
закон:  законы
дробь:  дроби дробь дробей
справа:  справа
последовательно:  последовательно
действие:  действий действия
вероятность:  вероятностей вероятность вероятности
записывать:  записывают
любой:  любое любой любая любого любом
старый:  старый старая
заключение:  заключение
уравненийв:  уравненийв
множитель:  множитель
отрезок:  отрезок
переписать:  переписать
грин:  грина
входить:  входит
эйлер:  эйлера
иной:  иное иными
бесследно:  бесследно
дискретный:  дискретный
заметно:  заметно
бесконечность:  бесконечности бесконечность
техника:  техникой техника
практически:  практически
сложный:  сложной сложный сложные сложных
рассмотрение:  рассмотрению
фурье:  фурье
отвлекаться:  отвлекаемся
поле:  поля
гипотеза:  гипотез гипотеза гипотезы
свойство:  свойства
равномерный:  равномерной равномерная равномерное
исследование:  исследование исследования
весь:  всем
точка:  точки точках точка точке
вариация:  вариации
основа:  основы
переходить:  переходим
кош:  коши
параграф:  параграфа параграфе
чайник:  чайников чайникам чайником
вычисленияс:  вычисленияс
некоторый:  некоторым некоторых некотором некоторое некоторые
матричный:  матричные матричных матричный
действительный:  действительное
заметить:  заметили заметьте
навык:  навыки
однородный:  однородные однородным
очень:  очень
корень:  корнем корень
матрица:  матрицу матрицы матрицами
этап:  этапе
испытанияй:  испытанияи
интегралыть:  интегралыв
научиться:  научимся научиться
перегруппировка:  перегруппировка
помощь:  помощью помощь
вариационный:  вариационный
блог:  блог
высокий:  высших высшей высшая
единственный:  единственной единственному единственная
пространство:  пространстве
удобный:  удобный
курс:  курс курсе
координата:  координаты координат координатах
буковка:  буковка
знакомый:  знакомая знакомым знакомы
окончательно:  окончательно
сообщить:  сообщите
аналитический:  аналитическая аналитической
понижение:  понижение понижением
неравенство:  неравенств неравенство неравенства
формулировать:  формулируют
левый:  левой левый
центр:  центр
нахождение:  нахождение нахождении
писать:  пишем
построение:  построение
вспоминать:  вспоминаем
называть:  называть
линейнойкорреляционный:  линейнойкорреляционной
оставаться:  остаётся
почему:  почему
распределениякритерия:  распределениякритерий
несобственный:  несобственные несобственным
полностью:  полностью
касательная:  касательная
задачис:  задачис
правило:  правила правилу правило
функциия:  функциии
возможно:  возможно
функцийдвуха:  функцийдвух
происходить:  происходить происходит
выборка:  выборке
функцийнесколький:  функцийнескольких
рост:  роста
квадрат:  квадрат квадратов
множественнойлинейный:  множественнойлинейной
тема:  темы
каждый:  каждой каждый
распределение:  распределение распределения
забывать:  забываем
радикальный:  радикальный
закомментировать:  закомментировать
задачипо:  задачипо
два:  двумя
востребовать:  востребованную
приблизить:  приближенные
изучить:  изучить
обобщённый:  обобщенного
примечание:  примечание
следующий:  следующего следующий следующем
зависимый:  зависимые
отклонение:  отклонение
таблица:  таблицы
произведение:  произведение
вполне:  вполне
случайный:  случайных случайные
ужас:  ужаса
дуга:  дуги
частность:  частности
отрезкать:  отрезкав
дивергенция:  дивергенция
использование:  использования
уничтожать:  уничтожает
сайт:  сайт сайте сайты сайта
графика:  графики графика
неопределённость:  неопределенность
неверно:  неверно
возрастание:  возрастание
эмпирический:  эмпирические
турбо:  турбо
подставить:  подставим подставили
найтись:  нашлось
этот:  этих
разбираться:  разбираться
указать:  указать
иррациональный:  иррациональных
определение:  определению определения
подчёркивать:  подчеркиваю
квадратичнуюформ:  квадратичнуюформу
сокращать:  сокращаем
двучлен:  двучлена двучлен
карта:  карта
прежний:  прежним
гипербола:  гипербола
они:  ними
коэффициент:  коэффициентами коэффициент коэффициенты
право:  право
произойти:  произошло
логика:  логики
новизна:  новизны
спирмена:  спирмена
формальный:  формальной
вид:  виду виды вид виде
лишь:  лишь
св:  св
самый:  самый
иметь:  имеет
сумма:  суммы сумму сумма
факториал:  факториалы факториалов
предыдущий:  предыдущих предыдущем предыдущего предыдущему предыдущий
достаточно:  достаточно
показательный:  показательное
преобразование:  преобразования преобразований
неверный:  неверной
диффура:  диффурами
почленно:  почленно
относиться:  относится
множество:  множество множества
использовать:  используем использовать используйте
представлять:  представляет представляют
статистика:  статистика
подставлять:  подставляем подставляя
биномиальный:  биномиальное
вознаграждение:  вознаграждение
линиюв:  линиюв
куб:  кубом
самостоятельный:  самостоятельного
решить:  решить
установить:  установлено
дуприближённо:  дуприближённо
рассказ:  рассказов
асимптота:  асимптоты
событие:  события
повторный:  повторные
умножить:  умноженные
смех:  смех
позади:  позади
состоять:  состоит
фнп:  фнп
простейшее:  простейшие
семейство:  семейства
знаменатель:  знаменателя знаменатель знаменателе
несобство:  несобств
нелинейный:  нелинейная
брать:  берём
применить:  применить
преобразованиеквадратичный:  преобразованиеквадратичной
подробность:  подробности
статья:  статья статье статьях
час:  час
геометрический:  геометрическая геометрическое
абсолютный:  абсолютная
выполнить:  выполнен
встречаться:  встречаются встречается
сложенияй:  сложенияи
раскрывать:  раскрываем
регрессия:  регрессии регрессия
требовать:  требуют
жаловать:  жаловать
подчеркнуть:  подчеркну
исчисление:  исчисления
локальный:  локальная
ожидание:  ожидание
лаплас:  лапласа
такой:  таким такие такое такого
перегиб:  перегиба
поехать:  поехали
тот:  те той
ду:  ду
далее:  далее
делать:  делать
полуинтервал:  полуинтервал
неопределённый:  неопределенный неопределенном
прикол:  прикол
собственный:  собственные
элемент:  элемент элементы
рядом:  рядом
поэтому:  поэтому
практика:  практике
проработать:  проработать
пункт:  пункте
длиннющий:  длиннющая
исследовать:  исследуем исследовать исследуемого
асимметрия:  асимметрия
шаг:  шаге
главный:  главную
динамический:  динамической
сводиться:  сводящиеся
замена:  замены
характер:  характер
составить:  составленного составить
маленький:  меньше
утомиться:  утомился
например:  например
решенияопределённый:  решенияопределенных
выглядеть:  выглядит
классификация:  классификация
значить:  значило
многочлен:  многочленов
коэффициентковариация:  коэффициентковариации
выполнение:  выполнение
обозначать:  обозначает
доказать:  доказали доказанному
желание:  желании
приводить:  приводить
абсолютно:  абсолютно
лопиталя:  лопиталя
называться:  называется
поляформула:  поляформула
просить:  прошу
фехнера:  фехнера
эффективный:  эффективные
условный:  условные
эллипс:  эллипс
ноль:  ноль
сократить:  сократить
прибавлять:  прибавляем
даламбер:  даламбера
теорема:  теоремы
целый:  целые
повторнойя:  повторнойи
естественно:  естественно
сложность:  сложностей сложности
комплексный:  комплексные комплексного комплексный комплексными
ранг:  ранг
кривая:  кривой
тяжестиплоска:  тяжестиплоской
относительно:  относительно
зато:  зато
понятный:  понятнее
проверка:  проверка
построить:  построить
давать:  давать даём
сохраняться:  сохраняется
внимание:  внимание
лейбниц:  лейбница
поток:  поток
отдельный:  отдельная
медиана:  медиана
бывать:  бывает
записать:  записать
направлениюй:  направлениюи
гостевой:  гостевая
рисунок:  рисунок
кроме:  кроме
страшный:  страшной
понятно:  понятно
зачёт:  зачетах
вывод:  вывод
применять:  применять
внутригрупповаяй:  внутригрупповаяи
зависеть:  зависит зависящего
вдаваться:  вдаюсь
алгебра:  алгебры
пара:  пару
невероятно:  невероятно
существовать:  существует
остановиться:  остановлюсь
прямоугольник:  прямоугольников
эксцессэмпирический:  эксцессэмпирического
оценка:  оценка оценки
криволинейный:  криволинейные
устранять:  устраняем
библиотека:  библиотека
наименьшеезначение:  наименьшеезначения
сила:  силы
рассказывать:  рассказывал
системылинейный:  системылинейных
нужно:  нужно
типовой:  типового типовую
зависимость:  зависимость
замкнутый:  замкнутому
возможный:  возможны
должный:  должен
очевидный:  очевидно
покурить:  покурить
желать:  желаю
показатель:  показатели
площадьс:  площадьс
большинство:  большинстве
убыванией:  убываниеи
повышенный:  повышенной
статистический:  статистическая статистические
также:  также
дать:  данная
интегрирование:  интегрирование
рациональный:  рациональные
интегральный:  интегральный
выделяться:  выделяется
нуль:  нулю нуля
ситуация:  ситуация
читать:  читайте
интервальный:  интервальный
итак:  итак
вообще:  вообще
оценкия:  оценкии
неявный:  неявной
несобственныхинтеграл:  несобственныхинтегралов
вероятностибиномиальный:  вероятностибиномиального
род:  рода
гаусс:  гаусса
хитро:  хитро
честно:  честно
особый:  особых
точно:  точно
экстремальный:  экстремальные
нормаль:  нормали
определитель:  определитель
выпуклость:  выпуклость
начало:  начала
первый:  первом первого
менее:  менее
значенияй:  значенияи
справедливый:  справедлива
объяснять:  объяснять
нужный:  нужной
кстати:  кстати
опираться:  опирались
классическоеопределение:  классическоеопределение
инормаль:  инормаль
радиус:  радиуса радиус
пирамида:  пирамида
наслать:  нашли
автор:  автор автора
делимый:  делим
понимание:  понимания
цель:  целях
дифференциальный:  дифференциальные
уравненияс:  уравненияс
онлайн:  онлайн
геометрия:  геометрии геометрия
использоваться:  используется
новый:  новому нового
произвольныйтройный:  произвольныйтройной
ниже:  ниже
дизайн:  дизайна
это:  это
сходить:  сходить
нулевой:  нулевыми нулевой
отбрасывать:  отбрасываем
помнить:  помним
поляй:  поляи
опечатка:  опечатку
отличный:  отличное
способ:  способом
носить:  носят
речь:  речь
технически:  технически
непременно:  непременно
методомоперационный:  методомоперационного
бесповторный:  бесповторной
правильно:  правильно
ошибка:  ошибку
л:  л
возводить:  возводим
касательный:  касательных
константа:  константу
типовыхзадача:  типовыхзадач
выясниться:  выяснилось
ранговойкорреляция:  ранговойкорреляции
эквивалентный:  эквивалентно
элементарный:  элементарные
подопытный:  подопытный
выбрать:  выберем
расходимость:  расходимость
поверхность:  поверхности
линейныйкоэффициент:  линейныйкоэффициент
несобственныйинтеграл:  несобственныйинтеграл
доступно:  доступно
удобство:  удобства
причём:  причём причем
учиться:  учимся
задавать:  задаваемые
ипример:  ипримеры
требоваться:  требуется
указывать:  указывая
поверхностный:  поверхностные
фигура:  фигуры
рассматриваться:  рассматривалась
пуассон:  пуассона
изучение:  изучению
подобный:  подобные
успех:  успехов
однако:  однако
единый:  единую
математическоеожидание:  математическоеожидание
стандартный:  стандартное стандартным
скорый:  скорая
школа:  школа
симметричный:  симметричен
неоднородный:  неоднородные
необходимо:  необходимо
проверять:  проверяем
вариант:  вариантов
думать:  думаю
кратное:  кратные
системудифференциальный:  системудифференциальных
помимо:  помимо
уметь:  уметь
алгоритм:  алгоритм
подарок:  подарков подарок
последовательность:  последовательностей
квадратичный:  квадратичные
расписать:  расписать
объём:  объем
отсутствовать:  отсутствующими
проверить:  проверить
поскольку:  поскольку
гипергеометрическоераспределение:  гипергеометрическоераспределение
извлекаться:  извлекается
обратить:  обратите
понятие:  понятие
подробно:  подробно
треугольный:  треугольная
пожалуйста:  пожалуйста
принимать:  принимать принимает
план:  плане
следовать:  следует
себя:  собой
раскрыть:  раскрыли
привлечь:  привлечь
сразу:  сразу
похожий:  похожи
функциюкомплексный:  функциюкомплексной
напоминать:  напоминаю
мода:  мода
подводить:  подводим
свойстваэлементарный:  свойстваэлементарных
считать:  считать
калькулятор:  калькулятор
учебный:  учебной
особняком:  особняком
определённый:  определенный определенного
экстремум:  экстремумы
постараться:  постараюсь
горнера:  горнера
сравнение:  сравнения
предельно:  предельно
получать:  получаем
функцийв:  функцийв
видеть:  видите
довольно:  довольно
понимать:  понимать
три:  трёх
дискретнойслучайный:  дискретнойслучайной
обилие:  обилия
крамер:  крамера
освоение:  освоения
расправляться:  расправляемся
парабола:  парабола
строго:  строго
пугаться:  пугаться
повторимый:  повторим
расписывать:  расписываем
запретить:  запрещено
к:  ко
функциидвуха:  функциидвух
черновик:  черновике
емелин:  емелин
широко:  широко
вычисленияопределенный:  вычисленияопределенных
пропасть:  пропал
замечательный:  замечательные
задачин:  задачина
системый:  системыи
удовлетворяетлить:  удовлетворяетли
заканчивать:  заканчивает
эталонный:  эталонный
тригонометрический:  тригонометрических
казаться:  казалось
разнообразие:  разнообразие
заданав:  заданав
порядок:  порядка порядков
всё:  всё
технический:  технических
тройной:  тройные
деление:  деления
контуруформула:  контуруформула
график:  график
приступить:  приступили
энна:  энной
догадываться:  догадываетесь
либо:  либо
рекомендовать:  рекомендую
эн:  эн
независимый:  независимые
детализировать:  детализированный
раскладывать:  раскладываем
привести:  привести
дело:  дело
разобрать:  разберу
обозначение:  обозначения
трафаретный:  трафаретен
корреляция:  корреляции
заочник:  заочников
подынтегральный:  подынтегральная
максимально:  максимально
развернуть:  развернутом
повторять:  повторяем
пропуск:  пропусками
литература:  литературе
