часовой:  часовой
производный:  производные производная производной производную
предел:  предел пределами пределы пределов пределе пределам
подкоренной:  подкоренное
выбор:  выбор
числовой:  числовые
производныенеявно:  производныенеявно
значение:  значение значения
форма:  формой формы
обозначать:  обозначают
общий:  общему общим общая общей общую
ужас:  ужас ужаса
контрольный:  контрольных
игрек:  игрек игреков
формула:  формулы формулой формуле формула формулу
смотреть:  см
нейтрально:  нейтрально
особенно:  особенно
канонический:  каноническому каноническое
два:  две двум двух
параметр:  параметра параметр
дифференциал:  дифференциалах дифференциалов дифференциал дифференциалы дифференциалами дифференциала
больший:  наибольшее большим большую большей
выразить:  выразим выразить
стрелка:  стрелки
криволинейный:  криволинейного криволинейным криволинейных криволинейные криволинейная криволинейный криволинейную
против:  против
новый:  новой новым новому
означать:  означает
избавляться:  избавляемся
сам:  самого самом сама самой
вогнутостья:  вогнутостьи
кусок:  куском кусок
стрижка:  стрижка
многий:  многих
двойной:  двойных двойные двойной
стать:  стали станет
подынтегральный:  подынтегральном подынтегральных подынтегральное подынтегральная
случай:  случай случае случаях
плохой:  хуже
профессия:  профессию
условие:  условии условие условия условию
пусть:  пусть
удобно:  удобно
наличие:  наличию
умножение:  умножения
система:  система системе систему системы
выполнимый:  выполним
группировка:  группировок группировка
познакомиться:  познакомимся
условнаясходимость:  условнаясходимость
окружность:  окружность окружности
слово:  словами словах слову
александр:  александр
ось:  ось оси осям
остаться:  осталось осталась
обусловить:  обусловлен
который:  которые который которая которым
традиционный:  традиционный
линейный:  линейные линейная линейных линейной
быть:  суть буду будут
пожарный:  пожарный
согласие:  согласия
вычисление:  вычислением вычисления вычисление
прочий:  прочие
понятие:  понятию понятие
знать:  знают
дуоперационный:  дуоперационным
указать:  указанным
базис:  базисах базису базис
бохан:  бохана
обычный:  обычному обычные
цилиндрический:  цилиндрической
наиболее:  наиболее
зависимостьвектор:  зависимостьвекторов
распространить:  распространённый
оно:  оно
день:  день
сначала:  сначала
метод:  методы методах методом метод
геометрически:  геометрически
страница:  страницу
различие:  различие
математический:  математическая математические математической
данные:  данных
природа:  природой
прямой:  прямых прямая прямой прямые прямую
интеграл:  интеграл интегралу интегралов интегралы интеграла интеграле интегралам
урок:  урока урок уроке
разложение:  разложением разложение
сводиться:  сводится сводящиеся
прозрачный:  прозрачно
замысловатый:  замысловатый
икс:  икс иксов икса
уравнение:  уравнению уравнения уравнение уравнением уравнениями уравнений
переход:  переход переходе перехода
нетерпение:  нетерпением
существо:  существу
целиком:  целиком
требование:  требованием
координатный:  координатным координатная координатной координатные
комната:  комнаты
угол:  углу углы
работа:  работах работа
малый:  малые малому наименьших
связь:  связь связи
точка:  точку точки точка точками точкам точек точке
нормальный:  нормальное нормальных
интегральнаятеорема:  интегральнаятеоремы
корнимногочлен:  корнимногочлена
логарифмический:  логарифмическая
подбирать:  подбирать
расположить:  расположенной расположен расположена расположенная
основной:  основные основной
функция:  функцией функции функция функций функцию
заглянуть:  загляните
бернулли:  бернулли
нужный:  нужен нужной
полярный:  полярные полярных полярной
рассмотреть:  рассмотрим рассмотреть
ряд:  ряды ряда ряд рядов
уровень:  уровня
должный:  должны должна
разбиение:  разбиения
определённый:  определённого определённому определенный определенного
доверительный:  доверительные
среднееквадратический:  среднееквадратическое
тривиальный:  тривиальный
комбинационный:  комбинационная
фрагмент:  фрагмента фрагмент
смешанноепроизведение:  смешанноепроизведение
популярность:  популярность
вместе:  вместе
сподручный:  сподручнее
дисперсия:  дисперсия дисперсии дисперсию
школьный:  школьный
мы:  нам нами
образ:  образом
непрерывнаяслучайный:  непрерывнаяслучайная
ибо:  ибо
длина:  длина длины длине длинам
мочь:  могут
знакопостоянство:  знакопостоянства
площадь:  площади площадь
градиент:  градиент
линия:  линия линии линию линиями
вспомнить:  вспомним
комбинаторика:  комбинаторике
измениться:  изменится
случайнаявеличина:  случайнаявеличина
бесконечно:  бесконечно
отметить:  отметить
задача:  задаче задачи задач задача
обратный:  обратную обратная обратном
готовый:  готовых
просто:  просто
подготовка:  подготовка
ещё:  ещё
тело:  тело тела
крепость:  крепости
приложение:  приложения
соответствовать:  соответствующую соответствует соответствующий соответствуют
отличаться:  отличается
кусочек:  кусочка кусочков кусочки
читатель:  читателей читатели
данный:  данного данном данный
непрерывный:  непрерывных непрерывная непрерывна
производныефункция:  производныефункции
средний:  средняя
знак:  знаком знак
объединять:  объединяли объединяет
область:  области область областью
ссылка:  ссылке ссылки
бесконечный:  бесконечным
ласковый:  ласковых
путь:  пути путь
предположим:  предположим
число:  числами числа
математик:  математика
переменный:  переменных переменной
пример:  пример примера примеров примере примерах примеры
посмотреть:  посмотрим
др:  др
упрощение:  упрощения
несовместный:  несовместные
независимыеслучайный:  независимыеслучайные
модуль:  модулю модуля
добавить:  добавить
следовательно:  следовательно
модель:  модель модели
минус:  минус минусом
непрерывность:  непрерывность
содержать:  содержит
догадаться:  догадаться
верхний:  верхняя верхней
функциис:  функциис
право:  правом
полный:  полной полным полных полное
зеркало:  зеркало
значит:  значит
пирсон:  пирсона
вопрос:  вопрос вопросы
межгрупповой:  межгрупповая
ортогональный:  ортогональное
разборка:  разборки
нсв:  нсв
схема:  схему схема
причесать:  причесать
положение:  положение
проанализировать:  проанализировать
придумать:  придумал придумаешь придумаю
упасть:  упал
изменение:  изменении изменение изменения
отрезка:  отрезке отрезкам
величина:  величина величин величины
важный:  важный важны важна важен
интегральный:  интегральная интегрального
поверхность:  поверхность поверхности
внимательно:  внимательно
получить:  полученные получи
заведомо:  заведомо
один:  одним одного одна одной
свойство:  свойствами свойства свойство
рассматривать:  рассматриваемой рассматриваемого
она:  неё
высота:  высоту высоты
детерминация:  детерминации
обязательно:  обязательно
тот:  тех те той
начать:  начать
кривая:  кривая кривые кривой кривую
выполнить:  выполнить
дифференциальныеуравнение:  дифференциальныеуравнения
название:  названия
игреков:  игрековых
постоянный:  постоянных
стокс:  стокса
свести:  свести
самостоятельно:  самостоятельно
жизнь:  жизнь
частично:  частично
дробовик:  дробовик
часть:  частью частям часть части
математика:  математике математики
векторный:  векторное векторного
вероятностия:  вероятностии
скалярный:  скалярное
совершенно:  совершенно
понятный:  понятен
значимость:  значимости
трапеция:  трапеция трапецию
убывать:  убывающего убывают убывать
каламбурный:  каламбурно
дать:  дана данные данной
несобственный:  несобственный несобственные
такой:  такую таким такое такого такая таких
анализ:  анализа анализ
её:  её
частный:  частное частные
парный:  парной
выражать:  выражающая
найти:  найдём найти
сборник:  сборники
параметрический:  параметрическом параметрического параметрическими параметрические параметрической
классический:  классическую
часто:  часто
расправить:  расправленное
получаться:  получается
находить:  находим
надеяться:  надеюсь
решение:  решение решением решения решений
место:  место
форум:  форум форуме
записывать:  записывать
типичный:  типичными
наш:  наши наш нашей
книга:  книги книга
таков:  таково такова
провести:  провести проведём
эллипс:  эллипса эллипс
изменяться:  изменяется
вектор:  векторы векторов вектора
вращение:  вращения
копирование:  копирование
давать:  давайте
разрыв:  разрыва
выражение:  выражения выражении выражение
парабола:  параболы парабола
грубо:  грубо
отблагодарить:  отблагодарить
являться:  являются является
байес:  байеса
простой:  проще проста
решать:  решать решали решай
цилиндр:  цилиндра цилиндр
одеяло:  одеялом одеяла одеяло
результат:  результат результата результате
теория:  теория теории
прийти:  пришла
высекать:  высекающий
двумерный:  двумерная
задать:  заданной задайте заданное задана заданному
циркуляция:  циркуляция
плоскость:  плоскости плоскостью плоскость
милость:  милости
получиться:  получится получиться получилась
определителяй:  определителяи
согласно:  согласно
закон:  законы
справа:  справа
дробь:  дроби дробей
разделение:  разделение
буква:  буква
ситуация:  ситуацию
вероятность:  вероятностей вероятность вероятности
заключение:  заключение
уравненийв:  уравненийв
отрезок:  отрезок отрезков
обстоятельство:  обстоятельства
грин:  грина
эйлер:  эйлера
иной:  иное иными
геометрический:  геометрический геометрическая геометрическое
дискретный:  дискретный
обязательный:  обязательным
знакочередоваться:  знакочередующиеся
бесконечность:  бесконечности
практически:  практически
способ:  способе способом способ
произвольный:  произвольных произвольную
сложный:  сложной сложные сложных
сердце:  сердца
выбирать:  выбирать
фурье:  фурье
поле:  поля
гипотеза:  гипотез гипотеза гипотезы
момент:  момент моментом
исследование:  исследование
объём:  объема объёме объем
плоский:  плоской плоская
проблема:  проблем
вариация:  вариации
подставить:  подставив подставим
паркет:  паркет
старший:  старшим
основа:  основы
слишком:  слишком
думать:  думать думаю
интервал:  интервалы
кош:  коши
выше:  выше
нарисовать:  нарисовать
начертить:  начертите начертить
чайник:  чайников
каждый:  каждым каждый
предложить:  предложенной
вычисленияс:  вычисленияс
появляться:  появляется
матричный:  матричные матричных матричный
аддитивность:  аддитивности
заметить:  заметили
навык:  навыки
однородный:  однородные однородным
выполнять:  выполняют
существенный:  существенное
вычислить:  вычислить
матрица:  матрицу матрицы матрицами
испытанияй:  испытанияи
интегралыть:  интегралыв
перегруппировка:  перегруппировка
практический:  практической
пойти:  пойдёт
помощь:  помощью помощь
ниточка:  ниточку
вариационный:  вариационный
исключение:  исключением исключение
блог:  блог
высокий:  высших высшей высшая
параболический:  параболический параболического
формулироваться:  формулируется
пространство:  пространстве
называть:  называемой
удобный:  удобный
курс:  курс
координата:  координаты координатам координат координатах
ордината:  ординат
весь:  всеми всём весь всей
пространственный:  пространственную пространственное
знакомый:  знакомая
сообщить:  сообщите
аналитический:  аналитическая аналитической
понижение:  понижение понижением
центр:  центр
фигура:  фигура фигуры
познакомить:  познакомлю
третий:  третьем
любой:  любой
изобразить:  изобразить
построение:  построение
побочный:  побочный
вспоминать:  вспоминаем
осуществляться:  осуществляется
линейнойкорреляционный:  линейнойкорреляционной
действие:  действия
игрековый:  игрековые
оставаться:  остаётся
пора:  пор
сила:  силу силы
распределениякритерия:  распределениякритерий
отлично:  отлично
очередной:  очередная
следующий:  следующую следующей следующем
зрение:  зрения
клан:  клана
отойти:  отойти
полностью:  полностью
касательная:  касательная
ответ:  ответ ответы
задачис:  задачис
правило:  правила правило
функциия:  функциии
возможно:  возможно
степенной:  степенного степенные
функцийдвуха:  функцийдвух
выборка:  выборке
зависнуть:  зависло
функцийнесколький:  функцийнескольких
удачный:  удачный
чисто:  чисто
налево:  налево
снимать:  снимай
множественнойлинейный:  множественнойлинейной
плита:  плиты
зависимость:  зависимости зависимость
тема:  темы
распределение:  распределение распределения
оказываться:  оказывается
задавать:  задаёт задаваемые
бомба:  бомба
задачипо:  задачипо
наводящий:  наводящие
востребовать:  востребованную
приблизить:  приближенные
вариант:  вариант
реальный:  реальную
конец:  концами конце концом
примечание:  примечание
разделаться:  разделаться
зависимый:  зависимые
значительный:  значительная
отклонение:  отклонение
избавиться:  избавиться
таблица:  таблицы
произведение:  произведение
завершить:  завершена
разобраться:  разберётся
вполне:  вполне
случайный:  случайных случайные
дуга:  дуги дуга дуге
частность:  частности
численно:  численно
отрезкать:  отрезкав
дивергенция:  дивергенция
чертёж:  чертежа чертёж чертежей
сайт:  сайт сайты сайта
графика:  графики графика
пользоваться:  пользуемся
энтузиазм:  энтузиазмом
идти:  идёт
причина:  причине
возрастание:  возрастание
эмпирический:  эмпирические
найтись:  нашлось
этот:  этих эта
аналогично:  аналогично
песня:  песнями
потребоваться:  потребуется
иррациональный:  иррациональных
человеческий:  человеческий
определение:  определению определения
квадратичнуюформ:  квадратичнуюформу
карта:  карта
экстремум:  экстремумах экстремумы
гипербола:  гипербола
равно:  равно
они:  ними
логика:  логики
материал:  материалов материалы
спирмена:  спирмена
формальный:  формальной
интегрирование:  интегрированием интегрированию интегрирование интегрирования
вид:  виду виды вид виде
лишь:  лишь
комментарий:  комментариями
сдать:  сдадут
св:  св
самый:  самый самое
второй:  второго второй
иметь:  имеет иметь
сумма:  суммы сумму сумма
тематический:  тематической
масса:  массу
предыдущий:  предыдущих
пара:  пара
достаточно:  достаточно
показательный:  показательное
преобразование:  преобразования преобразований
технический:  технические
диффура:  диффурами
параллельный:  параллельная параллельна параллелен
перейти:  перейдём
весьма:  весьма
экскурсия:  экскурсии
тройной:  тройных тройные
одноимённый:  одноимённая одноимённый
использовать:  используем использовать используйте
представлять:  представляет
статистика:  статистика
вперёд:  вперёд
подставлять:  подставляем
биномиальный:  биномиальное
выводиться:  выводятся
редкий:  реже
линиюв:  линиюв
самостоятельный:  самостоятельного самостоятельных
отношение:  отношении
забывать:  забывая
участок:  участка
ждать:  жду ждать
сегодняшний:  сегодняшние
смысл:  смысл
решить:  решить
дуприближённо:  дуприближённо
информация:  информации
октант:  октантах
асимптота:  асимптоты
событие:  события
повторный:  повторные
порядок:  порядок порядка порядков
учитывать:  учитывая
состоять:  состоит состоящей
ориентировать:  ориентирован
хрен:  хрена
замена:  замену замены
фнп:  фнп
ум:  ум уме
простейшее:  простейшие
лежать:  лежащая лежит
несобство:  несобств
промежуточный:  промежуточную
нелинейный:  нелинейная
брать:  берём
применить:  применить
ликвидация:  ликвидации
параболоид:  параболоидом
преобразованиеквадратичный:  преобразованиеквадратичной
наголо:  наголо
наворотить:  наворочено
дифференциальный:  дифференциальная дифференциальные
функциональный:  функциональные
ломаный:  ломаной ломаную
статья:  статья статье
реалистичный:  реалистичную
абсолютный:  абсолютная
интересный:  интересные интереснейший
сложенияй:  сложенияи
регрессия:  регрессии регрессия
упростить:  упростить упростим
взять:  возьмите
контроль:  контроль
исчисление:  исчисления
физический:  физические физический
каноничный:  каноничный
гораздо:  гораздо
локальный:  локальная
методичка:  методичек
отрицательный:  отрицательным отрицательными
ожидание:  ожидание
лаплас:  лапласа
перегиб:  перегиба
сходимость:  сходимости сходимость
представить:  представьте представили представить
оказаться:  оказаться оказался
гиперболический:  гиперболическим
ду:  ду
делать:  делать
коэффициент:  коэффициент
неопределённый:  неопределенный неопределенном
посвятить:  посвящена
собственный:  собственные
признак:  признак признаки
полуокружность:  полуокружность
единичный:  единичной единичного
элемент:  элемент элементы элементу
рядом:  рядом
поэтому:  поэтому
разделить:  разделить
вместо:  вместо
разумеется:  разумеется
неравенство:  неравенство неравенства
малое:  малого
объяснить:  объясню
коль:  коль
асимметрия:  асимметрия
шаг:  шаге
главный:  главную
представимый:  представим
записать:  запишем
маленький:  меньше
составить:  составим
подвести:  подвести
например:  например
решенияопределённый:  решенияопределенных
подлежать:  подлежащий
выглядеть:  выглядит
назреть:  назрел
задаваться:  задаётся
спешка:  спешки
задумка:  задумка
вверху:  вверху
коэффициентковариация:  коэффициентковариации
проекция:  проекцией проекция проекциям
далёкий:  далеки
помешать:  помешает
практика:  практику
абсцисса:  абсцисс
лопиталя:  лопиталя
называться:  называется
разобрать:  разобрана разобранной
крайне:  крайне
обычно:  обычно
поляформула:  поляформула
просить:  прошу
фехнера:  фехнера
эффективный:  эффективные
условный:  условные
отлечь:  отлегло
количество:  количество
обладать:  обладают
брат:  братом
левый:  левая
даламбер:  даламбера
теорема:  теоремы
факт:  факт
целый:  целые
стандартный:  стандартный
повторнойя:  повторнойи
зеркальный:  зеркальная
комплексный:  комплексные комплексного комплексный комплексными
ранг:  ранг
тяжестиплоска:  тяжестиплоской
нечастый:  нечастый
относительно:  относительно
лента:  ленты
лениться:  ленитесь
проверка:  проверка
назвать:  назвать
построить:  построить
внимание:  внимание
логарифм:  логарифм
лейбниц:  лейбница
приём:  приёмом
пол:  полу
поток:  поток
медиана:  медиана
бывать:  бывает
доводить:  доводим
устремляться:  устремляется
направлениюй:  направлениюи
гостевой:  гостевая
скоро:  скоро
кроме:  кроме
аккуратно:  аккуратно
подстановка:  подстановку
равный:  равен равна
внутригрупповаяй:  внутригрупповаяи
зависеть:  зависит
алгебра:  алгебры
звено:  звеньям
наоборот:  наоборот
существовать:  существует существуют
намного:  намного
прямоугольник:  прямоугольников
эксцессэмпирический:  эксцессэмпирического
выбрать:  выбрать
оценка:  оценка оценки
различный:  различных
подведение:  подведением
библиотека:  библиотека
настолько:  настолько
возможность:  возможности
корень:  корень
наименьшеезначение:  наименьшеезначения
вычислимый:  вычислим
системылинейный:  системылинейных
нужно:  нужно
смело:  смело
принципиальный:  принципиальное
другой:  другие другим другую
замкнутый:  замкнутому
линейность:  линейности
благо:  благо
проходить:  проходит
показатель:  показатели
отличие:  отличие
сильно:  сильно
площадьс:  площадьс
пытливый:  пытливый
большинство:  большинстве
эль:  эль
проинтегрировать:  проинтегрировать
убыванией:  убываниеи
повышенный:  повышенной
статистический:  статистическая статистические
мел:  мел
также:  также
легко:  легко
рациональный:  рациональные
пока:  пока
нуль:  нулю
интервальный:  интервальный
итак:  итак
мера:  мере
вообще:  вообще
иксовый:  иксовым
выжать:  выжать
оценкия:  оценкии
неявный:  неявной
круговой:  круговой
несобственныхинтеграл:  несобственныхинтегралов
вероятностибиномиальный:  вероятностибиномиального
род:  рода
интегрироваться:  интегрируются
гаусс:  гаусса
искомый:  искомого
полезно:  полезно
пересекать:  пересекать пересекает
острый:  острые
точно:  точно
экстремальный:  экстремальные
нормаль:  нормали
определитель:  определитель
желать:  желающие
ступенчатый:  ступенчатой
выпуклость:  выпуклость
мой:  мои
автор:  авторы автор автора
начало:  начала началом начале
первый:  первом первого первый
половина:  половине
беспрекословно:  беспрекословно
заставить:  заставил
нитка:  нитка ниткой
принципиально:  принципиально
сложность:  сложности
зуб:  зубов
значенияй:  значенияи
справедливо:  справедливо
справедливый:  справедлива
объяснять:  объяснять
кстати:  кстати
близкий:  близкие
классическоеопределение:  классическоеопределение
инормаль:  инормаль
радиус:  радиуса
идея:  идеи
плотность:  плотности
пирамида:  пирамида
арабский:  арабского
соблюсти:  соблюсти
спрямлять:  спрямляема
отмечать:  отмечал
уравненияс:  уравненияс
онлайн:  онлайн
геометрия:  геометрии геометрия
произвольныйтройный:  произвольныйтройной
ниже:  ниже
дизайн:  дизайна
это:  это этим
прикинуть:  прикинуть
недоглядывать:  недоглядывают
максимум:  максимуму
указывать:  указываем
родственник:  родственники
опознаваться:  опознаётся
поляй:  поляи
находиться:  находится
опечатка:  опечатку
параметрически:  параметрически
обработать:  обработать
речь:  речь
технически:  технически
высечь:  высечен
стараться:  стараюсь
трудный:  труднее
непременно:  непременно
направление:  направлении направление направления направлению
методомоперационный:  методомоперационного
бесповторный:  бесповторной
наверняка:  наверняка
правильно:  правильно
ошибка:  ошибку
л:  л
обойтись:  обойтись
важно:  важно
наука:  наука
касательный:  касательных
подметить:  подметить
разбираться:  разбираемся
типовыхзадача:  типовыхзадач
взгляд:  взгляд
ранговойкорреляция:  ранговойкорреляции
рука:  руки
отдельно:  отдельно
научный:  научной
дополнительный:  дополнительный
исследовать:  исследовать
нетрудно:  нетрудно
линейныйкоэффициент:  линейныйкоэффициент
гость:  гость
несобственныйинтеграл:  несобственныйинтеграл
доступно:  доступно
удобство:  удобства
причём:  причём
учиться:  учимся
ничто:  ничем
какой:  каких
ипример:  ипримеры
вертикальный:  вертикальная
множество:  множества
требоваться:  требуется требовалось
поверхностный:  поверхностные
спрямляемость:  спрямляемость
пуассон:  пуассона
однако:  однако
несмотря:  несмотря
математическоеожидание:  математическоеожидание
школа:  школа
неоднородный:  неоднородные
возрастать:  возрастает
картинка:  картинку
кратное:  кратные
дробиться:  дробится
стоить:  стоит
системудифференциальный:  системудифференциальных
решимость:  решимости
превращаться:  превращается
положительный:  положительны
алгоритм:  алгоритм
невразумительный:  невразумительное
последовательность:  последовательностей
типовой:  типовая
квадратичный:  квадратичные
последний:  последней последних
расписать:  расписать
стремиться:  стремится
проверить:  проверить
предварительный:  предварительная
поскольку:  поскольку
бесхитростный:  бесхитростнее
гипергеометрическоераспределение:  гипергеометрическоераспределение
пояснение:  пояснения
составляться:  составляется
обратить:  обратите
приятно:  приятно
подробно:  подробно
равномерный:  равномерная равномерное
иначе:  иначе
треугольный:  треугольная
пожалуйста:  пожалуйста
вправе:  вправе
следовать:  следует
гранитный:  гранитные
вдоль:  вдоль
себя:  собой
квадрат:  квадратов
сразу:  сразу
похожий:  похожи
функциюкомплексный:  функциюкомплексной
напоминать:  напоминаю
мода:  мода
свойстваэлементарный:  свойстваэлементарных
считать:  считать
краткий:  краткое
калькулятор:  калькулятор
научиться:  научиться
прародитель:  прародителями
принцип:  принципу
оба:  оба
кошмар:  кошмары
устроить:  устроены
формально:  формально
известный:  известного
горнера:  горнера
добавочный:  добавочным
функцийв:  функцийв
видеть:  видите
довольно:  довольно
интегрировать:  интегрировать
чертить:  чертить
три:  трёх
дискретнойслучайный:  дискретнойслучайной
ветка:  ветке
задание:  задания
буквально:  буквально
удивляться:  удивляйтесь
крамер:  крамера
немедленный:  немедленной
строго:  строго
запретить:  запрещено
функциидвуха:  функциидвух
емелин:  емелин
самовар:  самоваром
задачник:  задачников
источник:  источниках
вычисленияопределенный:  вычисленияопределенных
нежели:  нежели
задачин:  задачина
замечательный:  замечательные
отдельность:  отдельности
указанный:  указанного
системый:  системыи
удовлетворяетлить:  удовлетворяетли
разный:  разной
приходиться:  приходится
сей:  сих
всякий:  всякий
тригонометрический:  тригонометрических
проводить:  проводим
прямолинейный:  прямолинейным
понимать:  понимают
заданав:  заданав
что:  чём
всё:  всё
деление:  деления
контуруформула:  контуруформула
график:  график
дело:  деле дело
вне:  вне
ваш:  вашей
просуммировать:  просуммировать
собираться:  собираются
начинка:  начинку
простота:  простоты
либо:  либо
независимый:  независимые
контур:  контуру
привести:  привести
снискать:  снискала
безразмерный:  безразмерным
нарабатывать:  нарабатываем
студент:  студенты
корреляция:  корреляции
заочник:  заочников
разбирать:  разбирал
говорить:  говоря
повторять:  повторяем
избавление:  избавлением
появиться:  появилось
