уравнение:  уравнениях уравнению уравнения уравнение уравнении уравнением уравнениями уравнений
ошибка:  ошибкой ошибка ошибку
свежий:  свежими
третий:  третьим
производный:  производные производная производной производную
счастливый:  счастливые
предел:  предел пределы пределов
слагаемое:  слагаемые
ввиду:  ввиду
интерес:  интереса
исходный:  исходного исходное исходному
числовой:  числовые
производныенеявно:  производныенеявно
общий:  общему общим общая общие общий общего общее
находить:  находить находим
игрек:  игрек
формула:  формулы формула
смотреть:  см
оптимистичный:  оптимистичными
канонический:  каноническому
два:  две
дифференциал:  дифференциалах дифференциалов дифференциалы дифференциалу дифференциалами дифференциала
больший:  наибольшее большая
называть:  называемые
многие:  многие
один:  одну одно одна одни
проводиться:  проводится
избавляться:  избавляемся избавляясь
правый:  правая правой
вогнутостья:  вогнутостьи
посему:  посему
преспокойно:  преспокойно
многий:  многих
случай:  случай случаи случая случаю случаев случае случаях
упрощать:  упрощаем упрощать
плохой:  хуже
профессия:  профессию
пусть:  пусть
удобно:  удобно
умножение:  умножения
система:  система системе систему системы
группировка:  группировок группировка
условнаясходимость:  условнаясходимость
войти:  вошли войти вошла вошло
александр:  александр
запоминать:  запоминаем
контрольный:  контрольной
который:  которые которая которое которую которого которых
редко:  редко
линейный:  линейные линейная линейных линейными линейной
коэффициент:  коэффициентов коэффициент
гарантировать:  гарантировано
равенство:  равенство
запись:  записи
согласие:  согласия
дуоперационный:  дуоперационным
сформулировать:  сформулировать
базис:  базисах базису базис
убирать:  убираю
зависимостьвектор:  зависимостьвекторов
снова:  снова
оно:  оно
сначала:  сначала
метод:  методы методом метод
тема:  теме темы
страница:  страницу
наличие:  наличия
вспоминать:  вспоминают вспоминаем
математический:  математическая математические математической
данные:  данных
квест:  квест
ось:  оси
прямой:  прямых прямая прямой прямую
страничка:  страничку
интеграл:  интеграл интегралов интегралах интегралы интеграла интегралом интеграле
урок:  урока уроках урок уроке
разложение:  разложением разложение
этаж:  этаж
деление:  делении деление деления
специальный:  специальная
сон:  сон
икс:  икс иксы иксом икса
мочь:  можете могут
переход:  переход
указывать:  указывать
советовать:  советую
заметка:  заметку
проторить:  проторенной
желательно:  желательно
очередь:  очередь
ветка:  ветку веток ветки
практический:  практических
целесообразно:  целесообразно
малый:  малые наименьших
связь:  связь
лямбда:  лямбда лямбды лямбду
удобный:  удобные удобный удобнее
нормальный:  нормальное
интегральнаятеорема:  интегральнаятеоремы
некоторый:  некоторой некоторыми некоторых
корнимногочлен:  корнимногочлена
логарифмический:  логарифмическая
дробь:  дробью дроби дробей
основной:  основные
корн:  корне
бернулли:  бернулли
нужный:  нужен нужной нужную
полярный:  полярные полярных полярной
рассмотреть:  рассмотрим рассмотренном рассмотренную
ряд:  ряды ряда ряд рядов
уровень:  уровня
доверительный:  доверительные
среднееквадратический:  среднееквадратическое
коротко:  коротко
логарифм:  логарифмы логарифмом логарифм логарифму логарифма
решение:  решениями решение решении решением решения решений
комбинационный:  комбинационная
обращаться:  обращается
оба:  обе оба
смешанноепроизведение:  смешанноепроизведение
понт:  понты
функция:  функции функция функций функцию
вместе:  вместе
дисперсия:  дисперсия дисперсии дисперсию
проверка:  проверки проверке проверку проверка
заталкивать:  заталкиваем
школьный:  школьный школьных
мы:  нам
появляться:  появляются
разделить:  разделены разделим разделить
образ:  образом
распространить:  распространенный
непрерывнаяслучайный:  непрерывнаяслучайная
другой:  других другими другое другие
ибо:  ибо
прямо:  прямо
длина:  длина
хороший:  хорошая хорошем
работа:  работе работа
процесс:  процессе
знакопостоянство:  знакопостоянства
проводить:  проводить проводят проводим
простенький:  простенькая
попробовать:  попробуйте попробовать
градиент:  градиент
актуальность:  актуальность
линия:  линия линии линиями
внимание:  внимания внимание
тонкость:  тонкости
комбинаторика:  комбинаторике
попадать:  попадают
случайнаявеличина:  случайнаявеличина
свой:  своего свои
бесконечно:  бесконечно
учесть:  учли
форма:  формы
прийтись:  пришлось
статья:  статьи статье статью
задача:  задаче задачи задача
обратный:  обратную обратная обратной
приём:  приемы
готовый:  готовых готовые готовыми
конкретный:  конкретном
просто:  просто
ещё:  ещё
знак:  знаками знаком знак знаки
быть:  буду будут будем
проверять:  проверять проверяйте проверяем
частый:  чаще
единый:  единым единый
очевидный:  очевидна очевидно очевиден
данный:  данного данном данное
непрерывный:  непрерывных непрерывная
производныефункция:  производныефункции
средний:  средняя
заслать:  зашли
область:  области область
целый:  целый
число:  числами числа
математик:  математика
переменный:  переменных переменной переменные переменными
пример:  пример примеров примере примерах примеры
упрощение:  упрощения упрощениях упрощений
несовместный:  несовместные
независимыеслучайный:  независимыеслучайные
страшненький:  страшненькие
отловить:  отловили
пытаться:  пытаются
минус:  минус минусы
модель:  модель модели
непрерывность:  непрерывность
тэ:  тэ
семейство:  семейство
окова:  оковы
содержать:  содержит
небольшой:  небольшое
функциис:  функциис
полный:  полной полных полный полное полного
зеркало:  зеркало
значит:  значит
пирсон:  пирсона
вопрос:  вопрос вопросы
приписать:  приписать
межгрупповой:  межгрупповая
ортогональный:  ортогональное
заменить:  заменить
высокий:  высокой высших высшей высшая
нсв:  нсв
стиль:  стиле
внесение:  внесение
проанализировать:  проанализировать проанализируем
упасть:  упал
ход:  ходе
писать:  пишут
отрезка:  отрезке
трудно:  трудно
кривовато:  кривовато
нулевой:  нулевому нулевом
величина:  величина величин величины
важный:  важный
беспокойство:  беспокойства
требовать:  требуемое
шанс:  шансы шанс
интегрировать:  интегрируем
подынтегральный:  подынтегральную
умножать:  умножаем умножая
детерминация:  детерминации
сторона:  стороны
обязательно:  обязательно
потерять:  потеряли потерять потеряем
следующий:  следующие следующую следующий
тот:  тех тому те
начать:  начать
выполнить:  выполнить выполнил
решаться:  решается
дифференциальныеуравнение:  дифференциальныеуравнения
постоянный:  постоянных
стокс:  стокса
схема:  схема
однородный:  однородно однородными однородные однородным однородного однородное однородном однородных
самостоятельно:  самостоятельно
рука:  рук
сплошной:  сплошное
дифференцирование:  дифференцирования дифференцированием
удостаиваться:  удостаивается
дробовик:  дробовик
прописать:  прописать
математика:  математике математики
векторный:  векторное векторного
сам:  самом
коварный:  коварный
новость:  новость
множитель:  множителя множитель множители
вероятностия:  вероятностии
скалярный:  скалярное
задание:  заданиях
наш:  нашем наш нашего
понятный:  понятен
значимость:  значимости
записать:  записал записать
неоднородный:  неоднородными неоднородные
мысленно:  мысленно
такой:  такую таким такие такое такого такая такому таких такими
верный:  верное
анализ:  анализа анализ
её:  её
частный:  частное частные частный
парный:  парной
успешный:  успешного
заявить:  заявлена
найти:  найдём найден найти найдено
сборник:  сборники
верно:  верно
параметрический:  параметрическом параметрической
след:  следам
запрашиваться:  запрашивается
часто:  часто
надобность:  надобность
стена:  стена
получаться:  получается получаются получаться
какой:  какие
продвижение:  продвижения
форум:  форум форуме
записывать:  записывать записывают записываем
книга:  книги книга
прорешать:  прорешанные
провести:  провести проведём проведем проведенных
разряд:  разряда
подлежать:  подлежит
разложить:  разложим
устно:  устно
вектор:  векторы векторов
вращение:  вращения
наряду:  наряду
именно:  именно
принять:  принято
копирование:  копирование
привыкать:  привыкать
разрыв:  разрыва
выражение:  выражения выражение
роль:  роль
прийти:  придете
отблагодарить:  отблагодарить
являться:  являются является
байес:  байеса
простой:  проще проста простейших простой простые
решать:  решать
триллер:  триллер
результат:  результат результате
теория:  теория теории
проверить:  проверьте проверим проверить
дополнительно:  дополнительно
собрать:  собрать
повыносить:  повыносить
двумерный:  двумерная
задать:  заданной задано задайте
тело:  тела
циркуляция:  циркуляция
неявно:  неявно
слева:  слева
плоскость:  плоскости плоскость
уничтожить:  уничтожить
получиться:  получится получившийся получилась
оставить:  оставить
определителяй:  определителяи
выносить:  выносим
трёхчлен:  трёхчленом трёхчлен
повод:  повода
согласно:  согласно
закон:  законы
справа:  справа
качество:  качестве
корень:  корня корнем корнями корень
последний:  последнем
действие:  действий действия
буква:  буква буквами
условие:  условием условию
вероятность:  вероятностей вероятность вероятности вероятностью
заключение:  заключение
уравненийв:  уравненийв
разделяться:  разделяются разделяющимися
грин:  грина
эйлер:  эйлера
великий:  великая
вводный:  вводный вводного
навешивать:  навешиваем
невозможно:  невозможно
дискретный:  дискретный
знакочередоваться:  знакочередующиеся
отпадать:  отпадает
терять:  теряете теряем теряют
практически:  практически
произвольный:  произвольных
потерянный:  потерянном
сложный:  сложной сложные сложных
работать:  работает
фурье:  фурье
поле:  поля поле
гипотеза:  гипотез гипотеза гипотезы
свойство:  свойства
единственный:  единственна
момент:  момент
исследование:  исследование
начинаться:  начинается
дифференциальный:  дифференциального дифференциальных дифференциальные дифференциальное
точка:  точки точке
первый:  первую первому первая первом первого
вариация:  вариации
основа:  основы
интервал:  интервалы
кош:  коши
чайник:  чайников
вычисленияс:  вычисленияс
опасный:  опасные опасное опасная
модуль:  модуля модуль
матричный:  матричные матричных матричный
выделить:  выделю
столкнуться:  столкнулись
заметить:  заметили заметить
навык:  навыки
ответ:  ответе ответ ответу ответы
вычислить:  вычислить
очень:  очень
гордиться:  гордятся
матрица:  матрицу матрицы матрицами
испытанияй:  испытанияи
интегралыть:  интегралыв
квадратный:  квадратным квадратный
перегруппировка:  перегруппировка
исчезнуть:  исчезли
помощь:  помощью
понять:  поняли
вариационный:  вариационный
элементарный:  элементарных
сокращение:  сокращение
идти:  шло идём
получить:  получим получено получить получите получена полученный полученному получили получи
стандартно:  стандартно
блог:  блог
типовой:  типовых
произведение:  произведения произведением произведение
пространство:  пространстве
курс:  курс
координата:  координаты координат координатах
попасться:  попадутся
сообщить:  сообщите
аналитический:  аналитическая аналитической
понижение:  понижение понижением
знать:  знаю
разделение:  разделении разделения
левый:  левой левую
центр:  центр
принцип:  принципы
видеть:  видеть
сбросить:  сбросили
помнить:  помнят
любой:  любой любого
квадрат:  квадрата квадрат квадратов
преобразование:  преобразованиях преобразования преобразование преобразований
самый:  самую самые самое
возникать:  возникают возникает
построение:  построение
выбрать:  выберу выбрать
линейнойкорреляционный:  линейнойкорреляционной
чёрный:  чёрными
время:  время
закрепить:  закрепить
утренний:  утренний
почему:  почему
распределениякритерия:  распределениякритерий
экзаменационный:  экзаменационный
несобственный:  несобственные
фатальный:  фатальной
зрение:  зрения
вариант:  варианты варианта
проинтегрировать:  проинтегрировано
касательная:  касательная
задачис:  задачис
правило:  правила правило
замена:  заменой замену замене замены замена
рубеж:  рубеже
функциия:  функциии
возможно:  возможно
степенной:  степенного степенные
функцийдвуха:  функцийдвух
выборка:  выборке
обещать:  обещанный
неразложимый:  неразложим
рисковать:  рисковали рискуем
функцийнесколький:  функцийнескольких
пролететь:  пролетело
убеждаться:  убеждаемся
положительно:  положительно
множественнойлинейный:  множественнойлинейной
распределение:  распределение распределения
забывать:  забываем
интересный:  интересное интересный
задачипо:  задачипо
делитель:  делитель
востребовать:  востребованную
приблизить:  приближенные
похожий:  похожие
изучить:  изучить
неравносильный:  неравносильных неравносильного
примечание:  примечание
зависимый:  зависимые
отклонение:  отклонение
избавиться:  избавиться
следовать:  следовало следует
таблица:  таблицы
случайный:  случайных случайные
неприятный:  неприятны
зависеть:  зависящей зависящая
дуга:  дуги
отрезкать:  отрезкав
играть:  играет
дивергенция:  дивергенция
возникнуть:  возник
сайт:  сайт сайты сайта
графика:  графики графика
оформление:  оформления
причина:  причине причина
возрастание:  возрастание
эмпирический:  эмпирические
подставить:  подставим
ошибочный:  ошибочному
найтись:  нашлось
указать:  указать
иррациональный:  иррациональных
разделяемость:  разделяемость
устроить:  устроил
определение:  определению определения
квадратичнуюформ:  квадратичнуюформу
карта:  карта
маленький:  маленький
близкий:  ближайших
гипербола:  гипербола
несложный:  несложная
равно:  равно
они:  ними
показатель:  показателе показатели
подстановка:  подстановки подстановку
логика:  логики
фраза:  фразы
материал:  материалов материалы
спирмена:  спирмена
аналогичный:  аналогичная
вид:  виду виды виде
специально:  специально
оказаться:  оказалось оказаться оказался
заключительный:  заключительный
известный:  известная
св:  св
второй:  второго второй вторую вторая
прокатывать:  прокатывает
собирать:  собираем
достаточно:  достаточно
показательный:  показательное
бывать:  бывают бывает
сброс:  сброс
соответствовать:  соответствует
технический:  технические технической техническому
раскладываться:  раскладывается
диффура:  диффурами диффура диффур диффуру диффурах
этот:  эта
весьма:  весьма
вычисление:  вычисление
использовать:  используем используемые используя использовать используйте
статистика:  статистика
китайский:  китайская
замучить:  замучить
подставлять:  подставляем
выделение:  выделения
биномиальный:  биномиальное
линиюв:  линиюв
история:  история
самостоятельный:  самостоятельного
успеть:  успею
отношение:  отношении
продифференцировать:  продифференцировать
громоздкий:  громоздким
касса:  кассы
дифференцировать:  дифференцируем
решить:  решить
дуприближённо:  дуприближённо
асимптота:  асимптоты
привычный:  привычен
событие:  события
повторный:  повторные
неопределённый:  неопределенных неопределенный неопределенном
совершить:  совершили
состоять:  состоит
константа:  константы константу
всякий:  всякого
фнп:  фнп
выделять:  выделяем
простейшее:  простейшие
конец:  конце
часть:  частям часть части
двойной:  двойные двойной
компактный:  компактнее
несобство:  несобств
нелинейный:  нелинейная
брать:  берём
преобразованиеквадратичный:  преобразованиеквадратичной
функциональный:  функциональные
чудо:  чудо
глаз:  глаз
геометрический:  геометрическая геометрическое
абсолютный:  абсолютная
сложенияй:  сложенияи
раскрывать:  раскрываем
регрессия:  регрессии регрессия
упростить:  упростить
ориентироваться:  ориентируетесь
контроль:  контроль
сокращаться:  сокращаются
исчисление:  исчисления
чистовик:  чистовике
гораздо:  гораздо
локальный:  локальная
настоятельно:  настоятельно
сказать:  сказать
ожидание:  ожидание
согласиться:  согласитесь
прилично:  прилично
лаплас:  лапласа
перегиб:  перегиба
сходимость:  сходимости сходимость
несоблюдение:  несоблюдение
начальный:  начальным
ду:  ду
цепь:  цепи
далее:  далее
собственный:  собственные
признак:  признак признаки
пронести:  пронесло
поэтому:  поэтому
практика:  практике
вместо:  вместо
разумеется:  разумеется
проработать:  проработать
асимметрия:  асимметрия
шаг:  шаге
рабочий:  рабочего
главный:  главную
сводиться:  сводящиеся
например:  например
решенияопределённый:  решенияопределенных
хотя:  хотя
однородность:  однородность
коэффициентковариация:  коэффициентковариации
накатать:  накатанной
перечисленный:  перечисленные
отрывать:  отрывать
приводить:  приводить
абсолютно:  абсолютно
долго:  долго
лопиталя:  лопиталя
собрат:  собрату
удовольствие:  удовольствие
крайне:  крайне
обычно:  обычно
мимо:  мимо
поляформула:  поляформула
фехнера:  фехнера
эффективный:  эффективные
условный:  условные условный
эллипс:  эллипс
ноль:  ноль
переобозначить:  переобозначу
параллельный:  параллельных
потеряшка:  потеряшках
даламбер:  даламбера
теорема:  теоремы
факт:  факт
повторнойя:  повторнойи
комплексный:  комплексные комплексного комплексный комплексными
нижний:  нижний
скобка:  скобки
ранг:  ранг
кривая:  кривой
тяжестиплоска:  тяжестиплоской
построить:  построить
хотеть:  хочу
разобраться:  разберёмся
лейбниц:  лейбница
неравенство:  неравенства
искомый:  искомый
табличный:  табличному
поток:  поток
медиана:  медиана
туман:  туман
направлениюй:  направлениюи
гостевой:  гостевая
скоро:  скоро
кроме:  кроме
тип:  типов тип
равный:  равен
привести:  приведём привести
понятно:  понятно
вывод:  вывод
внутригрупповаяй:  внутригрупповаяи
он:  нём
пара:  пару
алгебра:  алгебры
сумма:  сумму сумма
существовать:  существует существуют
новинка:  новинка
прямоугольник:  прямоугольников
прокатить:  прокатить
эксцессэмпирический:  эксцессэмпирического
оценка:  оценка оценки
дать:  даст дано данной
криволинейный:  криволинейные
различный:  различных
смочь:  сможете
библиотека:  библиотека
трудный:  трудных
наименьшеезначение:  наименьшеезначения
сила:  силы
стандартный:  стандартна стандартной
выяснять:  выясняем
штрих:  штрих
системылинейный:  системылинейных
нужно:  нужно
обозначение:  обозначению
смело:  смело
нечего:  нечего
зависимость:  зависимость
возвращать:  возвращает
замкнутый:  замкнутому
возможный:  возможны
проконтролировать:  проконтролируйте
отличие:  отличие
площадьс:  площадьс
большинство:  большинстве
мигрировать:  мигрируют
убыванией:  убываниеи
повышенный:  повышенной
статистический:  статистическая статистические
интегрирование:  интегрирование интегрирования
легко:  легко
рациональный:  рациональные
стоп:  стоп
ситуация:  ситуация
читать:  читайте
интервальный:  интервальный
речь:  речи
упустить:  упустить
ан:  ан
диффуров:  диффуров
соответственно:  соответственно
итак:  итак
мера:  мере
сбрасывать:  сбрасываем
оценкия:  оценкии
неявный:  неявной
несобственныхинтеграл:  несобственныхинтегралов
вероятностибиномиальный:  вероятностибиномиального
род:  рода
сокращать:  сокращая
гаусс:  гаусса
трогать:  трогаем
выразить:  выразить
точно:  точно
экстремальный:  экстремальные
умножить:  умножим
упаковывать:  упаковываем
нормаль:  нормали
определитель:  определитель
желать:  желающие
алгоритм:  алгоритме алгоритм
выпуклость:  выпуклость
элемент:  элементы
знаменатель:  знаменатель знаменателю знаменателе
вынесение:  вынесение
сложность:  сложность сложности
менее:  менее
разделять:  разделяем
значенияй:  значенияи
справедливо:  справедливо
кстати:  кстати
классическоеопределение:  классическоеопределение
инормаль:  инормаль
далёкий:  дальше
сохранять:  сохраняем
корявый:  корявым
лёгкий:  лёгкого легче
пирамида:  пирамида
поперекидывать:  поперекидывать
автор:  автор автора
делимый:  делим
безопасный:  безопасен
опасность:  опасность
разница:  разница
уравненияс:  уравненияс
нарисоваться:  нарисовались
онлайн:  онлайн
геометрия:  геометрии геометрия
новый:  новому
произвольныйтройный:  произвольныйтройной
ниже:  ниже
дизайн:  дизайна
это:  это этим
исключение:  исключение
поляй:  поляи
находиться:  находится
опечатка:  опечатку
выгодный:  выгоднее
продолжать:  продолжаем
параметр:  параметр
повезти:  повезло
комментарий:  комментарий
поджидать:  поджидает
методомоперационный:  методомоперационного
бесповторный:  бесповторной
правильно:  правильно
л:  л
степень:  степени
контролировать:  контролируем
внизу:  внизу
слово:  слову
касательный:  касательных
типовыхзадача:  типовыхзадач
ранговойкорреляция:  ранговойкорреляции
вовремя:  вовремя
необходимый:  необходима
исследовать:  исследовать
порядок:  порядке порядка порядков
поверхность:  поверхности
линейныйкоэффициент:  линейныйкоэффициент
несобственныйинтеграл:  несобственныйинтеграл
совет:  совету
доступно:  доступно
учиться:  учимся
поначалу:  поначалу
задавать:  задаваемые
ипример:  ипримеры
множество:  множества
требоваться:  требуется требовалось
поверхностный:  поверхностные
приличный:  приличная
колея:  колее
фигура:  фигуры
пуассон:  пуассона
однако:  однако
математическоеожидание:  математическоеожидание
школа:  школа
необходимо:  необходимо
оформить:  оформить
длинный:  длинному
кратное:  кратные
системудифференциальный:  системудифференциальных
изначально:  изначально
максимальный:  максимальные
классический:  классическом
последовательность:  последовательностей
квадратичный:  квадратичные
дорога:  дорогой
объём:  объем
превратиться:  превратится
поскольку:  поскольку
гипергеометрическоераспределение:  гипергеометрическоераспределение
закончиться:  закончиться
удаться:  удастся
равномерный:  равномерная равномерное
треугольный:  треугольная
жирный:  жирными
редкий:  редких
освоиться:  освоились
пожалуйста:  пожалуйста
принимать:  принимать
пристальный:  пристального
штриховой:  штриховому
сразу:  сразу
функциюкомплексный:  функциюкомплексной
даваться:  даётся
напоминать:  напоминаю
мода:  мода
свойстваэлементарный:  свойстваэлементарных
значение:  значении
калькулятор:  калькулятор
научиться:  научиться
поисковик:  поисковика
удовлетворять:  удовлетворяет
реально:  реально
мой:  моему
раскрытие:  раскрытия
определённый:  определенный определенного
экстремум:  экстремумы
горнера:  горнера
упомянуть:  упомянутый
функцийв:  функцийв
довольно:  довольно
техника:  техника
отдельный:  отдельной
три:  трёх
дискретнойслучайный:  дискретнойслучайной
горячий:  горячим
каждый:  каждую
модифицированный:  модифицированной
крамер:  крамера
начало:  начале
правда:  правда
парабола:  парабола
строго:  строго
выполнять:  выполняем
запретить:  запрещено
функциидвуха:  функциидвух
черновик:  черновике
емелин:  емелин
оформлять:  оформлять
времяпровождение:  времяпровождение
вычисленияопределенный:  вычисленияопределенных
пояснить:  пояснить
задачин:  задачина
замечательный:  замечательные
системый:  системыи
удовлетворяетлить:  удовлетворяетли
потеря:  потеря
явный:  явном
любовь:  любовь
перейти:  перейти
беспокоиться:  беспокоиться
тригонометрический:  тригонометрических
казаться:  казалось
встречаться:  встречается
заданав:  заданав
уверенно:  уверенно
что:  чём
всё:  всё
тройной:  тройные
сойти:  сошла
контуруформула:  контуруформула
график:  график
дело:  деле дело
маньяк:  маньяку
либо:  либо
рекомендовать:  рекомендую
сигнум:  сигнум
независимый:  независимые
пользоваться:  пользуйтесь
обойтись:  обошлось
способ:  способ
корреляция:  корреляции
заочник:  заочников
максимально:  максимально
говорить:  говоря
повторять:  повторяем
