вектор:  векторы векторами векторов
получить:  получить получите получены получи
раздел:  разделе разделу разделов раздел
посетитель:  посетителей
цель:  целях
школьный:  школьного школьный
специальный:  специальные
экономить:  экономит
применяться:  применяются
вращение:  вращения
дифференциальный:  дифференциальные дифференциального дифференциальном дифференциальных
первый:  первый первого
уравненияс:  уравненияс
усваиваться:  усваивается
именно:  именно
онлайн:  онлайн
геометрия:  геометрии геометрия
сохранять:  сохранять
использоваться:  используется используются
полезный:  полезен полезными полезная
копирование:  копирование
замечательный:  замечательных замечательные
справка:  справка справке
решить:  решить
читать:  читать
этап:  этапы этапах
разрыв:  разрыва
работа:  работа работе
выражение:  выражения
сумма:  сумма сумму
нуль:  нуля
производный:  производные производная производной производную
прямой:  прямой прямое прямую прямая
дуприближённо:  дуприближённо
новый:  новому
предел:  предел предела пределы пределов
симпсон:  симпсона
произвольныйтройный:  произвольныйтройной
модель:  модели модель
вычислительный:  вычислительные вычислительных
информация:  информации информацией информация информацию
асимптота:  асимптоты
роль:  роль
дизайн:  дизайна
позволять:  позволяющие позволяет позволяющими
это:  это этим
пополняться:  пополняется
событие:  события
программка:  программка
отблагодарить:  отблагодарить
повторный:  повторные
байес:  байеса
числовой:  числовые
экселе:  экселе
дисперсия:  дисперсию дисперсия дисперсии
файл:  файлы файл файле
решать:  решать
производныенеявно:  производныенеявно
значение:  значение значения значений значениях
решение:  решений решении решением решения решение
поляй:  поляи
интеграл:  интегралы интеграла интеграл интеграле интегралов
опечатка:  опечатку
указать:  указано
минута:  минуты
эквивалентность:  эквивалентностях
результат:  результат результаты
теория:  теория теории
математический:  математические математических математическая математическим математической математическому
параметрически:  параметрически
способ:  способом
претендовать:  претендую претендует
данный:  данную данном данный
тервера:  тервера
основательный:  основательную
речь:  речь
формула:  формулы формулам формул формула формуле
задание:  заданий задания заданием
приблизить:  приближенных приближенное приближенные
чертёжь:  чертёжи
фнп:  фнп
трудный:  труднее
канонический:  каноническому
охватывать:  охватывает
простейшее:  простейшие
два:  две
гипотеза:  гипотезы гипотез гипотеза
отрезок:  отрезках
дифференциал:  дифференциалах дифференциала
двумерный:  двумерная
больший:  наибольшее
который:  которых которые который которая которыми
методомоперационный:  методомоперационного
задать:  заданной задайте заданных
нередко:  нередко
язык:  языком
часть:  частям часть части частью
систематизировать:  систематизирует систематизирована
заглядывать:  заглядываем
тело:  тела
циркуляция:  циркуляция
бесповторный:  бесповторной
экзаменатор:  экзаменатора
расчёт:  расчёты расчетов расчёт расчёте
обратный:  обратной обратных обратная обратную обратное
двойной:  двойные двойной
ошибка:  ошибку ошибок
плоскость:  плоскости плоскость
следующий:  следующих следующие
несобство:  несобств
качественный:  качественнее качественные
перевести:  перевести
л:  л
известный:  известны
общий:  общим общая
нелинейный:  нелинейная
искать:  ищете
какой:  каком какие
помочь:  поможет помогут
изучение:  изучение изучении
неоднократно:  неоднократно
преобразованиеквадратичный:  преобразованиеквадратичной
матрица:  матриц матрицу матрицы матрицами
определителяй:  определителяи
степень:  степени степеней
вещь:  вещь
вогнутостья:  вогнутостьи
график:  графиков график
вид:  виде виды виду
методичка:  методичка
закон:  законы
дробь:  дроби дробей дробь
особенность:  особенность
функциональный:  функциональные
комментарий:  комментарии комментариях комментариями
востребовать:  востребованные востребованную
случай:  случай случаев случаи случае
касательный:  касательных
освоить:  освоить
плохой:  хуже
солидный:  солидному
профессия:  профессию
замечание:  замечаний
действие:  действий действия действиях
срок:  сроки
улучшаться:  улучшалось
геометрический:  геометрическая геометрическое
абсолютный:  абсолютная
графика:  графика графики
типовыхзадача:  типовыхзадач
краткий:  краткая краткими
уважение:  уважением
удобно:  удобно
один:  одной одном
умножение:  умножения
готовый:  готовый готовых
вероятность:  вероятностей вероятностью вероятность вероятности
встречаться:  встречаются встречается
ранговойкорреляция:  ранговойкорреляции
система:  система систему системе системы
частный:  частные частное
функция:  функций функции функция
создать:  созданы
непрерывный:  непрерывная непрерывных
группировка:  группировок группировка
собрать:  собрал
условнаясходимость:  условнаясходимость
сложенияй:  сложенияи
исследование:  исследования исследование
уравненийв:  уравненийв
подбор:  подбора подборе подбор
самый:  самые самое
фигурировать:  фигурирует
регрессия:  регрессии регрессия
величина:  величин величина величины
практический:  практического практических
александр:  александр
разложение:  разложений разложением разложение разложения
лист:  листа
потребоваться:  потребоваться
наизусть:  наизусть
количество:  количества
корень:  корни
грин:  грина
полный:  полное полных полного полная полной
исчисление:  исчисления исчислении
линейный:  линейные линейная линейных линейной
чайник:  чайнику чайников
неоднородный:  неоднородного неоднородное неоднородные неоднородных
эйлер:  эйлера
правый:  правой
любой:  любые
автоматический:  автоматическом автоматических
сочетание:  сочетания сочетаний
быть:  суть
согласие:  согласия
локальный:  локальная
размещение:  размещения размещений
привести:  приведено приведены привести
ожидание:  ожидание
математика:  математики математике
лаплас:  лапласа
перегиб:  перегиба
содержательный:  содержательные
дополнить:  дополнен
сходимость:  сходимости сходимость
дуоперационный:  дуоперационным
исследовать:  исследовать
справочник:  справочники справочникам справочнику справочнике
поехать:  поехали
дискретный:  дискретный дискретных
базис:  базисах базис базису
комплекс:  комплекс
поверхность:  поверхности
знакочередоваться:  знакочередующиеся
задача:  задачи задач задачах
вычисление:  вычислений вычисление
тот:  те та
векторный:  векторного векторное
страница:  странице страницу страницы
ду:  ду
наиболее:  наиболее
смешанный:  смешанную
видеоролик:  видеоролик
зависимостьвектор:  зависимостьвекторов
шаг:  шагу
линейныйкоэффициент:  линейныйкоэффициент
справочный:  справочные справочное справочном справочный
память:  памяти
нахождение:  нахождении нахождения
распространить:  распространенных распространённых распространенные
коэффициент:  коэффициент коэффициентами
неопределённый:  неопределенный неопределенном
дробный:  дробной
значительный:  значительную
метод:  методы методом метод
пример:  примерами примеры пример
собственный:  собственные
тема:  теме темах
ваш:  ваш ваших вашей
практически:  практически
несобственныйинтеграл:  несобственныйинтеграл
признак:  признак признаки
произвольный:  произвольных
данные:  данных
сложный:  сложной сложных сложные
доступно:  доступно
комбинаторика:  комбинаторики комбинаторике
подготовить:  подготовленному
фурье:  фурье
учиться:  учимся
поле:  поля
урок:  урока уроку
задавать:  задаваемые
практика:  практике практика
свойство:  свойства свойств
степенной:  степенных степенной степенного степенные
момент:  момент
угол:  углов
перестановка:  перестановок перестановки
биномиальный:  биномиального биномиальное
обучение:  обучения
горячий:  горячие
весь:  всем
помогать:  помогает
ипример:  ипримеры
уравнение:  уравнению уравнений уравнения уравнение
точка:  точки точке
рассмотреть:  рассмотрены
множество:  множества множеством
найти:  найти найдете
оценка:  оценки оценка
мочь:  можете могут
переход:  переход
вариация:  вариации
проблема:  проблем
асимметрия:  асимметрия
обыкновенный:  обыкновенных обыкновенные
комплексный:  комплексными комплексные комплексного комплексный
основа:  основы
поверхностный:  поверхностные
интервал:  интервалы
книга:  книга книге книги
писать:  пишите
дать:  данные данной данная
широкий:  широких
главный:  главную
кош:  коши
основной:  основной основные
желательно:  желательно
координата:  координат координаты координатах
фигура:  фигуры
пуассон:  пуассона
типовой:  типовые
сводиться:  сводящиеся
упустить:  упущено
дополнительный:  дополнительными
материал:  материале материал материалы материалами материалов материалам
представить:  представлена представлены
преобразование:  преобразований преобразование преобразования
замена:  замены
ссылка:  ссылками
вычисленияс:  вычисленияс
однако:  однако
ценный:  ценным
радиан:  радианов радианы
реализовать:  реализована реализован
малый:  малые наименьших
связь:  связь
понижение:  понижением понижение
показывать:  показывает
матричный:  матричные матричных матричный
сотня:  сотни
заметить:  заметили
арка:  арки
ответ:  ответе
математическоеожидание:  математическоеожидание
однородный:  однородные однородным
решенияопределённый:  решенияопределенных
например:  например
операционный:  операционным
вычислить:  вычислить вычислите
нормальный:  нормальное
школа:  школа
очень:  очень
интегральнаятеорема:  интегральнаятеоремы
корнимногочлен:  корнимногочлена
логарифмический:  логарифмическая
курс:  курса курс курсу
испытанияй:  испытанияи
интегралыть:  интегралыв
универсальный:  универсальный универсальные
перегруппировка:  перегруппировка
каждый:  каждое каждом каждой
правило:  правило правила
монитор:  монитора
тангенс:  тангенса
нужный:  нужные нужной
логарифм:  логарифма логарифмы логарифмов
помощь:  помощью
бернулли:  бернулли
стать:  стала
найтись:  найдется нашлось
комбинация:  комбинаций
полярный:  полярные полярной полярных
коэффициентковариация:  коэффициентковариации
котангенс:  котангенса
ряд:  ряд ряды ряда рядов
оформить:  оформить
вариационный:  вариационный
уровень:  уровня
некорректный:  некорректного
элементарный:  элементарных
второй:  второй второго
постоянный:  постоянными постоянных
вопрос:  вопросы вопрос
обратиться:  обратиться
разбиение:  разбиения
кратное:  кратные
треугольник:  треугольнике
снабдить:  снабжена снабжены
методический:  методический
системудифференциальный:  системудифференциальных
значительно:  значительно
веб:  веб
видеоурок:  видеоурок
блог:  блог
доверительный:  доверительные
пункт:  пунктов
простой:  простейших простейший простым
высокий:  высших высшей высшая
делить:  делить
форма:  форме формы
неточность:  неточности
помнить:  помнить
развитие:  развития
руководство:  руководство
среднееквадратический:  среднееквадратическое
рекомендация:  рекомендации
линия:  линий линиями линии линия
пространство:  пространстве
графопостроитель:  графопостроителями
алгоритм:  алгоритм алгоритмы
лопиталя:  лопиталя
последовательность:  последовательностей
удобный:  удобный удобна
комбинационный:  комбинационная
воедино:  воедино
крайне:  крайне
минор:  миноры
квадратичный:  квадратичные
такой:  такое таких
смешанноепроизведение:  смешанноепроизведение
ходовой:  ходовые
объём:  объем
сократить:  сокращенного
проверить:  проверить
поляформула:  поляформула
оба:  обеим
макет:  макет
сообщить:  сообщите
редактироваться:  редактировалось
фехнера:  фехнера
аналитический:  аналитическая аналитической
пожелание:  пожеланий
эффективный:  эффективные
независимо:  независимо
центр:  центр
обзор:  обзор
гипергеометрическоераспределение:  гипергеометрическоераспределение
видеть:  видеть
эффективность:  эффективности
сайт:  сайте сайта сайты сайт
целый:  целой
условный:  условные
непрерывнаяслучайный:  непрерывнаяслучайная
разъяснить:  разъяснено
прикладной:  прикладных
другой:  других другие
эллипс:  эллипс
сложение:  сложения
прямо:  прямо
складывать:  складывать
позволить:  позволит
длина:  длина
возможность:  возможность возможности
посмотреть:  посмотреть
немного:  немного
переписывать:  переписывать
знакопостоянство:  знакопостоянства
производная:  производных
равномерный:  равномерная равномерное
экспонент:  экспоненты
правильный:  правильный
треугольный:  треугольная треугольной
повторение:  повторений повторениями повторения
градиент:  градиент
определение:  определения определению
смысл:  смысла
необходимость:  необходимость
вычитать:  вычитать
использовать:  используйте использовать
пожалуйста:  пожалуйста
даламбер:  даламбера
теорема:  теоремы
бесплатно:  бесплатно
просьба:  просьбам
число:  числе числами числа
случайнаявеличина:  случайнаявеличина
повторнойя:  повторнойи
построение:  построение
следовать:  следует
бесконечно:  бесконечно
скорость:  скорости
определитель:  определителя определители определитель
линейнойкорреляционный:  линейнойкорреляционной
всеобъемлющий:  всеобъемлющую
законспектировать:  законспектирована
распечатать:  распечатать
себя:  собой
программа:  программа программы программами
расчётный:  расчётный расчётные
программный:  программный
квадрат:  квадратов квадрат
ранг:  ранг
мгновенно:  мгновенно
требоваться:  требуются
кривая:  кривой
экран:  экране
тяжестиплоска:  тяжестиплоской
знание:  знания
приведение:  приведения
обычный:  обычный
ньютон:  ньютона
сразу:  сразу
распределениякритерия:  распределениякритерий
функциюкомплексный:  функциюкомплексной
область:  область области
проверка:  проверка
важный:  важными важное важнейшие
аргумент:  аргумента
принтер:  принтере
построить:  построить
несобственный:  несобственные
просто:  просто
три:  тремя трёх
мода:  мода
добавить:  добавлена
свойстваэлементарный:  свойстваэлементарных
выполнить:  выполнена выполнить
калькулятор:  калькулятор калькулятором
лейбниц:  лейбница
полуавтоматический:  полуавтоматическая
научиться:  научиться
неравенство:  неравенства
поток:  поток
преодоление:  преодоления
касательная:  касательная
узколокальный:  узколокальных
задачис:  задачис
считать:  считаете считанные считает
сталкиваться:  сталкиваются
отличаться:  отличается
разобраться:  разобраться
возводить:  возводить
медиана:  медиана
вышеуказанный:  вышеуказанные вышеуказанных
функциия:  функциии
частый:  чаще
функцийдвуха:  функцийдвух
направлениюй:  направлениюи
определённый:  определенный определенного
выборка:  выборке
гостевой:  гостевая
примечание:  примечаниями
перевод:  перевода
умножать:  умножать
просмотреть:  просмотреть
понятный:  понятным
распределение:  распределения распределение распределений
экстремум:  экстремумы
кроме:  кроме
горнера:  горнера
производныефункция:  производныефункции
средний:  средняя
понятно:  понятно
функцийнесколький:  функцийнескольких
подготовка:  подготовки
рассчитать:  рассчитать
расстояние:  расстояний
перечень:  перечень
внутригрупповаяй:  внутригрупповаяи
градус:  градусов градусы
прилагаться:  прилагается
понять:  понять
алгебра:  алгебры
уникальный:  уникальным
математик:  математика
синус:  синуса
функцийв:  функцийв
переменный:  переменных переменной
упрощение:  упрощения
гид:  гид
трата:  трата
незаменимый:  незаменим незаменима
несовместный:  несовместные
независимыеслучайный:  независимыеслучайные
множественнойлинейный:  множественнойлинейной
никакой:  никакого
выполнение:  выполнения выполнении
разместить:  размещены
анализ:  анализ анализа
намного:  намного
матстат:  матстата
проект:  проекта
прямоугольник:  прямоугольников
непрерывность:  непрерывность
сделать:  сделано
эксцессэмпирический:  эксцессэмпирического
трапеция:  трапеций
содержать:  содержит
десятка:  десятки
функциис:  функциис
максимальный:  максимальной
зеркало:  зеркало
различный:  различных различным
криволинейный:  криволинейные
значит:  значит
тригонометрический:  тригонометрические тригонометрических
заточить:  заточена
смочь:  сможете
пирсон:  пирсона
факториал:  факториала
библиотека:  библиотека
межгрупповой:  межгрупповая
ортогональный:  ортогональное
трудность:  трудностей трудностью
дискретнойслучайный:  дискретнойслучайной
заменить:  заменить
задачипо:  задачипо
доступ:  доступ
мануал:  мануал
наименьшеезначение:  наименьшеезначения
нсв:  нсв
сила:  силы
находить:  находит находим
дополнение:  дополнения
иной:  иная
идти:  идет
паскаль:  паскаля
системылинейный:  системылинейных
нужно:  нужно
глава:  главам
быстро:  быстро
упасть:  упал
ход:  ходе
собирать:  собирать
зависимый:  зависимые
параметр:  параметров
буквально:  буквально
зависимость:  зависимость
отклонение:  отклонение
крамер:  крамера
основный:  основных
отрезка:  отрезке
таблица:  таблицы таблица таблице
произведение:  произведение
случайный:  случайных случайные
изображение:  изображений
время:  времени
замкнутый:  замкнутому
заглянуть:  заглянуть
написать:  написана
давно:  давно
аналог:  аналогов
дуга:  дуги
свой:  свои
отрезкать:  отрезкав
дивергенция:  дивергенция
парабола:  парабола
использование:  использования
форум:  форуме форум
бином:  биноме
показатель:  показатели
ввести:  введите
наш:  наш
учёт:  учетом
площадьс:  площадьс
статистика:  статистике статистика
функциидвуха:  функциидвух
рабочий:  рабочей
статистический:  статистические статистическая
запретить:  запрещено
емелин:  емелин
недостаточно:  недостаточно
убыванией:  убываниеи
вычисленияопределенный:  вычисленияопределенных
повышенный:  повышенной
избежать:  избежать
научный:  научную
возрастание:  возрастание
эмпирический:  эмпирические
детерминация:  детерминации
также:  также
легко:  легко
обязательно:  обязательно
интегрирование:  интегрирование интегрирования
бесплатный:  бесплатный
задачин:  задачина
арксинус:  арксинуса
рациональный:  рациональные
системый:  системыи
начать:  начать
удовлетворяетлить:  удовлетворяетли
арктангенс:  арктангенса
этот:  этих
пока:  пока
дифференциальныеуравнение:  дифференциальныеуравнения
иррациональный:  иррациональных
некоторый:  некоторых некоторые
интервальный:  интервальный
применение:  применения
квадратичнуюформ:  квадратичнуюформу
стокс:  стокса
характеристика:  характеристики
схема:  схема
карта:  карта
параметрический:  параметрической параметрическом
итак:  итак
знать:  знать
мера:  мере
держать:  держать
гипербола:  гипербола
вышмат:  вышмате
многоэтажный:  многоэтажных
дифференцирование:  дифференцирования
квадратный:  квадратного
дробовик:  дробовик
они:  ними
лично:  лично
оценкия:  оценкии
неявный:  неявной
оригинал:  оригиналов
режим:  режиме
короткий:  короткие
несобственныхинтеграл:  несобственныхинтегралов
вероятностибиномиальный:  вероятностибиномиального
сам:  самом
вводный:  вводного
вероятностия:  вероятностии
логика:  логики
род:  рода
заданав:  заданав
скалярный:  скалярное
спирмена:  спирмена
гаусс:  гаусса
порядок:  порядка порядков
всё:  всё
значимость:  значимости
тройной:  тройные
возникать:  возникает
деление:  деления
являться:  является
контуруформула:  контуруформула
частное:  частного
постепенно:  постепенно
экстремальный:  экстремальные
играть:  играть
дело:  деле
пирамида:  пирамиды пирамида
св:  св
парный:  парной
выполнять:  выполняет
нормаль:  нормали
секунда:  секунды
масса:  массу
выпуклость:  выпуклость
сопровождаться:  сопровождается
элемент:  элементы
сборник:  сборники
показательный:  показательное
читатель:  читателю
версия:  версия
рекомендовать:  рекомендую
независимый:  независимые
автор:  автора
сложность:  сложности
диффура:  диффурами
часто:  часто
значенияй:  значенияи
относиться:  относится
полнота:  полноту
пособие:  пособие
узнать:  узнать
никуда:  никуда
модуль:  модуле
включительно:  включительно
пустой:  пустая
получаться:  получается
косинус:  косинуса
вспомогательный:  вспомогательные
обучать:  обучающий
я:  мной
классическоеопределение:  классическоеопределение
инормаль:  инормаль
представлять:  представляет
корреляция:  корреляции
бумага:  бумаге
прежде:  прежде
подсчитать:  подсчитать
самостоятельный:  самостоятельным
отображение:  отображения
автомат:  автоматом
редкий:  реже
заочник:  заочников
линиюв:  линиюв
алгебраический:  алгебраические
мой:  моими
наслать:  нашли
максимально:  максимально
отношение:  отношении
самопроверка:  самопроверки
повторять:  повторяем
скачать:  скачать
оказаться:  окажется
