ошибка:  ошибкой ошибку
неизвестный:  неизвестны
полезный:  полезен
справка:  справка
производный:  производные производная производной производную
предел:  предел пределы пределов
ввиду:  ввиду
материал:  материалах материал материалов материалами материалы
трюк:  трюком
числовой:  числовые
производныенеявно:  производныенеявно
значение:  значение значениях значения
маленький:  маленькими маленькую меньше
страшноватый:  страшноваты
игрек:  игрек
формула:  формулы формулой формуле формула формулу
необъятный:  необъятное
доступ:  доступа
смотреть:  см смотрим смотрите
приходиться:  приходилось
связать:  связаны связан
параллельный:  параллельные параллельной параллельный параллельна параллелен параллельную параллельных параллельны параллельными
прийтись:  придётся
канонический:  каноническому
два:  две двум двумя двух
дифференциал:  дифференциалах дифференциала
больший:  наибольшее большие
нередко:  нередко
многие:  многие
различный:  различные различных различными
прямоугольный:  прямоугольной
нижний:  нижнее нижними
число:  число числами числу числа
вогнутостья:  вогнутостьи
многий:  многих
начинаться:  начинаются
случай:  случай случаи случаю случаев случае
профессия:  профессию
условие:  условии условие условия условию
пусть:  пусть
удобно:  удобно
умножение:  умножения
совпадать:  совпадающих совпадают совпадает совпадающие совпадать
выполнимый:  выполним
система:  система системе систему системы
группировка:  группировок группировка
условнаясходимость:  условнаясходимость
путать:  путать
угол:  угол углу угла углов углом
александр:  александр
ось:  ось оси осями
остаться:  осталось
проходить:  проходящей проходящую проходить проходит
который:  которые котором который которая которое которого
редко:  редко
линейный:  линейные линейная линейных линейной
вниз:  вниз
коэффициент:  коэффициентов коэффициентах коэффициент коэффициенты коэффициента
перепутать:  перепутать
любой:  любые любое любой любую любым любыми любых любом
равенство:  равенство равенства
согласие:  согласия
решать:  решаем решать
дуоперационный:  дуоперационным
геометрия:  геометрией геометрии геометрия
базис:  базисах базису базисе базис базиса
наиболее:  наиболее
зависимостьвектор:  зависимостьвекторов
распространить:  распространённый распространённая
дёшево:  дёшево
оно:  оно
сначала:  сначала
метод:  методы методом метод
страница:  страницу
столбец:  столбцу столбце
математический:  математическая математического математические математической
данные:  данных
излишний:  излишни
прямой:  прямых прямая прямой прямые прямую
высекать:  высекает
интеграл:  интеграл интегралов интегралы интеграла интеграле
урок:  урока уроков урок уроку уроке
разложение:  разложением разложение
косинус:  косинусы
икс:  икс
помогать:  помогает
открываться:  открывается
уравнение:  уравнению уравнения уравнение уравнением уравнениями уравнений
переход:  переход
подойти:  подойти подойдёт
утверждение:  утверждение
желательно:  желательно
вектор:  векторах векторы вектору вектором векторов вектора векторам векторами вектор
практический:  практических
комната:  комнаты
перпендикулярно:  перпендикулярно
малый:  малые наименьших
связь:  связь связи
ответить:  ответим
наука:  наук
точка:  точку точки точка точками точкам точек точке
лямбда:  лямбда
восемь:  восьми
бесконечный:  бесконечна
интернет:  интернете
наглядность:  наглядности
нормальный:  нормальное нормальный нормальными нормального нормальных
интегральнаятеорема:  интегральнаятеоремы
некоторый:  некоторой некоторую некоторому некоторых
корнимногочлен:  корнимногочлена
логарифмический:  логарифмическая
начать:  начнём начать
придать:  придав
основной:  основные
масляный:  масляное
бернулли:  бернулли
нужный:  нужен нужны нужна нужной
полярный:  полярные полярных полярной
рассмотреть:  рассмотрим рассмотренную рассмотренной
ряд:  ряды ряда ряд ряде рядов
уровень:  уровня
аффинный:  аффинного
аналогия:  аналогию аналогий
бэтмена:  бэтмен
должный:  должны должно
рука:  руке руку руки
значительно:  значительно
пользоваться:  пользоваться
привлекательный:  привлекательнее
доверительный:  доверительные
нюанс:  нюанс
среднееквадратический:  среднееквадратическое
расположение:  расположению расположение расположения расположении
неловко:  неловко
комбинационный:  комбинационная
декартов:  декартовой
оба:  обе
смешанноепроизведение:  смешанноепроизведение
вспомогательный:  вспомогательный
функция:  функции функция функций
дисперсия:  дисперсия дисперсии дисперсию
проверка:  проверки проверку проверка
постараться:  постарайтесь
рассчитываться:  рассчитывается
лежать:  лежать лежат лежащими лежит лежащие
школьный:  школьный
мы:  нам
раскрутить:  раскрутить
принадлежащий:  принадлежащую принадлежащим
образ:  образом
обзор:  обзор
октант:  октантов октанте
непрерывнаяслучайный:  непрерывнаяслучайная
четыре:  четыре
прямо:  прямо
длина:  длина длину
вдуматься:  вдумайтесь
посмотреть:  посмотреть посмотрите посмотрим
немного:  немного
мочь:  могут
знакопостоянство:  знакопостоянства
процитировать:  процитировал
проводить:  проводить проводим
родный:  родной
градиент:  градиент
посетить:  посетить
линия:  линия линии линиями
долгий:  долгими
технический:  техническим технический
комбинаторика:  комбинаторике
взаимный:  взаимному взаимном взаимного взаимное
случайнаявеличина:  случайнаявеличина
мой:  моих
бесконечно:  бесконечно
определитель:  определителя определитель определители
вращаться:  вращаться
форма:  формы
равный:  равны равна
задача:  задачу задаче задачи задач задачах задача
содержательный:  содержательным
несовместный:  несовместна несовместные
статья:  статьи статьёй
обратный:  обратную обратная
третий:  третий третьего
готовый:  готовых
три:  тремя трём трёх
просто:  просто
ещё:  ещё
вернуться:  вернёмся вернитесь
произвольный:  произвольный произвольных произвольную
быть:  буду будут будем
неколлинеарный:  неколлинеарных неколлинеарным
пространственный:  пространственная пространственных пространственной пространственное
краткий:  краткий краткая
читатель:  читателей читатели
данный:  данного данную данном данное данный
грамотно:  грамотно
тема:  тему темы
непрерывный:  непрерывных непрерывная
производныефункция:  производныефункции
средний:  средняя
единица:  единице единицы
область:  области область
последний:  последние последний последних
путь:  пути
математик:  математика
переменный:  переменных переменной
пример:  пример примеру примера примерам примере примерами примерах примеры
упрощение:  упрощения
буква:  буквы буква букву буквами
строгий:  строгим строга
независимыеслучайный:  независимыеслучайные
добавить:  добавить добавим
вверх:  вверх
координатный:  координатными координатная координатной координатные координатную
очевидный:  очевидный очевидно
следовательно:  следовательно
модель:  модель модели
непрерывность:  непрерывность
минус:  минус
содержать:  содержит
способ:  способами способа способ
функциис:  функциис
угодный:  угодно
полный:  полной полных полное
зеркало:  зеркало
значит:  значит
пирсон:  пирсона
член:  члены членов
вопрос:  вопрос вопросы
прозрачный:  прозрачен
межгрупповой:  межгрупповая
ортогональный:  ортогональное ортогональны
известный:  известный известному известную известны
конструировать:  конструировать
нсв:  нсв
здорово:  здорово
расположить:  расположена
вроде:  вроде
упасть:  упал
ход:  ходе хода
красивый:  красивая
задать:  заданные заданной задать зададут заданная задайте задана
отрезка:  отрезке
величина:  величина величин величины
одновременно:  одновременно
игра:  игры
важный:  важный важна важную
присмотреться:  присмотримся
внимательно:  внимательно
один:  одним одного одна одной одном
анализировать:  анализировать
детерминация:  детерминации
прорисовывать:  прорисовывают
сторона:  стороны
обязательно:  обязательно
следующий:  следующие следующее следующем
выполнить:  выполнить выполню
дифференциальныеуравнение:  дифференциальныеуравнения
изображать:  изображать
постоянный:  постоянных
стокс:  стокса
схема:  схема
направлять:  направляющие
перевариться:  переварится
выкладка:  выкладок
дробовик:  дробовик
параграф:  параграф параграфа параграфе
математика:  математике математики
векторный:  векторное векторного
сам:  самом саму сама самой
прочерчивать:  прочерчивает
вероятностия:  вероятностии
скалярный:  скалярное скалярного
совершенно:  совершенно
значимость:  значимости
серия:  серии
страшный:  страшного страшной
мысленно:  мысленно
дать:  дана данному дан дать данная данной даны
раскидывать:  раскидывать
верный:  верное
анализ:  анализа анализ
её:  её
частный:  частное частные
парный:  парной
найти:  найдём найти найдено
сборник:  сборники
прятаться:  прячется
параметрический:  параметрическом параметрической
раскрыть:  раскрыть
часто:  часто
оптимальный:  оптимальное
выполняться:  выполняются выполнялись выполняется
поговорить:  поговорили поговорим
получаться:  получается
какой:  какие
байконур:  байконур
находить:  находим находите
место:  место месте
решение:  решение решением решения решений
форум:  форум форуме
наш:  наши наш наша
книга:  книги книга книге
провести:  провести проведённый
узнавать:  узнаёте
устно:  устно
задание:  задание задания
раздел:  разделе раздел
справедливый:  справедлив справедливы
надобность:  надобности
вращение:  вращения
именно:  именно
принять:  принято примем
домашний:  домашнего
копирование:  копирование
разрыв:  разрыва
выражение:  выражения выражением
свободный:  свободным свободны свободные
наглеца:  наглеца
отблагодарить:  отблагодарить
байес:  байеса
простой:  проще
точность:  точности
получить:  полученного получено полученное полученный получили получи
теория:  теория теории
схематический:  схематический
подразумеваться:  подразумевается
пессимист:  пессимисты
называть:  называют
двумерный:  двумерная
тело:  тела
циркуляция:  циркуляция
непосредственно:  непосредственно
слагаемое:  слагаемого
плоскость:  плоскости плоскостями плоскостях плоскостей плоскость
отношение:  отношение отношении отношения
формальный:  формальную
пижонски:  пижонски
общий:  общим общая общем общее общими
поздний:  позже
определителяй:  определителяи
ортонормированный:  ортонормированного ортонормированном
положение:  положении
согласно:  согласно
закон:  законы
качество:  качестве
впечатление:  впечатление
координата:  координату координаты координатам координат координатах
насколько:  насколько
пункт:  пункт
вероятность:  вероятностей вероятность вероятности
предусмотреть:  предусмотрена
уравненийв:  уравненийв
конструкция:  конструкция конструкцию
переписать:  переписать перепишем
грин:  грина
суть:  сути
интересный:  поинтереснее
входить:  входит
эйлер:  эйлера
дальний:  дальнее
протянуть:  протянуть
каждый:  каждого каждом каждой каждую
дискретный:  дискретный
знакочередоваться:  знакочередующиеся
рассказать:  рассказать рассказал
принцип:  принцип
вели:  вели
припомнить:  припомню
пожалуй:  пожалуй
подумать:  подумайте
происходить:  происходят
сложный:  сложной сложнее сложные сложных
овал:  овал
фурье:  фурье
поле:  поля
сервант:  серванте
гипотеза:  гипотез гипотеза гипотезы
свойство:  свойства
исследование:  исследование
неравенство:  неравенством неравенству неравенств неравенство неравенства
плоский:  плоской плоского
вариация:  вариации
обеспечивать:  обеспечивают
сойти:  сошёл
основа:  основы
изобразить:  изображён изобразить
мало:  мало
интервал:  интервалы
пространство:  пространству пространстве пространства
кош:  коши
такой:  таком таким такое такого таких
выше:  выше
нарисовать:  нарисовать
начертить:  начертите начертим
упоминаться:  упоминалось
соответствующий:  соответствующих соответствующие
чайник:  чайников
предложить:  предложенной
вычисленияс:  вычисленияс
выуживание:  выуживанием
матричный:  матричные матричных матричный
всякий:  всяких всякий
заметить:  заметили
однородный:  однородные однородным
записывать:  записываем
круглый:  круглые
вычислить:  вычислить
обнулить:  обнулим обнулить
бродить:  бродят
очень:  очень
зачёт:  зачёта
новый:  новое новому
матрица:  матрицу матрицы матрицами
испытанияй:  испытанияи
интегралыть:  интегралыв
привыкнуть:  привык
перегруппировка:  перегруппировка
помощь:  помощью
начало:  начало начале
вариационный:  вариационный
стук:  стуком
линейно:  линейно
справочный:  справочных
отложить:  отложить отложите
расчёт:  расчётом
блог:  блог
высокий:  высших высшей высшая
произведение:  произведения произведение
единственный:  единственной единственное единственный единственную
воображение:  воображение
снимать:  снимаем
удобный:  удобный удобнее
курс:  курс
весь:  всеми всему
сообщить:  сообщите
сделать:  сделать
аналитический:  аналитическая аналитической
понижение:  понижение понижением
определить:  определить определят определит
выражаться:  выражается
стог:  стог
ненулевой:  ненулевой
конкретный:  конкретную
греческий:  греческие греческими
центр:  центр
компланарный:  компланарны
свободно:  свободно
мытарство:  мытарства
считаться:  считается
пересекаться:  пересекаются пересекающиеся пересекаться
быстрый:  быстрее быстрого
разделить:  разделим разделить
ждать:  ждут
перпендикулярность:  перпендикулярность
строгость:  строгости
построение:  построение
линейнойкорреляционный:  линейнойкорреляционной
действие:  действия
недалеко:  недалеко
тупой:  тупой
почему:  почему
распределениякритерия:  распределениякритерий
кошечка:  кошечку
обозначение:  обозначений обозначения
четвёртый:  четвёртого
небольшой:  небольшим
посматривать:  посматривайте
жёсткий:  жёсткую
несобственный:  несобственные
откуда:  откуда
завершать:  завершаем
касательная:  касательная
ответ:  ответ ответы
задачис:  задачис
дальнейший:  дальнейшие
разобраться:  разобраться разобрались
правило:  правила правило
функциия:  функциии
степенной:  степенного степенные
функцийдвуха:  функцийдвух
выборка:  выборке
функцийнесколький:  функцийнескольких
градус:  градусов
понять:  понять
множественнойлинейный:  множественнойлинейной
единичный:  единичный единичного
распределение:  распределение распределения
оказываться:  оказывается
задавать:  задаёт задают задаваемые
завуалировать:  завуалировать
решить:  решим решить
задачипо:  задачипо
востребовать:  востребованную
приблизить:  приближенные
знакомый:  знакомым
видно:  видно
изучить:  изучить изучили изучим
тиражироваться:  тиражируется
примечание:  примечание
зависимый:  зависимые
отклонение:  отклонение
таблица:  таблицы
кто:  кому
случайный:  случайных случайные
коллинеарный:  коллинеарный коллинеарны коллинеарных
пропускать:  пропускать
дуга:  дуги
наштамповать:  наштампует
отрезкать:  отрезкав
дивергенция:  дивергенция
спасибо:  спасибо
опытный:  опытных
возникнуть:  возник
дверь:  дверь
сайт:  сайт сайты сайта
графика:  графики графика
возрастание:  возрастание
эмпирический:  эмпирические
подставить:  подставим подставить
найтись:  нашлось
этот:  этих эта
аналогично:  аналогично
потребоваться:  потребуется потребоваться
нулевой:  нулевые
двухгранный:  двухгранных
отметить:  отмечу
иррациональный:  иррациональных
определение:  определению определения
квадратичнуюформ:  квадратичнуюформу
карта:  карта
гипербола:  гипербола
равно:  равно
индекс:  индексами
они:  ними
снять:  снять снимем
логика:  логики
спирмена:  спирмена
вид:  виду виды вид виде
пропорциональный:  пропорциональны
лишний:  лишняя
специально:  специально
определять:  определяет
хватать:  хватать хватает
возникать:  возникает
заключительный:  заключительный заключительной
вовсе:  вовсе
лишь:  лишь
св:  св
самый:  самый самое
второй:  второго второй вторым
этап:  этапов
параллельно:  параллельно
иметь:  имеет иметь
достаточно:  достаточно
похожий:  похожа похожи похожего
показательный:  показательное
преобразование:  преобразования преобразований
соответствовать:  соответствует
перпендикулярный:  перпендикулярных перпендикулярен перпендикулярна перпендикулярны перпендикулярную
диффура:  диффурами
перейти:  перейдём
весьма:  весьма
вычисление:  вычисление вычислениях
теоретический:  теоретических
использовать:  используем использовать используйте
покрутить:  покрутите
статистика:  статистика
бумага:  бумаге
опустить:  опущенного
вперёд:  вперёд
подставлять:  подставляем
биномиальный:  биномиальное
нестрогий:  нестрогое
повторить:  повторю
построить:  построенной построить
линиюв:  линиюв
самостоятельный:  самостоятельного
хотеться:  хочется
фигура:  фигурой фигуры
дуприближённо:  дуприближённо
информация:  информации информация
асимптота:  асимптоты
предполагать:  предполагаем
событие:  события
повторный:  повторные
кусочек:  кусочек
знать:  знает знаем знать
состоять:  состоит
космодром:  космодрома
забавно:  забавно
фнп:  фнп
экран:  экрана
простейшее:  простейшие
конец:  конце
часть:  частям часть
дартс:  дартс
двойной:  двойные двойной
несобство:  несобств
нелинейный:  нелинейная
дырявый:  дырявая
применить:  применить
преобразованиеквадратичный:  преобразованиеквадратичной
напрашиваться:  напрашивается
функциональный:  функциональные
комментарий:  комментарии
рациональный:  рациональнее рациональные
геометрический:  геометрическая геометрической геометрическое
абсолютный:  абсолютная
треугольник:  треугольник
встречаться:  встречаются встречается
одинаковый:  одинаковы
поверхность:  поверхностях поверхности
сложенияй:  сложенияи
раскрывать:  раскрываем
сохраняться:  сохраняться
вытащить:  вытащим
концовка:  концовку
регрессия:  регрессии регрессия
упростить:  упростить
взять:  возьмите взять
расстояние:  расстояние расстояния
исчисление:  исчисления
откладывать:  откладывать
потренировать:  потренируем
реальный:  реальные
обыденный:  обыденной
локальный:  локальная
ожидание:  ожидание ожиданиями
лаплас:  лапласа
перегиб:  перегиба
предыдущий:  предыдущем предыдущего предыдущие
сходимость:  сходимости сходимость
тот:  те
потолок:  потолок
создавать:  создаёт
ду:  ду
далее:  далее
носить:  носить
неопределённый:  неопределенный неопределенном
заключать:  заключают
дробь:  дробей
собственный:  собственные
признак:  признак признаки
поэтому:  поэтому
практика:  практике практики
увидеть:  увидите
безусловно:  безусловно
объять:  объять
асимметрия:  асимметрия
главный:  главную
сводиться:  сводящиеся
замена:  замены
характер:  характер
дырочка:  дырочка
составить:  составим составили составить
убрать:  убрать
результат:  результате
например:  например
решенияопределённый:  решенияопределенных
выглядеть:  выглядит
хотя:  хотя
подобрать:  подобрал
минимальный:  минимальную
коэффициентковариация:  коэффициентковариации
совместный:  совместна
причина:  причинам
обозначить:  обозначим
перечисленный:  перечисленные
желание:  желании
рассуждение:  рассуждения
лопиталя:  лопиталя
разобрать:  разобрана разобрали разобранной
работать:  работали
отвлечься:  отвлечёмся
поляформула:  поляформула
наверное:  наверное
фехнера:  фехнера
эффективный:  эффективные
первый:  первому первых первом первого первый первые
условный:  условные
эллипс:  эллипс
ваш:  вашего вашей
сократить:  сократить
хороший:  лучшего хорошим
чертёж:  чертёж чертеже чертежей
нерв:  нервах
даламбер:  даламбера
факт:  факт факты
теорема:  теоремы
располагаться:  располагаться
повторнойя:  повторнойи
комплексный:  комплексные комплексного комплексный комплексными
скобка:  скобки
ранг:  ранг
кривая:  кривой
тяжестиплоска:  тяжестиплоской
плохой:  плохое
мат:  мат
внимание:  внимание
лейбниц:  лейбница
привести:  приведу привести
сигма:  сигма
поток:  поток
расписать:  распишем
царица:  царица
медиана:  медиана
подстрочный:  подстрочными
видеть:  видел
направлениюй:  направлениюи
дополнить:  дополнить
гостевой:  гостевая
выгода:  выгодой
кроме:  кроме
понятно:  понятно
вывод:  вывод
главное:  главное
внутригрупповаяй:  внутригрупповаяи
зависеть:  зависит
алгебра:  алгебры
сумма:  сумму сумма
строка:  строкой
существовать:  существует
намного:  намного
слово:  словом слову
прямоугольник:  прямоугольников
получиться:  получиться получились
эксцессэмпирический:  эксцессэмпирического
выбрать:  выбрать выберите
оценка:  оценка оценки
правый:  правое
криволинейный:  криволинейные
библиотека:  библиотека
определяться:  определяется
настолько:  настолько
наименьшеезначение:  наименьшеезначения
доступный:  доступна
сила:  силы
задачка:  задачка
вычислимый:  вычислим
википедия:  википедии
системылинейный:  системылинейных
нужно:  нужно
громкий:  громким
нечего:  нечего
зависимость:  зависимость
другой:  другие
замкнутый:  замкнутому
закономерность:  закономерности
давно:  давно
проверить:  проверим проверить
полупространство:  полупространство полупространства
показатель:  показатели
площадьс:  площадьс
эль:  эль
мишень:  мишень
убыванией:  убываниеи
повышенный:  повышенной
статистический:  статистическая статистические
также:  также
интегрирование:  интегрирование
легко:  легко
пока:  пока
нуль:  нулю нуля
ситуация:  ситуация
читать:  читайте
список:  списке
интервальный:  интервальный
итак:  итак
параллелограмм:  параллелограмма
принадлежать:  принадлежит
оценкия:  оценкии
неявный:  неявной
несобственныхинтеграл:  несобственныхинтегралов
вероятностибиномиальный:  вероятностибиномиального
род:  рода
гаусс:  гаусса
честно:  честно
точно:  точно
экстремальный:  экстремальные
меню:  меню
нормаль:  нормали
обещать:  обещанного
противоположный:  противоположный
выпуклость:  выпуклость
элемент:  элементы
схематически:  схематически
менее:  менее
принципиально:  принципиально
сложность:  сложности
значенияй:  значенияи
многочлен:  многочлен
трёхбуквенный:  трёхбуквенные
классический:  классическая
зафиксировать:  зафиксировать
кстати:  кстати
классическоеопределение:  классическоеопределение
инормаль:  инормаль
вышесказанный:  вышесказанному
далёкий:  дальше
пирамида:  пирамида
видимо:  видимо
аналогичный:  аналогичный
автор:  автор автора
понимание:  понимания
цель:  целях
дифференциальный:  дифференциальные
уравненияс:  уравненияс
пропорциональность:  пропорциональность
онлайн:  онлайн
работа:  работа работу
произвольныйтройный:  произвольныйтройной
дизайн:  дизайна
это:  это этим
перпендикуляр:  перпендикуляр перпендикуляра
поляй:  поляи
высота:  высоте
находиться:  находится
опечатка:  опечатку
отсекать:  отсекает
привычный:  привычного
продолжать:  продолжаем
продолжаться:  продолжается
методомоперационный:  методомоперационного
бесповторный:  бесповторной
облачко:  облачко
наверняка:  наверняка
правильно:  правильно
л:  л
помочь:  поможет
вещь:  вещь вещи
вокруг:  вокруг
важно:  важно
барабан:  барабану
переделывать:  переделывать
касательный:  касательных
продолжить:  продолжим
фиксировать:  фиксированная
типовыхзадача:  типовыхзадач
ранговойкорреляция:  ранговойкорреляции
масло:  масло
искомое:  искомое
помнить:  помню
скука:  скуки
посвятить:  посвящен
сколько:  сколько
независимый:  независимы независимые
исследовать:  исследовать
образовать:  образуют
пересекать:  пересекает
совпасть:  совпал
линейныйкоэффициент:  линейныйкоэффициент
сено:  сена
нахождение:  нахождении
несколько:  несколькими
несобственныйинтеграл:  несобственныйинтеграл
безобразие:  безобразия
доступно:  доступно
логично:  логично
учиться:  учимся
напоминать:  напоминает напоминаю
явный:  явную
допустить:  допустить
развить:  разовьём
ипример:  ипримеры
множество:  множества
требоваться:  требуется требовалось
живой:  живой
искать:  ищите
поверхностный:  поверхностные
принимать:  принимают
дружить:  дружит
пуассон:  пуассона
подобный:  подобные
однако:  однако
таки:  таки
фактически:  фактически
математическоеожидание:  математическоеожидание
разновидность:  разновидность
школа:  школа
неоднородный:  неоднородные
необходимо:  необходимо
проверять:  проверяем
оформить:  оформить
стерва:  стерва
картинка:  картинку
думать:  думаю
кратное:  кратные
системудифференциальный:  системудифференциальных
рассчитывать:  рассчитываем
тон:  тоном
помимо:  помимо
алгоритм:  алгоритм
последовательность:  последовательностей
типовой:  типовая
квадратичный:  квадратичные
выполнять:  выполняйте
свестись:  свелось
объём:  объем
умереть:  умереть
усвоение:  усвоения
поскольку:  поскольку
гипергеометрическоераспределение:  гипергеометрическоераспределение
обратить:  обратите
многое:  многом
возможность:  возможность
равномерный:  равномерная равномерное
треугольный:  треугольная
необходимость:  необходимость
вытянуть:  вытяните
обозначать:  обозначать
пожалуйста:  пожалуйста
устроить:  устроит
усложнить:  усложним
следовать:  следует
себя:  собой
однозначно:  однозначно
полагать:  полагать
квадрат:  квадратов
сразу:  сразу
флакон:  флаконе
функциюкомплексный:  функциюкомплексной
мода:  мода
популярный:  популярны
свойстваэлементарный:  свойстваэлементарных
калькулятор:  калькулятор
проситься:  просится
научиться:  научиться
удовлетворять:  удовлетворяет удовлетворяют
похоже:  похоже
формально:  формально
определённый:  определенный определенного
тренировка:  тренировки
предлагать:  предлагаю предлагать
действительно:  действительно
экстремум:  экстремумы
горнера:  горнера
вкус:  вкусом
получать:  получаем
функцийв:  функцийв
стартовать:  стартует
активно:  активно
довольно:  довольно
телевизор:  телевизора
томиться:  томиться
начинать:  начинаем
полёт:  полёты
понимать:  понимать
дискретнойслучайный:  дискретнойслучайной
вертеться:  вертеться
знак:  знак
прекрасно:  прекрасно
сердито:  сердито
интересовать:  интересуют
стена:  стены
крамер:  крамера
размножить:  размножьте
банально:  банально
парабола:  парабола
строго:  строго
запретить:  запрещено
функциидвуха:  функциидвух
черновик:  черновике
емелин:  емелин
мёртвый:  мёртвого
традиционный:  традиционного
вычисленияопределенный:  вычисленияопределенных
задачин:  задачина
замечательный:  замечательные
системый:  системыи
удовлетворяетлить:  удовлетворяетли
сегодня:  сегодня
тригонометрический:  тригонометрических
аналитически:  аналитически
наклон:  наклон
казаться:  казалось
чётко:  чётко
заданав:  заданав
порядок:  порядка порядков
всё:  всё
клетчатый:  клетчатой
тройной:  тройные
деление:  деления
являться:  является
контуруформула:  контуруформула
график:  график
острый:  острый
дело:  деле дело
простота:  простоты
либо:  либо
зет:  зет
лаконичность:  лаконичность
менять:  меняем
корреляция:  корреляции
обзорный:  обзорный
заочник:  заочников
повторять:  повторяем
соотношение:  соотношением
