раскрывать:  раскрывать раскрываем раскрывая
техника:  технику
третий:  третьим третий третья третьем третью третьему третьего третьей
столбцы:  столбцов столбцы столбцами
мишень:  мишени мишенью мишень
положить:  положены
неоднократно:  неоднократно
транспонировать:  транспонируем транспонировать транспонируйте транспонированной
производный:  производные производная производной производную
оформлять:  оформляют
предел:  предел пределы пределов
небольшой:  небольшой невелик
качественно:  качественно
переварить:  переварить
крокодил:  крокодилы
выбор:  выбор
обычный:  обычном обычным
числовой:  числовые
исходный:  исходного исходном исходному
производныенеявно:  производныенеявно
значение:  значение значению
традиционный:  традиционном
контрольный:  контрольных
дальнейший:  дальнейшем дальнейшее дальнейшие
десерт:  десерта
формула:  формулы формулам формула
смотреть:  см смотрим смотрите
читатель:  читатель читатели
особенно:  особенно
отрицательный:  отрицательный отрицательным
прийтись:  придётся пришлось
канонический:  каноническому
два:  две двумя двух
дифференциал:  дифференциалах дифференциала
повышенный:  повышенный повышенной
больший:  наибольшее большие большими
обратно:  обратно
известно:  известно
нередко:  нередко
один:  одну одно одним одной одном одни
любой:  любому любые любой любая любую
десять:  десяти десять
земноводный:  земноводное
число:  число числами чисел числа
вогнутостья:  вогнутостьи
верный:  верный
двойной:  двойных двойные двойной
становиться:  становится
стать:  стали статей стала станет
случай:  случай случая случаев случае
убедиться:  убедиться
профессия:  профессию
пусть:  пусть
удобно:  удобно
умножение:  умножения
закинуть:  закинуть
система:  система системе систему систем системы
немногий:  немногих
группировка:  группировок группировка
познакомиться:  познакомимся
условнаясходимость:  условнаясходимость
слово:  словами слову слово
элементарный:  элементарном элементарных элементарная элементарна элементарное элементарные элементарного
александр:  александр
сменить:  сменил сменит
необходимый:  необходимый
запоминать:  запоминаем
сказать:  скажете сказать скажут
уровень:  уровень уровня
обусловить:  обусловлен
линейный:  линейные линейная линейных линейной
вниз:  вниз
заходить:  заходите
считать:  считанных считаем считает считать
разобрать:  разобрано
согласие:  согласия
вынесение:  вынесения
опыт:  опыт опыта опытом
совет:  совет
поубавиться:  поубавится
придумать:  придуманную
решать:  решаем решать решайте
дуоперационный:  дуоперационным
понижать:  понижая понижаем понижать
справочник:  справочники
базис:  базисах базису базис
наиболее:  наиболее
зависимостьвектор:  зависимостьвекторов
выжимать:  выжимаем
сначала:  сначала
метод:  методы методов методом метод
тема:  теме
страница:  страницу страницы странице
столбец:  столбцу столбце столбец столбцам столбцом столбца
различие:  различие
математический:  математическая математические математической
данные:  данных
интеграл:  интеграл интегралов интегралы интеграла интеграле
урок:  урока уроке
разложение:  разложением разложении разложение
лишний:  лишние
вносить:  вносим
помогать:  помогает
уравнение:  уравнению уравнения уравнение уравнений
переход:  переход
определитель:  определителем определителя определителях определителей определителю определитель определителе определители
очередь:  очередь
багаж:  багаж
гонщик:  гонщиков
практический:  практических практическим практический
работа:  работах работа
понижаться:  понижается
обильно:  обильно
малый:  малые наименьших
связь:  связь
хороший:  лучшим лучший
нормальный:  нормальное
интегральнаятеорема:  интегральнаятеоремы
позволить:  позволят
корнимногочлен:  корнимногочлена
логарифмический:  логарифмическая
начать:  начнём начать начните
место:  места местами
основной:  основные
бернулли:  бернулли
полярный:  полярные полярных полярной
мой:  моего
рассмотреть:  рассмотрим рассмотренного рассмотренное
ряд:  ряды ряда ряд рядов
преобразование:  преобразовании преобразованиях преобразования преобразование преобразований
крупный:  крупных
краткий:  краткие
наперёд:  наперёд
значительно:  значительно
привлекательный:  привлекательнее
доверительный:  доверительные
форма:  форме формы
редкость:  редкость
среднееквадратический:  среднееквадратическое
расположить:  расположенные
оптимальный:  оптимальнее оптимальное
комбинационный:  комбинационная
смешанноепроизведение:  смешанноепроизведение
функция:  функции функция функций
дисперсия:  дисперсия дисперсии дисперсию
постараться:  постарайтесь
большой:  велик побольше велика
попытаться:  попытаюсь
компланарность:  компланарность
школьный:  школьный
мы:  нам
появляться:  появляются
выбирать:  выбираем
непрерывнаяслучайный:  непрерывнаяслучайная
другой:  других другие другим другую
четыре:  четыре четырёх
прямо:  прямо
длина:  длина
посмотреть:  посмотреть посмотрим
немного:  немного
мочь:  могут
знакопостоянство:  знакопостоянства
понизить:  понизим понизили понизить понижен
неплохо:  неплохо
градиент:  градиент
увеличивать:  увеличивает
линия:  линия линии линиями
разнообразие:  разнообразия
ясно:  ясно
комбинаторика:  комбинаторике
измениться:  изменится изменился
случайнаявеличина:  случайнаявеличина
исследование:  исследовании исследование
бесконечно:  бесконечно
знак:  знаков знаком знака знак
стараться:  стараемся
понизиться:  понизился
четвёртый:  четвёртый четвёртой четвёртого четвертой четвёртому четвёртую
удобство:  удобством
равный:  равны равен
отметить:  отметить
задача:  задаче задачи задачах задача
обратный:  обратную обратная обратное
ненулевой:  ненулевое
завтра:  завтра
диагональ:  диагонали
готовый:  готовых готовая
просто:  просто
ещё:  ещё
прибавить:  прибавили прибавим прибавить
вернуться:  вернёмся
завернуть:  завернёт
картинка:  картинками
облегчить:  облегчить
заготовить:  заготовленный
рациональный:  рационального рациональный рациональнее рациональные
частый:  чаще
калькулятор:  калькулятора калькулятор калькуляторе
воевать:  воевать
данный:  данного данном данное данный
умножать:  умножать умножаем
непрерывный:  непрерывных непрерывная
производныефункция:  производныефункции
средний:  средняя
единица:  единице единица единицы единиц
область:  области область
путь:  пути путь
предположим:  предположим
полезный:  полезных
математик:  математика
который:  которому который которая которое которой
попробовать:  попробовать
переменный:  переменных переменной
пример:  пример примера примере примеры
несовместный:  несовместные
независимыеслучайный:  независимыеслучайные
добавить:  добавить
вверх:  вверх
очевидный:  очевидный очевидное
транспонирование:  транспонирования транспонировании
модель:  модель модели
минус:  минус минуса минусов
непрерывность:  непрерывность
способ:  способами способы способом способ
функциис:  функциис
гуляш:  гуляш
полный:  полной полных полное
пятый:  пятого пятой
зеркало:  зеркало
второй:  втором второго второму второй вторым вторую вторая
значит:  значит
пирсон:  пирсона
вопрос:  вопрос вопросу вопросы
межгрупповой:  межгрупповая
ортогональный:  ортогональное
ошибка:  ошибки ошибку
нсв:  нсв
внесение:  внесение
учебник:  учебники
быстро:  быстро
равноправный:  равноправно равноправны
упасть:  упал
ход:  ходе ход ходу
неудобство:  неудобство
отрезка:  отрезке
перец:  перцем
величина:  величина величин величины
игра:  игры играми
важный:  важный
запись:  запись
делиться:  делятся
короче:  короче
нарисоваться:  нарисовался
раскрой:  раскроем
таблица:  таблица таблицы
закономерность:  закономерность
детерминация:  детерминации
получить:  полученном полученного получим получить получена получив получили получи
тот:  тех та тому той
дифференциальныеуравнение:  дифференциальныеуравнения
прямой:  прямая прямой прямую
взять:  возьмём взять
контролировать:  контролировать
постоянный:  постоянных
стокс:  стокса
схема:  схема
самостоятельно:  самостоятельно
жизнь:  жизнь
дробовик:  дробовик
параграф:  параграф
математика:  математике математики
векторный:  векторное векторного
слабо:  слабо
вероятностия:  вероятностии
скалярный:  скалярное
задание:  заданиях задание
понятный:  понятен понятны
свойство:  свойствах свойства свойством свойств свойству свойство
значимость:  значимости
страшный:  страшного
мысленно:  мысленно
анализ:  анализа анализ
её:  её
частный:  частное частные частный
парный:  парной парная
координата:  координатами координаты координат координатах
несколько:  несколько несколькими
сборник:  сборники
параметрический:  параметрическом параметрической
ваш:  вашем вашу ваш вашего
раскрыть:  раскрыть раскрыли раскройте раскрыв
часто:  часто
нагулять:  нагулять
пропорциональный:  пропорциональными пропорциональны
сидеть:  сидеть
получаться:  получается
изменить:  изменил
какой:  какие
решение:  решение решением решения решений
годзилла:  годзилла
форум:  форум форуме
книга:  книги книга
компактный:  компактный
многий:  многим
рационально:  рационально
дополнительный:  дополнительное дополнительного
разложить:  разложим разложив разложили разложить
устно:  устно
вынести:  вынести вынесли вынесем
проанализировать:  проанализируем
реальный:  реальное
вектор:  векторы векторов вектора
раздел:  разделе
справедливый:  справедлив
вращение:  вращения
именно:  именно
копирование:  копирование
давать:  давайте
разрыв:  разрыва
выражение:  выражения
необходимость:  необходимости
отблагодарить:  отблагодарить
байес:  байеса
ступенчатый:  ступенчатых ступенчатый
простой:  проще
выгодно:  выгодно
рука:  рукой руку
минута:  минуты минут
результат:  результат результата результате
теория:  теория теории
отсутствовать:  отсутствует
называть:  называемый
вспоминать:  вспоминая вспоминаем
изменение:  изменение
главный:  главный главной главную
избежание:  избежание
двумерный:  двумерная
задать:  заданной задайте
тело:  тела
циркуляция:  циркуляция
слева:  слева
слабый:  слабые
сок:  сока
лежать:  лежат
плоскость:  плоскости плоскость
общий:  общим общая общий общем
получиться:  получится
помеха:  помех
определителяй:  определителяи
мир:  мир
выступать:  выступает
выносить:  выносим выносить
апельсиновый:  апельсинового
согласно:  согласно
закон:  законы
справа:  справа
первый:  первым первую первой первому первая первом первого первый первые
самый:  самым самые
качество:  качестве
рассматривать:  рассматриваемых
произвольный:  произвольной произвольных
вероятность:  вероятностей вероятность вероятности
уравненийв:  уравненийв
множитель:  множитель множителей
поделиться:  поделиться
иметь:  имеют имеет имеете
грин:  грина
эйлер:  эйлера
направо:  направо
геометрический:  геометрический геометрическая геометрическое
баранка:  баранки
умножить:  умноженный умноженную умножим
знакомый:  знакомых
дискретный:  дискретный
знакочередоваться:  знакочередующиеся
заметно:  заметно
принцип:  принцип принципе
лаконичный:  лаконичный
лёгкий:  легки легче
сложный:  сложной сложные сложных
треугольный:  треугольные треугольный треугольная
отправить:  отправим
фурье:  фурье
дать:  дан данной
поле:  поля
гипотеза:  гипотез гипотеза гипотезы
момент:  момент
любительский:  любительская
точка:  точки точке
вариация:  вариации
пойти:  пойдет пойти
сыграть:  сыграем
основа:  основы
слишком:  слишком
интервал:  интервалы
кош:  коши
такой:  таком такие такое такая
выше:  выше
чайник:  чайников чайникам
вычисленияс:  вычисленияс
древний:  древнейших
матричный:  матричные матричных матричный
столкнуться:  столкнулись
заметить:  заметили заметьте
подстрочный:  подстрочных
однородный:  однородные однородным
записывать:  записываем
выполнять:  выполняют выполнять выполняемые
вычислить:  вычислить
очень:  очень
матрица:  матрицу матрицы матрица матрицами матрице
испытанияй:  испытанияи
интегралыть:  интегралыв
научиться:  научимся научиться
смешанный:  смешанного
перегруппировка:  перегруппировка
замечать:  замечаем
пропорциональность:  пропорциональности
помощь:  помощью
вариационный:  вариационный
страничка:  страничек
день:  дне
линейно:  линейно
блог:  блог
высокий:  высших высшей высшая
произведение:  произведения произведение произведению
доступный:  доступной
пространство:  пространстве пространства
удобный:  удобный удобнее
курс:  курс
кандидат:  кандидатом
меняться:  меняется
сообщить:  сообщите
сделать:  сделать
аналитический:  аналитическая аналитической
понижение:  понижение понижением
центр:  центр
компланарный:  компланарны
узнать:  узнаем узнать
вникнуть:  вникнуть
жаба:  жаба жаб
быстрый:  быстрее
насчитываться:  насчитывается
затем:  затем
построение:  построение
линейнойкорреляционный:  линейнойкорреляционной
действие:  действия действие
монстр:  монстров монстром
время:  время
пора:  пор
индекс:  индексов индексы
неизменный:  неизменным неизменной
почему:  почему
распределениякритерия:  распределениякритерий
предстоять:  предстоит
несобственный:  несобственные
зрение:  зрения
представлять:  представлять
процесс:  процесс
касательная:  касательная
ответ:  ответ ответы
задачис:  задачис
комплексовать:  комплексуйте
правило:  правила правил правилом правило правиле
наказуемый:  наказуем
функциия:  функциии
возможно:  возможно
степенной:  степенного степенные
функцийдвуха:  функцийдвух
выборка:  выборке
прикладной:  прикладное
функцийнесколький:  функцийнескольких
понять:  понять
простецкий:  простецкая
налево:  налево
настоящий:  настоящий
множественнойлинейный:  множественнойлинейной
зависимость:  зависимости зависимость
некоторый:  некоторого некоторых некоторые
сформулировать:  сформулируем сформулированное
распределение:  распределение распределения
поменять:  поменяем поменять
забывать:  забываем
этот:  этому
совпасть:  совпали
решить:  решим решить
задачипо:  задачипо
нравиться:  нравятся
востребовать:  востребованную
приблизить:  приближенные
новогодний:  новогодний
помещать:  помещаем
вариант:  вариант
примечание:  примечание
зависимый:  зависимые зависимы
путём:  путём
отклонение:  отклонение
избавиться:  избавиться
ум:  умы
вполне:  вполне
случайный:  случайных случайные
материал:  материала материалов материалы
дуга:  дуги
частность:  частности
отрезкать:  отрезкав
дивергенция:  дивергенция
дотошный:  дотошные
представиться:  представится
использование:  использования
одинаково:  одинаково
подробный:  подробной подробнее
сайт:  сайт сайте сайты сайта
наш:  наш наша
графика:  графики графика
неверно:  неверно
идти:  идёт
причина:  причине
возрастание:  возрастание
эмпирический:  эмпирические
найтись:  нашлось
знать:  зная знать
упростить:  упростят упростить
аппетит:  аппетит
громоздкий:  громоздкие
разбираться:  разбираться
появиться:  появился
нулевой:  нулевые нулевой
иррациональный:  иррациональных
услышать:  услышал
располагаться:  располагается
определение:  определению определения
квадратичнуюформ:  квадратичнуюформу
элемент:  элементам элемент элементов элементы элементу элемента
карта:  карта
вычисление:  вычисления вычисление вычислений
выйти:  вышло
гипербола:  гипербола
быть:  будут
равно:  равно
они:  ними
академичный:  академично
выгодный:  выгодные выгодным выгоднее
логика:  логики
спирмена:  спирмена
следующий:  следующим следующем
вид:  виду виды вид виде
специально:  специально
возникать:  возникает
св:  св
коснуться:  коснёмся
пара:  пара
беда:  беда
достаточно:  достаточно
показательный:  показательное
маловероятный:  маловероятно
диффура:  диффурами
соответствующий:  соответствующие
весьма:  весьма
проверить:  проверили проверить
использовать:  используем используя использовать используйте
статистика:  статистика
биномиальный:  биномиальное
равенство:  равенстве
повторить:  повторю
линиюв:  линиюв
шутка:  шутки
самостоятельный:  самостоятельного
выбрать:  выбрав выбрать выберем
отношение:  отношении
маленький:  маленького поменьше маленьким маленькие
долгожданный:  долгожданные
смысл:  смысл
прибавлять:  прибавляют прибавляем
дуприближённо:  дуприближённо
потратить:  потратите
асимптота:  асимптоты
событие:  события
повторный:  повторные
порядок:  порядок порядка порядков
посидеть:  посидеть
строка:  строку строке строкой строки строкам строках строка строк
состоять:  состоит
нижеследующий:  нижеследующий
фнп:  фнп
кнопка:  кнопкам
простейшее:  простейшие
иной:  иными
конец:  конце конца
часть:  частям
оставить:  оставим
несобство:  несобств
классический:  классической
нелинейный:  нелинейная
преобразованиеквадратичный:  преобразованиеквадратичной
функциональный:  функциональные
комментарий:  комментарии
абсолютный:  абсолютная
одинаковый:  одинаковы
встречаться:  встречаются
особый:  особый особого
сложенияй:  сложенияи
регрессия:  регрессии регрессия
ориентироваться:  ориентируетесь
исчисление:  исчисления
двойка:  двойку двойка
подходить:  подходит
вложить:  вложить
локальный:  локальная
понятие:  понятиями
ожидание:  ожидание
лаплас:  лапласа
перегиб:  перегиба
сходимость:  сходимости сходимость
представить:  представьте
поехать:  поехали
оказаться:  оказаться
ду:  ду
работать:  работают
далее:  далее
остаток:  остатка
коэффициент:  коэффициент
неопределённый:  неопределенный неопределенном
круг:  круг круги
дробь:  дробей
собственный:  собственные
спасти:  спасёт
признак:  признак признаки
запутаться:  запутаться
вкусно:  вкусно
правильный:  правильный
поэтому:  поэтому
влечь:  влечёт
практика:  практике
менять:  меняет
безусловно:  безусловно
дублировать:  дублирует
асимметрия:  асимметрия
шаг:  шаге
скажем:  скажем
целесообразный:  целесообразнее
ставить:  ставить ставим
сверху:  сверху
представимый:  представим
сводиться:  сводящиеся
замена:  замены
записать:  запишем записать записаны
захотеться:  захочется
например:  например
оплошность:  оплошностей
решенияопределённый:  решенияопределенных
выглядеть:  выглядит
возвращаться:  возвращается
действительность:  действительности
хотя:  хотя
аналогичный:  аналогичное аналогичный
вверху:  вверху
коэффициентковариация:  коэффициентковариации
свой:  своя
перечисленный:  перечисленные
спичка:  спичках
лопиталя:  лопиталя
матана:  матана
отработать:  отработаем
крайне:  крайне
стандартный:  стандартными стандартным
поляформула:  поляформула
фехнера:  фехнера
вычислительный:  вычислительной
эффективный:  эффективные эффективного
условный:  условные
впервые:  впервые
эллипс:  эллипс
ноль:  ноль
сократить:  сократить
заключительный:  заключительном
выход:  выход
количество:  количество
вычитать:  вычитать
даламбер:  даламбера
теорема:  теоремы
факт:  факт
повторнойя:  повторнойи
естественно:  естественно
комплексный:  комплексные комплексного комплексный комплексными
скобка:  скобки
ранг:  ранг
кривая:  кривой
организовать:  организуем организовать
тяжестиплоска:  тяжестиплоской
допустить:  допустим допустить
проверка:  проверка
нуль:  нули нулю нуля нулей
построить:  построить
игнорироваться:  игнорируются
внимание:  внимание
лейбниц:  лейбница
привести:  приведу привести
ради:  ради
неравенство:  неравенства
бойня:  бойня
поток:  поток
медиана:  медиана
тьма:  тьма
направлениюй:  направлениюи
единственный:  единственное единственный
гостевой:  гостевая
очередной:  очередного
многовато:  многовато
встречать:  встречаем
понятно:  понятно
никакой:  никакой
знание:  знаний
главное:  главное
закрепление:  закрепления
внутригрупповаяй:  внутригрупповаяи
зависеть:  зависит
он:  нём
алгебра:  алгебры
сумма:  сумму сумма
существовать:  существует существуют
обед:  обед
прямоугольник:  прямоугольников
отличаться:  отличаться
эксцессэмпирический:  эксцессэмпирического
стакан:  стакан
животное:  животное
оценка:  оценка оценки
криволинейный:  криволинейные
различный:  различных
библиотека:  библиотека
мощный:  мощным
идея:  идея
год:  года
приём:  приёмам приёмы
наименьшеезначение:  наименьшеезначения
сила:  силы
вычислимый:  вычислим
протяжение:  протяжении
разница:  разницы
системылинейный:  системылинейных
нужно:  нужно
внести:  внесём внести
видеть:  вижу
освоение:  освоение
суп:  суп
замкнутый:  замкнутому
давно:  давно
сам:  само самой
благо:  благо
показатель:  показатели
энтузиазм:  энтузиазма
сильно:  сильно
площадьс:  площадьс
большинство:  большинстве
присутствовать:  присутствует
замечательный:  замечательный замечательные
старый:  старых
убыванией:  убываниеи
статистический:  статистическая статистические
также:  также
интегрирование:  интегрирование
собираться:  собираетесь
легко:  легко
читать:  читайте
интервальный:  интервальный
распространить:  распространённым
итак:  итак
вообще:  вообще
оценкия:  оценкии
неявный:  неявной
несобственныхинтеграл:  несобственныхинтегралов
вероятностибиномиальный:  вероятностибиномиального
уметь:  умеет
род:  рода
гаусс:  гаусса
достигнуть:  достичь
полезно:  полезно
экстремальный:  экстремальные
меню:  меню
нормаль:  нормали
путешествие:  путешествия
присест:  присест
желать:  желающие
успеть:  успели
противоположный:  противоположный
выпуклость:  выпуклость
интересно:  интересно
менее:  менее
сложность:  сложности
значенияй:  значенияи
справедливо:  справедливо
нужный:  нужной
кстати:  кстати
классическоеопределение:  классическоеопределение
инормаль:  инормаль
далёкий:  дальше
пирамида:  пирамида
перестановка:  перестановка
помнить:  помните
находиться:  находятся
путать:  путайте
автор:  автор автора
родить:  родить
руководствоваться:  руководствоваться
цель:  целях
распоряжение:  распоряжении
лягушонок:  лягушонка
разобраться:  разобрались
дифференциальный:  дифференциальные
уравненияс:  уравненияс
онлайн:  онлайн
геометрия:  геометрии геометрия
нехороший:  нехорошего
новый:  новому
произвольныйтройный:  произвольныйтройной
ниже:  ниже
зеркальный:  зеркальное
дизайн:  дизайна
это:  это этим
ситуация:  ситуаций
явный:  явной
поляй:  поляи
опечатка:  опечатку
стучать:  стучать
речь:  речь
статья:  статье
формулировка:  формулировка
методомоперационный:  методомоперационного
толк:  толку
ехать:  ехать
бесповторный:  бесповторной
л:  л
помочь:  поможет
важно:  важно
татуировка:  татуировками
снизу:  снизу
коллинеарный:  коллинеарны
внизу:  внизу
несложно:  несложно
реверанс:  реверансы
наблюдаться:  наблюдалась
секунда:  секунд
касательный:  касательных
типовыхзадача:  типовыхзадач
ранговойкорреляция:  ранговойкорреляции
прийти:  пришло
неутомимый:  неутомимые
переставлять:  переставлять
исследовать:  исследовать
поверхность:  поверхности
линейныйкоэффициент:  линейныйкоэффициент
бой:  бой
несобственныйинтеграл:  несобственныйинтеграл
доступно:  доступно
покой:  покое
причём:  причём
учиться:  учимся
задавать:  задаваемые
район:  районе
ипример:  ипримеры
множество:  множества
найти:  найти
поверхностный:  поверхностные
фигура:  фигуры
пуассон:  пуассона
подобный:  подобные
однако:  однако
фактически:  фактически
математическоеожидание:  математическоеожидание
школа:  школа
неоднородный:  неоднородные
экономить:  экономить
думать:  думаю
кратное:  кратные
стоить:  стоит
системудифференциальный:  системудифференциальных
лапка:  лапки
резюмировать:  резюмируя
набить:  набить
алгоритм:  алгоритм
последовательность:  последовательностей
должный:  должно
квадратичный:  квадратичные
объём:  объем
предполагаться:  предполагается
удлинить:  удлинит
впереди:  впереди
требоваться:  требовалось
поскольку:  поскольку
гипергеометрическоераспределение:  гипергеометрическоераспределение
заядлый:  заядлых
обратить:  обратите
возможность:  возможность
подробно:  подробно
равномерный:  равномерная равномерное
пожалуйста:  пожалуйста
распотрошить:  распотрошим
золотой:  золотое
стильно:  стильно
следовать:  следует
улучшить:  улучшить
подрасти:  подросшее
квадрат:  квадратов
укоротить:  укороченную
сразу:  сразу
функциюкомплексный:  функциюкомплексной
мода:  мода
свойстваэлементарный:  свойстваэлементарных
принимать:  принимает
порубить:  порубим
демонстрироваться:  демонстрировалось
оба:  оба
реально:  реально
говорить:  говорят
определённый:  определенный определенного
покрыть:  покрыл
остаться:  останется
действительно:  действительно
экстремум:  экстремумы
горнера:  горнера
ерунда:  ерунда
переставить:  переставим
подарок:  подарок
зацикливаться:  зацикливаться
функцийв:  функцийв
ознакомиться:  ознакомиться
напоминать:  напоминать
рядышком:  рядышком
понимать:  понимать
три:  трёх
дискретнойслучайный:  дискретнойслучайной
прекрасно:  прекрасно
крамер:  крамера
правда:  правда
парабола:  парабола
путаница:  путаницы
раздавить:  раздавим
запретить:  запрещено
к:  ко
функциидвуха:  функциидвух
черновик:  черновике
емелин:  емелин
вычисленияопределенный:  вычисленияопределенных
задачин:  задачина
системый:  системыи
удовлетворяетлить:  удовлетворяетли
субъективный:  субъективной
довести:  довести
всякий:  всякий
минуть:  минуло
сократиться:  сократилось
тригонометрический:  тригонометрических
казаться:  казалось
остановиться:  остановимся
заданав:  заданав
уверенно:  уверенно
щёлкаться:  щёлкаются
популярный:  популярен
всё:  всё
что:  чём
концовка:  концовка
тройной:  тройные
кирпич:  кирпич
деление:  деления
являться:  является
выполнить:  выполнено
контуруформула:  контуруформула
частное:  частного
график:  график
пациент:  пациента
либо:  либо
рекомендовать:  рекомендую
независимый:  независимые
раскладывать:  раскладываем
разумный:  разумный
я:  мной
корреляция:  корреляции
увидеть:  увидеть
заочник:  заочников
повторять:  повторяем
складывать:  складываем
ждать:  ждёт
