раскрывать:  раскрывать
подмывать:  подмывало
пытаться:  пытаться пытайтесь
чётный:  четную
производный:  производные производная производной производную
предел:  предел пределы пределов
соблюдать:  соблюдайте
числовой:  числовые числовой
путаться:  путаемся
табличный:  табличный
точнее:  точнее
производныенеявно:  производныенеявно
познакомить:  познакомить
значение:  значение значений значения
форма:  формой форме формы форма форму
обозначать:  обозначают обозначает обозначать обозначая
контрольный:  контрольных
чертить:  чертим чертил чертят
находить:  находить находим
обобщение:  обобщение
раздел:  разделами
формула:  формулы формулой формуле формулам формула формулу
смотреть:  см смотрим
канонический:  каноническому
трёхмерный:  трехмерном
два:  две двумя двух
дифференциал:  дифференциалах дифференциала
больший:  наибольшее
обратно:  обратно
один:  одну одно одного одной
любитель:  любители любителей
извлечение:  извлечение извлечения
образно:  образно
рассмотреть:  рассмотрен рассмотрим рассмотренном рассмотренному рассмотренными
утолстить:  утолщенной утолщённой
радиан:  радиан
перевести:  перевести
избавляться:  избавляемся
хороший:  хорош хороший
правый:  правая правой правы
число:  число числами числах числам чисел числа
вогнутостья:  вогнутостьи
становиться:  становится становятся
особенность:  особенность
случай:  случай случаи случая случаев случае случаях
убедиться:  убедиться убедитесь
профессия:  профессию
жарко:  жарко
удобно:  удобно
умножение:  умножения умножение умножением
выполнимый:  выполним
система:  система системе систему системы
группировка:  группировок группировка
познакомиться:  познакомимся познакомились
условнаясходимость:  условнаясходимость
окружность:  окружность окружности
ошибка:  ошибка ошибку
угол:  угол угла углы
александр:  александр
ось:  ось оси осях осями осей осям
сказать:  скажете
который:  которые который которая которое которых
редко:  редко
линейный:  линейные линейная линейных линейной
приходить:  приходит приходите
четверть:  четверти четверть
метод:  метода методы методом метод
алгебраический:  алгебраическим алгебраической алгебраическую алгебраическая алгебраический алгебраические
равенство:  равенство равенством
обычный:  обычных обычные обычной обычными обычный
запись:  записи запись
согласие:  согласия
рассматривать:  рассматриваемый
совет:  совет
балда:  балды
дуоперационный:  дуоперационным
сформулировать:  сформулировать
базис:  базисах базису базис
чертёж:  чертеж чертежу чертежа чертёж чертеже
проверочный:  проверочное
зависимостьвектор:  зависимостьвекторов
снова:  снова
дать:  дам данная дано данной даны
оно:  оно
день:  день
сначала:  сначала
геометрически:  геометрически
страница:  страницу страницы странице
вкус:  вкус
числитель:  числителе числитель числителя
математический:  математическая математические математической
данные:  данных
интеграл:  интеграл интегралов интегралы интеграла интеграле
обозначить:  обозначены обозначен обозначим
урок:  урока уроках урок уроке
разложение:  разложением разложение
уравнение:  уравнению уравнения уравнение уравнений
четвёртый:  четвертое четвёртый четвертого
мочь:  можете могут
переход:  переход
получиться:  получилось получатся
аргумент:  аргументе аргумента аргументом аргументы аргумент
утверждение:  утверждение
желательно:  желательно
цвет:  цветом цвет
первый:  первое первой первого первый
практический:  практических
работа:  работах работа
доступный:  доступен
целесообразно:  целесообразно
малый:  малые наименьших
связь:  связь связи
понятие:  понятием понятия понятие
действительный:  действительный действительной действительную действительными действительного действительное действительные действительных действительная
точка:  точку точки точка точками точке
провести:  проведенным
извлекать:  извлекать
наглядность:  наглядности
нормальный:  нормальное
интегральнаятеорема:  интегральнаятеоремы
корнимногочлен:  корнимногочлена
логарифмический:  логарифмическая
основной:  основные
соответствовать:  соответствующей соответствует
бернулли:  бернулли
единица:  единицу единица единицы
полярный:  полярные полярных полярными полярный полярной
ряд:  ряды ряда ряд ряде рядов
быть:  будете буду будьте будут
уровень:  уровня
значительно:  значительно
попросту:  попросту
доверительный:  доверительные
буква:  буквой букву
эра:  эр
интерпретация:  интерпретацию
заниматься:  занимайтесь
среднееквадратический:  среднееквадратическое
переписать:  перепишу переписать перепишем
комбинационный:  комбинационная
декартов:  декартовой
отмечать:  отмечали отмечаем отмечают отмечал
показатель:  показатель показатели
сопрячь:  сопряженное сопряженными сопряженным сопряженные сопряженных
смешанноепроизведение:  смешанноепроизведение
функция:  функции функция функций
дисперсия:  дисперсия дисперсии дисперсию
проверка:  проверки проверку проверка
множество:  множеством множество множества
таблица:  таблиц таблице таблицу таблицы
школьный:  школьный школьной школьных школьное
образ:  образом
непрерывнаяслучайный:  непрерывнаяслучайная
мнимый:  мнимых мнимой мнимая мнимую мнимые
длина:  длина
материал:  материал материалов материалы
примерчик:  примерчик
немного:  немного
знакопостоянство:  знакопостоянства
алгоритм:  алгоритму
проводить:  проводить
противоположный:  противоположной
градиент:  градиент
предложить:  предложить предложено
линия:  линия линии линиями
вычитаемое:  вычитаемое
ясно:  ясно
полуось:  полуосью полуоси
комбинаторика:  комбинаторике
измениться:  изменится изменилось
случайнаявеличина:  случайнаявеличина
бесконечно:  бесконечно
распечатать:  распечатать
внимательный:  внимательным внимательны внимательные
отмерить:  отмерите
равный:  равны равен
отметить:  отметить отмечены отмечен
прийтись:  пришлось
гребёнка:  гребёнкой
окончательный:  окончательный
обратный:  обратную обратная обратное обратных
третий:  третий третье третьей
готовый:  готовых готовые
просто:  просто
приём:  приём
произвольный:  произвольного произвольных
заметить:  заметит заметили заметить
переставить:  переставить
недосказанность:  недосказанности
тема:  тема темой
нахождение:  нахождения нахождении
частый:  чаще
подобный:  подобных
данный:  данного данном данное
непрерывный:  непрерывных непрерывная
производныефункция:  производныефункции
средний:  средняя
определённость:  определённости
знак:  знаком знаках знака
отщипывать:  отщипываем
называть:  называемая называют
переводить:  переводим
область:  области область
извлечь:  извлечь
далеко:  далеко
математик:  математика
синус:  синуса
переменный:  переменных переменной
пример:  пример примера примеров примере примерами примеры
разность:  разность разности
несовместный:  несовместные
независимыеслучайный:  независимыеслучайные
считать:  считаем считать считаю
модель:  модель модели
минус:  минус минуса минусов минусы
непрерывность:  непрерывность
детализировать:  детализирую детализируем детализировать
способ:  способами способе способом способ
функциис:  функциис
полный:  полной полных полное
зеркало:  зеркало
читатель:  читатели
значит:  значит
пирсон:  пирсона
вопрос:  вопрос вопросы
геометрический:  геометрических геометрическая геометрическую геометрическое
межгрупповой:  межгрупповая
ортогональный:  ортогональное
располагаться:  располагаются располагается располагаться
нсв:  нсв
вроде:  вроде
перемножить:  перемножить
перечертить:  перечертите
упасть:  упал
прочитать:  прочитать
писать:  пишут
отрезка:  отрезке
величина:  величина величин величины
важный:  важный
получить:  полученные полученного получить полученный получи
строчка:  строчку
подмножество:  подмножеством
умножать:  умножаем
сантиметр:  сантиметрах
детерминация:  детерминации
обязательно:  обязательно
следующий:  следующие следующее следующим следующих следующая следующем
начать:  начать начнем
класс:  классе класса
серьёзный:  серьёзное
выполнить:  выполнить выполнив
решаться:  решается
дифференциальныеуравнение:  дифференциальныеуравнения
натуральный:  натуральное натуральную
сеть:  сети
прямой:  прямая прямой прямую
сожаление:  сожалению
комплексный:  комплексной комплексное комплексные комплексная комплексного комплексный комплексными комплексных
стандарт:  стандартов
постоянный:  постоянных
стокс:  стокса
схема:  схема
синий:  синим
многочлен:  многочлена многочленов многочлен
самостоятельно:  самостоятельно
выкладка:  выкладок
степень:  степень степени
квадратный:  квадратного квадратное квадратный квадратные
дробовик:  дробовик
часть:  частью частям часть части
математика:  математике математики
векторный:  векторное векторного
сам:  самом
нечто:  нечто
вероятностия:  вероятностии
аналогичный:  аналогичную
скалярный:  скалярное
задание:  заданиях задание задания
наш:  нашем наши наш
значимость:  значимости
процент:  процентов
анализ:  анализа анализ
частный:  частное частные частный
парный:  парной
координата:  координатами координаты координат координатах
сборник:  сборники
параметрический:  параметрическом параметрической
отсутствие:  отсутствие
раскрыть:  раскрыть
являться:  являетесь являются является
делать:  делаем делать
часто:  часто
глазок:  глазок
получаться:  получается
надеяться:  надеюсь
координатный:  координатная координатных координатной координатные
решение:  решение решением решения решений
форум:  форум форуме
записывать:  записывать записывают
книга:  книги книга
обед:  обеда
вспомнить:  вспомнить
нечётность:  нечетностью нечетность
разложить:  разложим разложить
устно:  устно
выглядеть:  выглядеть
вектор:  векторы векторов
вращение:  вращения
упрощение:  упрощение
именно:  именно
принять:  принято
копирование:  копирование
изображаться:  изображаются
разрыв:  разрыва
выражение:  выражения выражением выражение
отблагодарить:  отблагодарить
байес:  байеса
простой:  проще простейших простой
решать:  решать
параграф:  параграфов параграфы параграфа параграфе параграфах
выяснить:  выясним
точность:  точности
результат:  результат результате
теория:  теория теории
отсутствовать:  отсутствует
забавный:  забавного забавном
бог:  боже
умножить:  умножить
двумерный:  двумерная двумерное
задать:  заданной задать задайте
тело:  тела
циркуляция:  циркуляция
непосредственно:  непосредственно
плоскость:  плоскости плоскость
циркуль:  циркулем
общий:  общим общая общую
поздний:  позже
стандартный:  стандартном стандартной
определителяй:  определителяи
выносить:  выносим
согласно:  согласно
закон:  законы
дробь:  дроби дробь дробей
корень:  корня корнями корни корень корней корнях
действие:  действий действия действие
проделать:  проделать
вероятность:  вероятностей вероятность вероятности
формульный:  формульной
любой:  любое любой любого любых любом
уравненийв:  уравненийв
составной:  составная
ограничиться:  ограничусь
называться:  называются называется
количество:  количества
грин:  грина
эйлер:  эйлера
возведение:  возведения возведении возведение
закачать:  закачать
известный:  известной известным
невозможно:  невозможно
дискретный:  дискретный
знакочередоваться:  знакочередующиеся
масштаб:  масштаб масштабе
отрицательный:  отрицательных отрицателен
любимый:  любимой любимого
член:  член
принцип:  принцип принципе принципу
смущать:  смущать
заметно:  заметно
справочный:  справочные
распространить:  распространенных
припомнить:  припомню
практически:  практически
применение:  применении
подумать:  подумайте
сложный:  сложной сложные сложных
рассмотрение:  рассмотрению
работать:  работает
фурье:  фурье
поле:  поля поле
зайти:  зашла
гипотеза:  гипотез гипотеза гипотезы
свойство:  свойства
момент:  момент
исходный:  исходной
исследование:  исследование
оставлять:  оставлять
весь:  всем всеми всём
проблема:  проблем
вариация:  вариации
пойти:  пойдет пойти
основа:  основы
мало:  мало
интервал:  интервалы интервалом
перестановка:  перестановки
кош:  коши
такой:  таком таким такие такое такому
выше:  выше
голова:  головы
составлять:  составляет
упоминаться:  упоминалось
чайник:  чайников чайником
смена:  сменой
вычисленияс:  вычисленияс
модуль:  модуля модули модулем модуль
матричный:  матричные матричных матричный
однородный:  однородные однородным
вычислить:  вычислить
очень:  очень
матрица:  матрицу матрицы матрицами
испытанияй:  испытанияи
интегралыть:  интегралыв
научиться:  научимся научиться
перегруппировка:  перегруппировка
домножить:  домножить
помощь:  помощью помощь
вариационный:  вариационный
элементарный:  элементарных
стандартно:  стандартно
казаться:  кажется
чистовик:  чистовик
блог:  блог
высокий:  высших высшей высшая
сливаться:  сливаются
произведение:  произведения произведение
помнить:  помнить помните помним
год:  лет
нечётный:  нечетную
пространство:  пространстве
удобный:  удобный
курс:  курс курса
меняться:  меняется
напоследок:  напоследок
эх:  эх
сообщить:  сообщите
измерить:  измерьте измерить
перейти:  перейдем
сделать:  сделать сделано сделали
аналитический:  аналитическая аналитической
понижение:  понижение понижением
ненулевой:  ненулевой
центр:  центр
перескок:  перескоков
объяснение:  объяснений
транспортир:  транспортиром транспортира транспортир
экспонент:  экспоненты
квадрат:  квадрата квадрат квадратов
расположить:  расположим расположены
браковать:  бракуют
нехитрый:  нехитрым
изобразить:  изобразить изобразим
возвести:  возвести
затем:  затем
построение:  построение
вспоминать:  вспоминаем
осуществляться:  осуществляется
линейнойкорреляционный:  линейнойкорреляционной
закрепить:  закрепить
почему:  почему
распределениякритерия:  распределениякритерий
кратко:  кратко
дальнейший:  дальнейшее
беспокоиться:  беспокойтесь
нехороший:  нехорошей
показательный:  показательной показательное показательную показательная
несобственный:  несобственные
выполнять:  выполнять
откуда:  откуда
проставлять:  проставлять
касательная:  касательная
ответ:  ответ ответы
задачис:  задачис
жирный:  жирной
закрытый:  закрыта
правило:  правила правилу правило
функциия:  функциии
степенной:  степенного степенные
деление:  делением деление деления
определить:  определён
функцийдвуха:  функцийдвух
выборка:  выборке
красный:  красным
функцийнесколький:  функцийнескольких
чисто:  чисто
градус:  градусов градусы градусах
понять:  понять
множественнойлинейный:  множественнойлинейной
каждый:  каждой каждый
распределение:  распределение распределения
тригонометрический:  тригонометрические тригонометрической тригонометрическая тригонометрических тригонометрическую
задачипо:  задачипо
обыкновенный:  обыкновенные
громоздкий:  громоздком
востребовать:  востребованную
приблизить:  приближенные
видно:  видно
сложить:  сложить
хит:  хит
идти:  идет
паника:  паники
примечание:  примечание
зависимый:  зависимые
отклонение:  отклонение
избавиться:  избавиться
что:  чему
кто:  кому
случайный:  случайных случайные
предварительно:  предварительно
дуга:  дуги
частность:  частности
рассчитать:  рассчитаем
отрезкать:  отрезкав
знакомый:  знакомой знакомы знакомое
дивергенция:  дивергенция
множитель:  множителей множители
разбегаться:  разбегаемся
сайт:  сайт сайты сайта
графика:  графики графика
оформление:  оформления оформлении
таков:  такова
трюк:  трюк
предлагаться:  предлагается
какой:  какому
возрастание:  возрастание
эмпирический:  эмпирические
найтись:  нашлось
арктангенс:  арктангенса
аналогично:  аналогично
иррациональный:  иррациональных иррациональные
определение:  определению определения
квадратичнуюформ:  квадратичнуюформу
сокращать:  сокращаем
карта:  карта
маленький:  маленький
пригодный:  пригодным
вычисление:  вычисления вычисление
гипербола:  гипербола
равно:  равно
они:  ними
мелочиться:  мелочиться
коэффициент:  коэффициентами коэффициент
убавить:  убавить
подробный:  подробных
муавр:  муавра
логика:  логики
спирмена:  спирмена
определять:  определяют
схожий:  схож
вид:  виду виды вид виде вида
комментарий:  комментариях
возникать:  возникает
св:  св
самый:  самый самое
второй:  второго второй вторую
иметь:  имеет иметь
сумма:  суммы сумму сумма
достаточно:  достаточно
преобразование:  преобразования преобразований
универсальный:  универсальным универсальнее
диффура:  диффурами
узнать:  узнать
скобка:  скобок скобки
косинус:  косинуса
использовать:  используем используя использовать используйте
представлять:  представляет представляют
статистика:  статистика
бумага:  бумаге
подставлять:  подставляем подставляя
бэ:  бэ
биномиальный:  биномиальное
записаться:  запишется
редкий:  реже
линиюв:  линиюв
расписать:  распишу
самостоятельный:  самостоятельного
отношение:  отношении
простор:  просторах
везде:  везде
путь:  путями
решить:  решить
дуприближённо:  дуприближённо
асимптота:  асимптоты
событие:  события
пифагор:  пифагора
повторный:  повторные
воздержаться:  воздержусь
порядок:  порядок порядке порядку порядка порядков
рукопись:  рукописях
найти:  найденные найдем найден найти
состоять:  состоит
тетрадь:  тетрадь
грязноватый:  грязновато
фнп:  фнп
простейшее:  простейшие
знаменатель:  знаменателя знаменатель знаменателю знаменателе
конец:  конце
куба:  куба
двойной:  двойные двойной
несобство:  несобств
настать:  настал
нелинейный:  нелинейная
линейка:  линейкой линейку
преобразованиеквадратичный:  преобразованиеквадратичной
напрашиваться:  напрашивается
функциональный:  функциональные
ориентация:  ориентацией
сто:  сто
абсолютный:  абсолютная
специальный:  специальных специальную
разный:  разными
встречаться:  встречаются встречается
получать:  получая получаем
сложенияй:  сложенияи
полуплоскость:  полуплоскости полуплоскость
сложение:  сложение сложению
регрессия:  регрессии регрессия
упростить:  упростить
вычитание:  вычитание
расстояние:  расстояние расстояния
рассказать:  расскажу
исчисление:  исчисления
отделить:  отделить
локальный:  локальная
сократить:  сокращенная сокращенного
ожидание:  ожидание
лаплас:  лапласа
перегиб:  перегиба
предыдущий:  предыдущем предыдущего
сходимость:  сходимости сходимость
представить:  представьте представленных представить представлено представлю
задача:  задачи задач
оказаться:  оказаться
ду:  ду
далее:  далее
формальный:  формальный
неопределённый:  неопределенный неопределенном
запомнить:  запомним
собственный:  собственные
признак:  признак признаки
соображение:  соображений
правильный:  правильный правильной
поэтому:  поэтому
практика:  практике
пункт:  пункте
коль:  коль
асимметрия:  асимметрия
скажем:  скажем
главный:  главную
представимый:  представим
сводиться:  сводящиеся
замена:  замены
составить:  составим
например:  например
решенияопределённый:  решенияопределенных
интересный:  интересный
хотя:  хотя
подобрать:  подобрал
наворотить:  навороченный
порешать:  порешать
другой:  другими другие другого
коэффициентковариация:  коэффициентковариации
желание:  желании
теорема:  теореме теоремы
приводить:  приводить
лопиталя:  лопиталя
крайне:  крайне
обычно:  обычно
дорога:  дорогу
опилка:  опилками
возводиться:  возводится
ставить:  ставим
поляформула:  поляформула
фехнера:  фехнера
эффективный:  эффективные
условный:  условные
эллипс:  эллипс
ноль:  ноль
требование:  требовании
хотеть:  хотите
даламбер:  даламбера
факт:  факт
целый:  целые
повторнойя:  повторнойи
ровно:  ровно
сложность:  сложностей сложности
ранг:  ранг
кривая:  кривой
тяжестиплоска:  тяжестиплоской
двучлен:  двучлен
держать:  держите
понятный:  понятнее
касаться:  касается
сидеть:  сидят
построить:  построить построим
знаменитый:  знаменитое знаменитым
внимание:  внимание
графический:  графического
лейбниц:  лейбница
привести:  приведу привести
неравенство:  неравенства
поток:  поток
отдельный:  отдельная
медиана:  медиана
записать:  записать
направлениюй:  направлениюи
гостевой:  гостевая
скоро:  скоро
кроме:  кроме
чётность:  четность
основание:  основание
понятно:  понятно
никакой:  никакой
знание:  знаний
главное:  главное
внутригрупповаяй:  внутригрупповаяи
зависеть:  зависит
алгебра:  алгебры
оборот:  оборотов оборот
наоборот:  наоборот
существовать:  существует существуют
прямоугольник:  прямоугольников
эксцессэмпирический:  эксцессэмпирического
слагаемое:  слагаемых
оценка:  оценка оценки
криволинейный:  криволинейные
различный:  различных
библиотека:  библиотека
знакомиться:  знакомятся
настолько:  настолько
возможность:  возможности
наименьшеезначение:  наименьшеезначения
сила:  силы
вычислимый:  вычислим
запросто:  запросто
позабыться:  позабылось
выяснять:  выясняем
разобрать:  разберем
системылинейный:  системылинейных
нужно:  нужно
кой:  коем
зависимость:  зависимость
замкнутый:  замкнутому
возможный:  возможны
должный:  должен
очевидный:  очевидно
отмерять:  отмеряем
заглавный:  заглавную
площадьс:  площадьс
большинство:  большинстве
убыванией:  убываниеи
повышенный:  повышенной
статистический:  статистическая статистические
также:  также
интегрирование:  интегрирование
легко:  легко
рациональный:  рациональные
пока:  пока
нуль:  нулю нуля
привычный:  привычной
интервальный:  интервальный
соответственно:  соответственно
зелёный:  зеленым
уехать:  уехать
вообще:  вообще
оценкия:  оценкии
неявный:  неявной
несобственныхинтеграл:  несобственныхинтегралов
вероятностибиномиальный:  вероятностибиномиального
школьник:  школьнику
род:  рода
гаусс:  гаусса
лежать:  лежит
честно:  честно
трогать:  трогаем
полезно:  полезно
особый:  особых
точно:  точно
экстремальный:  экстремальные
обозначаться:  обозначаются
нормаль:  нормали
определитель:  определитель
выпуклость:  выпуклость
элемент:  элементы
начало:  начала
интересно:  интересно
значенияй:  значенияи
отличаться:  отличаются
справедливо:  справедливо
справедливый:  справедлива
нужный:  нужной
кстати:  кстати
классическоеопределение:  классическоеопределение
инормаль:  инормаль
радиус:  радиуса радиус
пирамида:  пирамида
информация:  информацию
находиться:  находятся
прокрутка:  прокруткой
автор:  автор автора
поставить:  поставит поставить
усвоиться:  усвоятся
дифференциальный:  дифференциальные
уравненияс:  уравненияс
онлайн:  онлайн
геометрия:  геометрии геометрия
неотрицательный:  неотрицательна
использоваться:  используется
новый:  новому нового
произвольныйтройный:  произвольныйтройной
нуждаться:  нуждается
дизайн:  дизайна
это:  это
поляй:  поляи
опечатка:  опечатку
десять:  десять
параметр:  параметр
речь:  речь
методомоперационный:  методомоперационного
бесповторный:  бесповторной
лишний:  лишних
правильно:  правильно
компания:  компания
л:  л
обойтись:  обойтись
ед:  ед
взять:  взять
касательный:  касательных
актуальный:  актуальны
типовыхзадача:  типовыхзадач
воспользоваться:  воспользоваться
ранговойкорреляция:  ранговойкорреляции
рука:  руки
строиться:  строится
жизнь:  жизни
переставлять:  переставлять
расчёт:  расчет
сколько:  сколько
исследовать:  исследовать
нетрудно:  нетрудно
поверхность:  поверхности
дискриминант:  дискриминант
линейныйкоэффициент:  линейныйкоэффициент
практикум:  практикум
брать:  берем
несобственныйинтеграл:  несобственныйинтеграл
безобразие:  безобразия
доступно:  доступно
удобство:  удобства
единый:  единое
учиться:  учимся
задавать:  задаваемые
ипример:  ипримеры
требоваться:  требуется требовалось
поверхностный:  поверхностные
фигура:  фигуры
пуассон:  пуассона
изучение:  изучению
однако:  однако
устный:  устное
фактически:  фактически
дополнительный:  дополнительных
намертво:  намертво
математическоеожидание:  математическоеожидание
успешно:  успешно
разновидность:  разновидность
школа:  школа
напомнить:  напомню
неоднородный:  неоднородные
необходимо:  необходимо
взяться:  взялось
рубить:  рубить
думать:  думаю
положительный:  положительной
кратное:  кратные
рецензент:  рецензент
методический:  методический
системудифференциальный:  системудифференциальных
уметь:  уметь
последовательность:  последовательностей
квадратичный:  квадратичные
объём:  объем
единственный:  единственная единственный единственного
проверить:  проверить
измерение:  измерение
тригонометрия:  тригонометрии
равняться:  равняется
поскольку:  поскольку
гипергеометрическоераспределение:  гипергеометрическоераспределение
извлекаться:  извлекается
подробно:  подробно
равномерный:  равномерная равномерное
треугольный:  треугольная
пожалуйста:  пожалуйста
принимать:  принимать принимает
записываться:  записывается
следовать:  следует
себя:  собой
однозначно:  однозначно
вариант:  варианта
сразу:  сразу
функциюкомплексный:  функциюкомплексной
напоминать:  напоминаю
вывести:  вывести
заодно:  заодно
мода:  мода
свойстваэлементарный:  свойстваэлементарных
незачёт:  незачета
краткий:  краткое
калькулятор:  калькулятор калькуляторе
напугать:  напугал
оба:  оба
учебный:  учебной
определённый:  определенный определенного
действительно:  действительно
бородатый:  бородатую
экстремум:  экстремумы
горнера:  горнера
отмечаться:  отмечалось
упомянуть:  упомянутый
подкоренной:  подкоренного
функцийв:  функцийв
допускать:  допускают
место:  местами
техника:  техника
поднять:  поднимем
лёгкий:  легче
проводиться:  проводилась
три:  трёх
дискретнойслучайный:  дискретнойслучайной
короткий:  короткий
упасти:  упаси
последний:  последних
крамер:  крамера
основный:  основных
освоение:  освоения
правда:  правда
парабола:  парабола
строго:  строго
пёстрый:  пёстрая
повторимый:  повторим
преподаватель:  преподаватели
внешний:  внешний
запретить:  запрещено
функциидвуха:  функциидвух
емелин:  емелин
оформлять:  оформлять
немножко:  немножко
вычисленияопределенный:  вычисленияопределенных
задачин:  задачина
замечательный:  замечательные
системый:  системыи
удовлетворяетлить:  удовлетворяетли
приходиться:  приходится
учитывать:  учитываем
некоторый:  некоторое
перестановочный:  перестановочно
заданав:  заданав
уверенно:  уверенно
всё:  всё
клетчатый:  клетчатой
тройной:  тройные
контуруформула:  контуруформула
график:  график
дело:  деле дело
нулевой:  нулевой
приступить:  приступили
просуммировать:  просуммировать
простота:  простоты
либо:  либо
рекомендовать:  рекомендую
эн:  эн
пользоваться:  пользуйтесь
независимый:  независимые
забивание:  забивание
подход:  подход
рассмешить:  рассмешу
я:  мной
студент:  студенты
корреляция:  корреляции
прежде:  прежде
заочник:  заочников
говорить:  говоря
повторять:  повторяем
литература:  литературе
