низкий:  низшим низший
скобка:  скобками скобкам скобок скобки скобка скобках скобке
техника:  технику
формальный:  формальна формальной формальном
сколь:  сколь
неоднократно:  неоднократно
производный:  производные производная производной производную
предел:  предел пределами пределы пределов
конъюнкция:  конъюнкция конъюнкции конъюнкцию конъюнкцией
доказать:  докажем доказана доказано доказанного доказали доказать
взрослый:  взрослой
справедливый:  справедливой справедливы справедлива
числовой:  числовые
точнее:  точнее
производныенеявно:  производныенеявно
значение:  значение значений значения
скорее:  скорее
входить:  входить входит входят
сила:  силе силу силы
формула:  формулы формулами формулой формуле формула формул формулу
смотреть:  см смотрим
русский:  русским
сухо:  сухо
канонический:  каноническому
два:  две двумя двух
дифференциал:  дифференциалах дифференциала
больший:  наибольшее
нередко:  нередко
известно:  известно
контрапозиция:  контрапозиции
один:  одну одно одна одном
подробный:  подробные подробными
пройти:  пройдите
сам:  самого самом
число:  число числами числа
вогнутостья:  вогнутостьи
выяснить:  выяснить
позволять:  позволяет
формулировка:  формулировки формулировка
математический:  математическую математическая математические математической
убедиться:  убедиться убедимся убедитесь
профессия:  профессию
некорректно:  некорректно
перечислить:  перечислить перечислю
удобно:  удобно
умножение:  умножения умножение
предмет:  предмет предметам
дуб:  дубы дуб дубом
система:  система системе системах систему системы
группировка:  группировок группировка
условнаясходимость:  условнаясходимость
александр:  александр
душа:  душу
гарантировать:  гарантированы
разночтение:  разночтений
перестановочность:  перестановочность
доказательство:  доказательстве доказательств доказательство доказательства доказательством доказательству
стройность:  стройности
который:  которые который которая которое которого которым которых которой
закон:  закон законы законом законами закону закона
линейный:  линейные линейная линейных линейной
осуществлять:  осуществлять
алгебраический:  алгебраическим алгебраических
правый:  правой правую
любой:  любые любое любая любую любом
проснуться:  проснуться
быть:  суть буду будем
пожарный:  пожарный
улица:  улице
согласие:  согласия
знать:  знают знает
дуоперационный:  дуоперационным
сформулировать:  сформулировать сформулируем
базис:  базисах базису базис
зависимостьвектор:  зависимостьвекторов
шаг:  шагу шагах шаге шаг
снова:  снова
оно:  оно
сначала:  сначала
метод:  методы методом метод
страница:  страницу
данные:  данных
комбинаторика:  комбинаторики комбинаторике
интеграл:  интеграл интегралов интегралы интеграла интеграле
урок:  урока уроке
сдать:  сдал
разложение:  разложением разложение
ставить:  ставит ставить ставим
затейливый:  затейливом
прозрачный:  прозрачно
уравнение:  уравнению уравнения уравнение уравнений
играть:  играют
переход:  переход перехода
получиться:  получилось получился
утверждение:  утверждение утверждению
совпадать:  совпадают совпадает
вводный:  вводном
существо:  существу
очередь:  очередь
подлежать:  подлежат
малый:  малые наименьших
связь:  связь
понятие:  понятием понятиями
плохо:  плохо
нормальный:  нормальное
интегральнаятеорема:  интегральнаятеоремы
фирменный:  фирменный
корнимногочлен:  корнимногочлена
логарифмический:  логарифмическая
внешний:  внешним внешние
основной:  основные
масляный:  масляное
бернулли:  бернулли
единица:  единицу единица единицы единиц
полярный:  полярные полярных полярной
ряд:  ряды ряда ряд рядов
уровень:  уровня
истинность:  истинности истинность истинностью
равносильный:  равносильными равносильное равносильны
доверительный:  доверительные
смысл:  смысле смысл
среднееквадратический:  среднееквадратическое
отрицание:  отрицания отрицание
импликационный:  импликационная
формирование:  формирования
говориться:  говорится
договориться:  договоримся
комбинационный:  комбинационная
следовать:  следуют следует
смешанноепроизведение:  смешанноепроизведение
функция:  функции функция функций функцию
дисперсия:  дисперсия дисперсии дисперсию
постараться:  постарайтесь
знакомый:  знакомого знакомая знакомые знакомы
таблица:  таблиц таблица таблицу таблицы таблицей
школьный:  школьный школьном
мы:  нам нами
образ:  образом
целый:  целой
непрерывнаяслучайный:  непрерывнаяслучайная
другой:  других другие другим другую
четыре:  четыре
прямо:  прямо
длина:  длина
материал:  материал материала материалов материале материалы
немного:  немного
мочь:  могут
знакопостоянство:  знакопостоянства
описывать:  описывающая
противоположный:  противоположной противоположная
изменить:  изменить
градиент:  градиент
линия:  линия линии линиями
вспомнить:  вспомним
матлогик:  матлогике матлогику
банальный:  банальные
случайнаявеличина:  случайнаявеличина
тожество:  тожество
свой:  своего
бесконечно:  бесконечно
распечатать:  распечатать
форма:  формы
содержательный:  содержательным содержательный содержательными содержательном содержательной
отметить:  отметить
статья:  статьи статье
фраза:  фразу фразы фраза
алгебра:  алгебре алгебры
обратный:  обратную обратная обратной
рассматривать:  рассматривать
сыро:  сыро
завтра:  завтра
готовый:  готовых
просто:  просто
получить:  получены получена полученный полученному получи
весёлый:  веселой
ещё:  ещё
вернуться:  вернёмся вернуться
назначение:  назначения
переставить:  переставить
порядок:  порядком порядок порядке порядка порядков
исключить:  исключённого исключенного
тема:  тема тему
преподнести:  преподнёс
картинка:  картинка
возможный:  возможных возможные
читатель:  читателей
бумага:  бумагу
данный:  данного данную данном данный
умножать:  умножать умножаем
непрерывный:  непрерывных непрерывная
убирать:  убираем
производныефункция:  производныефункции
средний:  средняя средним
столбцы:  столбцы столбцах
противоречие:  противоречие противоречия противоречием
заслать:  зашли
область:  области область
ссылка:  ссылке
далеко:  далеко
предположим:  предположим
обычный:  обычной обычного
математик:  математика
переменный:  переменных переменной переменные переменными
пример:  пример примерам примерами примеры
упрощение:  упрощения
дождь:  дождь дождя
несовместный:  несовместные
независимыеслучайный:  независимыеслучайные
нравиться:  нравится
выполнение:  выполнения выполнении выполнение
грек:  греков
следовательно:  следовательно
модель:  модель модели
непрерывность:  непрерывность
небольшой:  небольшое
функциис:  функциис
угодный:  угодно
таков:  таков
право:  правом
полный:  полной полных полное
зеркало:  зеркало
второй:  втором второго второй вторую
значит:  значит
пирсон:  пирсона
вопрос:  вопрос вопросы
межгрупповой:  межгрупповая
ортогональный:  ортогональное
разборка:  разборки
располагаться:  располагаются
нсв:  нсв
стиль:  стиле
некий:  некий
проанализировать:  проанализировать
упасть:  упал
ход:  ходе
отрезка:  отрезке
остаться:  оставшихся оставшиеся
условиться:  условимся
теорема:  теоремой теоремы теорема
величина:  величина величин величины
одновременно:  одновременно
истина:  истина истины
запись:  запись
измениться:  изменился
коммутативность:  коммутативность коммутативностью коммутативности
пэ:  пэ
она:  неё
допустимый:  допустимо
анализировать:  анализировать
детерминация:  детерминации
избежать:  избежать
обязательно:  обязательно
усилить:  усилить
следующий:  следующие следующее следующую следующего следующая
начать:  начать начните
запомнить:  запомнить
важный:  важные важная
выполнить:  выполнить
дифференциальныеуравнение:  дифференциальныеуравнения
название:  названия
дизъюнкция:  дизъюнкция дизъюнкцию дизъюнкции
прямой:  прямая прямой прямую
дистрибутивный:  дистрибутивные дистрибутивный
контролировать:  контролировать
постоянный:  постоянных
стокс:  стокса
схема:  схема
превращать:  превращаем
самостоятельно:  самостоятельно
тождество:  тождество тождестве тождеств тождества
неформальный:  неформальной неформальную
дробовик:  дробовик
математика:  математике математики
векторный:  векторное векторного
вероятностия:  вероятностии
скалярный:  скалярное
совершенно:  совершенно
наш:  нашем нашим наш нашей наша
значимость:  значимости
записать:  записал запишем записать
анализ:  анализа анализ
её:  её
частный:  частное частные
парный:  парной
перечислять:  перечислять
последний:  последнего последних
логический:  логического логическая логических логической логическим логическое логические логическую
несколько:  несколько несколькими
сборник:  сборники
пренебрежение:  пренебрежение
верно:  верно
параметрический:  параметрическом параметрической
раскрыть:  раскрыть
часто:  часто
выполняться:  выполняются выполняется
табличка:  табличку
получаться:  получается
комбинация:  комбинации комбинаций
указательный:  указательным
слабый:  слабой слабее
базовый:  базовыми базовые
антикоммутативный:  антикоммутативно
нота:  ноте
решение:  решение решением решения решений
вещь:  вещами вещь вещам
форум:  форум форуме
книга:  книги книга
ответить:  ответил
дерево:  деревья деревом
менять:  менять меняет меняют меняем
теоретический:  теоретического
настать:  настало
задание:  задание задания
вектор:  векторы векторов
забыть:  забыл
рекурсивный:  рекурсивным
наподобие:  наподобие
вращение:  вращения
отрицать:  отрицаем
именно:  именно
копирование:  копирование
давать:  давайте
использовать:  используют использую используем использовать используйте
предикат:  предикатов
разрыв:  разрыва
выражение:  выражения
предыдущий:  предыдущей
использоваться:  используются
машина:  машин
роль:  роль
стесняться:  стесняйтесь
значок:  значок значки
грубо:  грубо
заполнять:  заполняем
отблагодарить:  отблагодарить
являться:  являются являться является
ложь:  лжи ложь
байес:  байеса
кажущийся:  кажущейся
приписывать:  приписываем
решать:  решать
класс:  класса
результат:  результат результате результату результаты
теория:  теория теории
вывод:  выводы вывод
продолжение:  продолжение
ранний:  раньше
называть:  называют называть
структура:  структуру
относиться:  относиться относится
двумерный:  двумерная
язык:  языком
задать:  заданной задайте
тело:  тела
циркуляция:  циркуляция
слева:  слева
муссироваться:  муссировался
фикция:  фикция
плоскость:  плоскости плоскость
общий:  общим общая общем общее общую
забегать:  забегая
поздний:  позже
определителяй:  определителяи
согласно:  согласно
дважды:  дважды
справа:  справа
соблюдать:  соблюдать
качество:  качестве
действие:  действий действия действие
оригинальный:  оригинальнее
пункт:  пункт
обширный:  обширную
ситуация:  ситуацию
столбец:  столбец столбцам столбца
вероятность:  вероятностей вероятность вероятности вероятностью
заключение:  заключение
уравненийв:  уравненийв
ограничиться:  ограничусь
называться:  называются называется
переписать:  переписать
грин:  грина
эйлер:  эйлера
озвучить:  озвученной озвучено
направо:  направо
дискретный:  дискретный
знакочередоваться:  знакочередующиеся
принцип:  принцип принципе
подогнать:  подогнать
произвольный:  произвольных
сложный:  сложной сложный сложную сложные сложных
формализм:  формализм
фурье:  фурье
поле:  поля
гипотеза:  гипотез гипотеза гипотезы
свойство:  свойства свойство
частица:  частицы
ложный:  ложной ложным ложна ложно ложны
прочитать:  прочитали
исследование:  исследование
точка:  точки точке
первый:  первую первой первом первого
высказывание:  высказываний высказыванием высказывания высказывание
вариация:  вариации
основа:  основы основу основам
студент:  студент студентов
интервал:  интервалы
перестановка:  перестановки перестановка
равносильность:  равносильностями равносильности равносильность
кош:  коши
такой:  таком таким такие такое такого таких
эквивалентный:  эквивалентны
выше:  выше
чайник:  чайников
вычисленияс:  вычисленияс
глаз:  глазами
некоторый:  некоторым
матричный:  матричные матричных матричный
заметить:  заметили
однородный:  однородные однородным
записывать:  записываем
вычислить:  вычислить
раскрытие:  раскрытии
очень:  очень
избавляться:  избавляются
матрица:  матрицу матриц матрицы матрицами
этап:  этапе
испытанияй:  испытанияи
интегралыть:  интегралыв
сильный:  сильные сильная
перегруппировка:  перегруппировка
логика:  логика логику логики логике
помощь:  помощью
идемпотентность:  идемпотентности
стать:  стала
морган:  моргана
вариационный:  вариационный
источник:  источнике
элементарный:  элементарных элементарное элементарные
проговорить:  проговорите
стандартно:  стандартно
неразличимый:  неразличимы
блог:  блог
высокий:  высших высшей высшая
рассуждать:  рассуждать
импликация:  импликации импликацию импликаций импликация
пространство:  пространстве
удобный:  удобный удобнее
курс:  курс курсе
посвятить:  посвящённом
восприятие:  восприятие
координата:  координаты координат координатах
операция:  операциям операция операций операцию операции
меняться:  меняется
помогать:  помогают
сообщить:  сообщите
основный:  основным
аналитический:  аналитическая аналитической
понижение:  понижение понижением
мой:  моим
левый:  левой левых левую
центр:  центр
видеть:  видеть видите
обоснованный:  обоснованного
равный:  равные
совпасть:  совпала совпали
сложение:  сложения сложение
ожидать:  ожидают
сверяться:  сверяемся
затем:  затем
построение:  построение
вспоминать:  вспоминаем
осуществляться:  осуществляется
линейнойкорреляционный:  линейнойкорреляционной
время:  время
закрепить:  закрепить
распределениякритерия:  распределениякритерий
предстоять:  предстоит
несправедливый:  несправедливо несправедлив
несобственный:  несобственные
провести:  проведём
истинный:  истинной истинным истинная истинна истинны
аналогия:  аналогия
зрение:  зрения
вариант:  варианты варианта
процесс:  процесс
элементарность:  элементарности
палец:  пальцем
касательная:  касательная
ответ:  ответ ответы
задачис:  задачис
поглощение:  поглощения
друг:  другом
разобраться:  разобраться
правило:  правила правилу правило
функциия:  функциии
завершать:  завершающем
степенной:  степенного степенные
возможно:  возможно
функцийдвуха:  функцийдвух
набор:  наборы наборе набора
вовсю:  вовсю
выборка:  выборке
прикладной:  прикладное
функцийнесколький:  функцийнескольких
повторение:  повторениями
тривиальный:  тривиально
налево:  налево
растение:  растением растения растение
множественнойлинейный:  множественнойлинейной
остроумный:  остроумное
классика:  классика
единичный:  единичный
распределение:  распределение распределения
сводить:  сводят
этот:  этому эта
квадратный:  квадратных квадратные
построить:  построена построить
конкретный:  конкретных
задачипо:  задачипо
независимый:  независимых независимые
востребовать:  востребованную
приблизить:  приближенные
примечание:  примечание
зависимый:  зависимые
отклонение:  отклонение
произведение:  произведение
случайный:  случайных случайные
дуга:  дуги
частность:  частности
отрезкать:  отрезкав
дивергенция:  дивергенция
похожий:  похожих
множитель:  множителей
сайт:  сайт сайты сайта
графика:  графики графика
идти:  идёт
причина:  причине
возрастание:  возрастание
эмпирический:  эмпирические
третий:  третьего
найтись:  нашлось
потребоваться:  потребуется
иррациональный:  иррациональных
определение:  определению определение определения
квадратичнуюформ:  квадратичнуюформу
карта:  карта
общеобразовательный:  общеобразовательного
гипербола:  гипербола
зачёт:  зачётом
окраска:  окраску
они:  ними ими
спирмена:  спирмена
обратить:  обратили обратите
вид:  виду виды виде вида
оказаться:  оказалось окажется
аргумент:  аргументы аргументов
дорого:  дорого
близко:  близко
лишь:  лишь
комментарий:  комментариями комментарии комментариев
ассоциативность:  ассоциативность
св:  св
самый:  самый самые самое
выход:  выходе выход
иметь:  имеет
приоритет:  приоритетом приоритет приоритету приоритета
пара:  пара
показательный:  показательное
преобразование:  преобразования преобразование преобразований
соответствовать:  соответствует
создать:  создать
диффура:  диффурами
соответствующий:  соответствующие
подразумевать:  подразумевает
вытрясти:  вытрясет
вычисление:  вычисление
статистика:  статистика
эквиваленция:  эквиваленции эквиваленцией эквиваленцию эквиваленция
вперёд:  вперёд
латынь:  латынь
биномиальный:  биномиальное
озвучивать:  озвучивать
линиюв:  линиюв
перескок:  перескоки
составить:  составьте составим составить
отношение:  отношении
хотеться:  хочется
философия:  философии
опускать:  опускал
скучно:  скучно
решить:  решить
занумеровать:  занумеровать
раздел:  раздела
дуприближённо:  дуприближённо
подход:  подхода
икс:  иксу
асимптота:  асимптоты
заставить:  заставило
крохотный:  крохотным
событие:  события
пифагор:  пифагора
повторный:  повторные
различный:  различны различных
тождественно:  тождественно
применить:  применено
б:  б
преобразовать:  преобразуем
вход:  входе
фнп:  фнп
простейшее:  простейшие
примитивный:  примитивным
конец:  конце
часть:  частям часть части
двойной:  двойные двойной двойного
компактный:  компактнее
несобство:  несобств
классический:  классической
нелинейный:  нелинейная
означать:  означают
три:  трём трёх
преобразованиеквадратичный:  преобразованиеквадратичной
напрашиваться:  напрашивается
функциональный:  функциональные функциональном
сто:  сто
геометрический:  геометрическая геометрическое
абсолютный:  абсолютная
упрощать:  упрощайте
сложенияй:  сложенияи
регрессия:  регрессии регрессия
закономерный:  закономерное
ориентироваться:  ориентируетесь
упростить:  упростить упростим
требовать:  требуют
исчисление:  исчисления
вложить:  вложить
локальный:  локальная
настоятельно:  настоятельно
сказать:  сказать скажу скажет
ожидание:  ожидание
лаплас:  лапласа
перегиб:  перегиба
сходимость:  сходимости сходимость
справедливость:  справедливости
задача:  задачи задач
ду:  ду
далее:  далее
делать:  делать
обладать:  обладает
коэффициент:  коэффициент
неопределённый:  неопределенный неопределенном
дробь:  дробей
инструкция:  инструкции
собственный:  собственные
признак:  признак признаки
соображение:  соображений
поэтому:  поэтому
влечь:  влечёт
вместо:  вместо
разумеется:  разумеется
безусловно:  безусловно
объять:  объять
жанр:  жанра
никакой:  никаких никакое
противный:  противном
место:  местам местами
асимметрия:  асимметрия
вслух:  вслух
главный:  главную
сводиться:  сводящиеся
собственно:  собственно
замена:  замены
алгоритм:  алгоритма
нисколько:  нисколько
убрать:  убрать
например:  например
решенияопределённый:  решенияопределенных
пренебрежительно:  пренебрежительно
экзамен:  экзамен
действительность:  действительности
хотя:  хотя
многочлен:  многочленов
коэффициентковариация:  коэффициентковариации
запасть:  запал
перестановочный:  перестановочна
строгий:  строгий
перечисленный:  перечисленные
изъян:  изъян
лопиталя:  лопиталя
обычно:  обычно
поляформула:  поляформула
наверное:  наверное
фехнера:  фехнера
входящий:  входящих
эффективный:  эффективные
исходный:  исходном исходные
условный:  условные
эллипс:  эллипс
ноль:  ноль
цель:  целью
поговорить:  поговорим
важность:  важности
даламбер:  даламбера
красота:  красоты
повторнойя:  повторнойи
длинный:  длинную
делиться:  делится
комплексный:  комплексные комплексного комплексный комплексными
ранг:  ранг
кривая:  кривой
тяжестиплоска:  тяжестиплоской
проверка:  проверка
нуль:  нули нуля нулей
преподаватель:  преподаватель преподавателя
силлогизм:  силлогизма
хотеть:  хочу
внимание:  внимание
лейбниц:  лейбница
привести:  приведу привести
случай:  случае случаях
лениться:  ленимся
окончательный:  окончательное
неравенство:  неравенства
поток:  поток
мусор:  мусором
пытаться:  пытался
недавно:  недавно
медиана:  медиана
направлениюй:  направлениюи
единственный:  единственное
гостевой:  гостевая
скоро:  скоро
кроме:  кроме
аккуратно:  аккуратно
обещать:  обещал
говорить:  говорить говорят говоря
понятно:  понятно
выражать:  выражающие
закрепление:  закрепления
внутригрупповаяй:  внутригрупповаяи
зависеть:  зависит
сумма:  сумму сумма
придерживаться:  придерживаемся
условие:  условия
намного:  намного
прямоугольник:  прямоугольников
эксцессэмпирический:  эксцессэмпирического
слагаемое:  слагаемых
оценка:  оценка оценки
ограниваться:  огранивается
криволинейный:  криволинейные
обсуждать:  обсуждали
сверка:  сверку
знак:  знака
библиотека:  библиотека
каждый:  каждый
наименьшеезначение:  наименьшеезначения
прослеживаться:  прослеживается
системылинейный:  системылинейных
нужно:  нужно
зависимость:  зависимость
подчёркивать:  подчёркивал
замкнутый:  замкнутому
применимый:  применим
цепочка:  цепочку
равносильно:  равносильно
желать:  желаю желающие
показатель:  показатели
известный:  известном известные
сильно:  сильно
площадьс:  площадьс
ранее:  ранее
многочисленный:  многочисленными
строка:  строки
убыванией:  убываниеи
одинаковый:  одинаковые
повышенный:  повышенной
статистический:  статистическая статистические
также:  также
дать:  данная дано данной
интегрирование:  интегрирование
рациональный:  рациональные
тьюринг:  тьюринга
интервальный:  интервальный
древний:  древних
напутствие:  напутствие
институт:  института
привычный:  привычном привычным
объяснение:  объяснение
вообще:  вообще
допускать:  допускал
простой:  простой простое простыми простые простым
сочетательный:  сочетательное
оценкия:  оценкии
неявный:  неявной
несобственныхинтеграл:  несобственныхинтегралов
вероятностибиномиальный:  вероятностибиномиального
род:  рода
гаусс:  гаусса
оговорить:  оговорённом
выразить:  выразить
точно:  точно
экстремальный:  экстремальные
весь:  вся всей
нормаль:  нормали
определитель:  определитель
позиция:  позиций
выпуклость:  выпуклость
элемент:  элементы
начало:  начала
ждать:  ждать
осуществить:  осуществить
сложность:  сложности
встретиться:  встретился
значенияй:  значенияи
справедливо:  справедливо
тожественный:  тожественно
затруднить:  затруднит
работать:  работаем
нужный:  нужной
кстати:  кстати
психика:  психики
классическоеопределение:  классическоеопределение
инормаль:  инормаль
представлять:  представляют
пирамида:  пирамида
нежелательно:  нежелательно
находиться:  находятся находится
автор:  автор автора
задуматься:  задуматься
отмечать:  отмечал
дифференциальный:  дифференциальные
уравненияс:  уравненияс
онлайн:  онлайн
геометрия:  геометрии геометрия
работа:  работа
фрагмент:  фрагмент
новый:  новому нового
произвольныйтройный:  произвольныйтройной
дизайн:  дизайна
это:  это
понимание:  понимание
поляй:  поляи
опечатка:  опечатку
продолжать:  продолжаем
способ:  способом
познакомиться:  познакомились
методомоперационный:  методомоперационного
бесповторный:  бесповторной
ошибка:  ошибку
л:  л
практический:  практические
обойтись:  обойтись
итоговый:  итоговые итоговый
столь:  столь
важно:  важно
внутренний:  внутренним
слово:  слову
наука:  наука
касательный:  касательных
непростой:  непростых
типовыхзадача:  типовыхзадач
немалый:  немалой
ранговойкорреляция:  ранговойкорреляции
рука:  руки
прийти:  пришло
масло:  масло
переставлять:  переставлять
размещение:  размещения
проблема:  проблемы
представить:  представить
исследовать:  исследовать
нетрудно:  нетрудно
поверхность:  поверхности
линейныйкоэффициент:  линейныйкоэффициент
несобственныйинтеграл:  несобственныйинтеграл
доступно:  доступно
удобство:  удобства
логично:  логично
учиться:  учимся
задавать:  задаваемые
ипример:  ипримеры
множество:  множества
найти:  найти
поверхностный:  поверхностные
принимать:  принимают принимать принимает
де:  де
практика:  практики
фигура:  фигуры
пуассон:  пуассона
успех:  успехов
однако:  однако
осмыслить:  осмыслить
стандартный:  стандартное
математическоеожидание:  математическоеожидание
школа:  школа
соединимый:  соединим
неоднородный:  неоднородные
остальной:  остальных
думать:  думаю думает
кратное:  кратные
стоить:  стоит
системудифференциальный:  системудифференциальных
очевидный:  очевидная очевидных
помимо:  помимо
рассуждение:  рассуждение
тождественный:  тождественна тождественными
последовательность:  последовательностей
истинно:  истинно
квадратичный:  квадратичные
объём:  объем
имя:  имя имён
проверить:  проверить
требоваться:  требовалось
поскольку:  поскольку
гипергеометрическоераспределение:  гипергеометрическоераспределение
складывать:  складывать складываем
параграф:  параграфу
равномерный:  равномерная равномерное
треугольный:  треугольная
исключительно:  исключительно
обозначать:  обозначать
пожалуйста:  пожалуйста
эмоциональный:  эмоциональную
план:  плане
улучшить:  улучшить
себя:  собой
квадрат:  квадратов
сразу:  сразу
функциюкомплексный:  функциюкомплексной
необходимый:  необходимого
заодно:  заодно
мода:  мода
свойстваэлементарный:  свойстваэлементарных
заполнение:  заполнению
краткий:  краткое
гласить:  гласящее
калькулятор:  калькулятор
научиться:  научиться
поисковик:  поисковика
доктор:  доктором
натуральный:  натуральные
принципиальный:  принципиальную
определённый:  определенный определенного
знакомиться:  знакомиться
тренировка:  тренировки
действительно:  действительно
прочий:  прочих
экстремум:  экстремумы
горнера:  горнера
отмечаться:  отмечалось
применять:  применяем
получать:  получаем получает
функцийв:  функцийв
активно:  активно
вышеуказанный:  вышеуказанной
довольно:  довольно
смена:  смену
лишний:  лишним
дискретнойслучайный:  дискретнойслучайной
погружение:  погружение
чёрточка:  чёрточки
прекрасно:  прекрасно
соответствие:  соответствии
крамер:  крамера
обосновать:  обосновать
выпить:  выпил
парабола:  парабола
путаница:  путаницы
строго:  строго
повторимый:  повторим
подчеркнуть:  подчеркнуть
мальчик:  мальчик
выполнять:  выполняем
запретить:  запрещено
функциидвуха:  функциидвух
емелин:  емелин
широко:  широко
вычисленияопределенный:  вычисленияопределенных
задачин:  задачина
замечательный:  замечательные
системый:  системыи
удовлетворяетлить:  удовлетворяетли
здоровый:  здоровой
всякий:  всякий
направление:  направления
перейти:  перейти
тригонометрический:  тригонометрических
проводить:  проводим
казаться:  казалось
этический:  этических
чётко:  чётко
факт:  факта
понимать:  понимают
заданав:  заданав
всё:  всё
что:  чём
тройной:  тройные
деление:  деления
контуруформула:  контуруформула
понять:  поймёте
график:  график
скрепить:  скреплена
дело:  деле дело
внутри:  внутри
собственноручно:  собственноручно
либо:  либо
рекомендовать:  рекомендую
раскладывать:  раскладываем
типичный:  типичный
изучение:  изучения
обещание:  обещания
корреляция:  корреляции
прежде:  прежде
тот:  ту
горизонтальный:  горизонтальные
заочник:  заочников
разный:  разные
тупой:  тупым
некоммутативный:  некоммутативным
повторять:  повторяем
опустить:  опустить
равенство:  равенства
