ошибка:  ошибкой ошибку
часовой:  часовой часовых
математический:  математических математическая математические математической
производный:  производные производная производной производную
длинный:  длинная длинным
счастливый:  счастливые
предел:  предел пределы пределов
небольшой:  небольшой
художественный:  художественной
характеристический:  характеристическое характеристическим характеристический
числовой:  числовые числовым
производныенеявно:  производныенеявно
значение:  значение значением значениям значению значений значениях значения
контрольный:  контрольных
игрек:  игрек
формула:  формулы формула
найдить:  найдённые
канонический:  каноническому канонического каноническом каноническое каноническим
два:  две двум двух
дифференциал:  дифференциалах дифференциала
больший:  наибольшее большей
стрелка:  стрелки
выразить:  выразим выразив выразить выражены
многие:  многие
один:  одну одно одного одна одном одному
различный:  различные различны различных различным
феникс:  феникс
против:  против
вынудить:  вынуждены
квадратный:  квадратной квадратного квадратное квадратных квадратный квадратную
сам:  самого самом
расположить:  расположить
число:  число числом числами числам числу чисел числа
вогнутостья:  вогнутостьи
посему:  посему
многий:  многих
позволять:  позволяет позволяющую
случай:  случай случая случаев случае случаях
убедиться:  убедиться
последующий:  последующих
неизвестный:  неизвестный
профессия:  профессию
получить:  получило получены получим получить полученная получена получили получи
условие:  условии условию
пусть:  пусть
умножение:  умножения умножение умножении
составить:  составлена составим составленная
система:  система системе систему систем системы
группировка:  группировок группировка
познакомиться:  познакомимся
условнаясходимость:  условнаясходимость
угол:  угол
александр:  александр
остаться:  осталось
термин:  термины термин
сказочный:  сказочный
доказательство:  доказательстве
который:  которые которому который которая которое которую которого которым которых которой
линейный:  линейные линейная линейное линейную линейных линейного линейному линейной
правый:  правой
любой:  любые любое любой любого
равенство:  равенство равенств
запись:  записи
согласие:  согласия
пункт:  пунктах пункта
решать:  решаем решать
дуоперационный:  дуоперационным
пример:  примером пример примера примере примерах примеры
сформулировать:  сформулировать
базис:  базисах базису базисе базис базиса
геометрия:  геометрией геометрии геометрия
никто:  никто
компактный:  компактные
оговорка:  оговорка
обычный:  обычному обычная
хороший:  лучшей хорошем
наиболее:  наиболее
зависимостьвектор:  зависимостьвекторов
распространить:  распространённый
снова:  снова
оно:  оно
день:  день
соответствовать:  соответствующее соответствующую соответствующем соответствует соответствуют
сначала:  сначала
метод:  методы методу методом метод
составлять:  составляем
геометрически:  геометрически
страница:  страницу страницы
столбец:  столбцу столбце столбец столбца
смотреть:  смотрим
данные:  данных
интеграл:  интеграл интегралов интегралы интеграла интеграле
урок:  урока урок
разложение:  разложением разложении разложение разложения
конкретный:  конкретного
икс:  икс иксом
уравнение:  уравнению уравнения уравнение уравнении уравнением уравнений
оприходовать:  оприходуем
переход:  переход
однозначность:  однозначности
желательно:  желательно
очередь:  очередь
вектор:  векторах векторы вектору вектором векторов вектора векторами вектор
практический:  практических
целесообразно:  целесообразно
выдать:  выдал
малый:  малые наименьших
связь:  связь
придавать:  придаём придавая
строка:  строками строку строке строки строкам строк
нормальный:  нормальное
заметный:  заметному
интегральнаятеорема:  интегральнаятеоремы
корнимногочлен:  корнимногочлена
логарифмический:  логарифмическая
кратное:  кратным кратных кратными кратные
подчёркивать:  подчёркиваю
основной:  основные
кратный:  кратны
бернулли:  бернулли
полярный:  полярные полярных полярной
рассмотреть:  рассмотрим рассмотренного рассмотренной
ряд:  ряды ряда ряд рядов
уровень:  уровня уровне
главный:  главным главной главную
значительно:  значительно
попросту:  попросту
доверительный:  доверительные
стараться:  стараются стараемся
среднееквадратический:  среднееквадратическое
избегать:  избегая
тип:  типа
посвятить:  посвящён
подбор:  подбором подбора
комбинационный:  комбинационная
содержательный:  содержательного
декартов:  декартовой
смешанноепроизведение:  смешанноепроизведение
неколлинеарный:  неколлинеарны неколлинеарных неколлинеарный
искусить:  искушенные
функция:  функции функция функций
упрощённый:  упрощённой
дисперсия:  дисперсия дисперсии дисперсию
постараться:  постарайтесь
базисный:  базисную базисные базисная
школьный:  школьный
мы:  нам
образ:  образом
целый:  целой целым
непрерывнаяслучайный:  непрерывнаяслучайная
неверный:  неверное
ибо:  ибо
четыре:  четыре
однородный:  однородная однородные однородную однородным однородной однородных
длина:  длина
немного:  немного
мочь:  могут
знакопостоянство:  знакопостоянства
алгоритм:  алгоритму алгоритма алгоритм алгоритмом
градиент:  градиент
линия:  линия линии линиями
вспомнить:  вспомним
технический:  техническим технической техническую
комбинаторика:  комбинаторике
случайнаявеличина:  случайнаявеличина
мой:  моих
бесконечно:  бесконечно
давать:  даёт давайте даём
форма:  формы
равный:  равны равные равен равна
задача:  задачу задаче задачи задач задачах задача
увлекаться:  увлекаться
отметить:  отметить
знание:  знания знаний
статья:  статьи статьёй
опечатка:  опечатка опечатку
обратный:  обратную обратная обратной
ненулевой:  ненулевое ненулевой ненулевые
особенность:  особенности
изменять:  изменять
диагональ:  диагонали
год:  годы
третий:  третий третья третью третьего третье третьей
доводить:  доводить
заесть:  заест
готовый:  готовых
просто:  просто
приём:  приём приёмом
ещё:  ещё
прибавить:  прибавили прибавим
вычисление:  вычислениями вычисление
задавать:  задавая задают задаваемые
разыскиваться:  разыскиваются
отвращение:  отвращении
собственный:  собственного собственным собственными собственное собственный собственные собственному собственных
нахождение:  нахождения нахождении
подобный:  подобных
данный:  данного данную данном данное данный
вы:  вами
тема:  тему темы
непрерывный:  непрерывных непрерывная
производныефункция:  производныефункции
средний:  средняя
столбцы:  столбцы
участок:  участки
область:  области область
последний:  последние последнем последних
подобрать:  подобрать
заключительный:  заключительную
корректно:  корректно
далеко:  далеко
математик:  математика
переменный:  переменных переменной переменные переменную переменная
др:  др
упрощение:  упрощения
несовместный:  несовместные
независимыеслучайный:  независимыеслучайные
ответ:  ответа ответ ответы
следовательно:  следовательно
модель:  модель модели моделях
непрерывность:  непрерывность
четвёртый:  четвёртой четвёртая
функциис:  функциис
угодный:  угодно
таков:  таков
полный:  полной полных полное полному
зеркало:  зеркало
второй:  втором второго второй вторую вторая
читатель:  читатели
значит:  значит
исходный:  исходная исходным исходной исходную
пирсон:  пирсона
некоторый:  некоторую некоторых некотором некоторые
умножить:  умножили умноженную умножим
свой:  своё свои
вопрос:  вопрос вопроса вопросы
межгрупповой:  межгрупповая
ортогональный:  ортогональное
располагаться:  располагаются располагается
страх:  страхе
нсв:  нсв
стиль:  стиле
промежуточный:  промежуточных
схема:  схему схема схеме
вроде:  вроде
перемножить:  перемножить
удостовериться:  удостовериться
упасть:  упал
ход:  ходе ходу
векторыфундаментальный:  векторыфундаментальной
отрезка:  отрезке
величина:  величина величин величины
важность:  важность
требовать:  требуемое
методика:  методике
раскрой:  раскроем
самый:  самая самым самый самое
детерминация:  детерминации
избежать:  избежать
обязательно:  обязательно
трудный:  трудные
начать:  начать начну
запомнить:  запомнить
важный:  важные
выполнить:  выполнить выполненное
матрица:  матрицей матрицу матриц матрицы матрица матрицами матрице
энтузиаст:  энтузиасты
дифференциальныеуравнение:  дифференциальныеуравнения
прямой:  прямая прямой прямую
взять:  возьмём взять
постоянный:  постоянных
стокс:  стокса
размер:  размеры
многочлен:  многочлена многочлен
самостоятельно:  самостоятельно
зетовый:  зетовая
жизнь:  жизнь
равняться:  равняются
дробовик:  дробовик
диагональный:  диагональная диагональным диагональную диагональной
математика:  математике математики
векторный:  векторное векторном векторного векторная
тренироваться:  тренируемся
ваш:  ваши
вероятностия:  вероятностии
представитель:  представители
скалярный:  скалярное
задание:  заданиях задание задания
совершенно:  совершенно
наш:  нашем наш нашего
значимость:  значимости
симпатичный:  симпатичной
страшный:  страшного
мысленно:  мысленно
удалить:  удалят удалили
анализ:  анализа анализ
её:  её
частный:  частное частные частный
парный:  парной
товарищ:  товарищ
репродукция:  репродукции
примерный:  примерный
найти:  найдём найдёте найдем найденное найти найдено
одинокий:  одиноким
момент:  моменты
сборник:  сборники
параметрический:  параметрическом параметрической
версия:  версия
раскрыть:  раскрыть
дать:  данному дать данные данной
пространственный:  пространственных
часто:  часто
формальный:  формальным формальной формальный
абзац:  абзацах
коварство:  коварство
получаться:  получается
комбинация:  комбинации комбинацию
находить:  находим находили
решение:  решение решением решения решений
форум:  форум форуме
записывать:  записывать записывают записываем
книга:  книги книга
провести:  провести проведём
дополнительный:  дополнительное
чтение:  чтения
разложить:  разложим разложить
устно:  устно
вращение:  вращения
именно:  именно
вероятно:  вероятно
копирование:  копирование
разрыв:  разрыва
выражение:  выражения выражение
совпадать:  совпадает
использоваться:  используются
название:  название
отблагодарить:  отблагодарить
являться:  являются является
байес:  байеса
упростить:  упростит
комплект:  комплекта
кривоватый:  кривоват
эстетический:  эстетическому
точность:  точности точностью точность
минута:  минуты
выставить:  выставлен
теория:  теория теории
прокомментировать:  прокомментировал
нулевой:  нулевым нулевая нулевой
малина:  малина
называть:  называют называемое
двумерный:  двумерная
друг:  друг другом другу
задать:  заданной задайте заданного
приемлемый:  приемлем
тело:  тела
циркуляция:  циркуляция
слева:  слева
ветка:  ветка
плоскость:  плоскости плоскость
действовать:  действующим
общий:  общим общая общий общем общее
получиться:  получится получиться
определителяй:  определителяи
хвост:  хвост
согласно:  согласно
действительный:  действительны действительных
захлопывать:  захлопывают
закон:  законы
справа:  справа
качество:  качестве
вероятность:  вероятностей вероятность вероятности
уравненийв:  уравненийв
множитель:  множитель множители
ограничиться:  ограничусь
назреть:  назрели
иметь:  имеют имеет
уместный:  уместная
грин:  грина
эйлер:  эйлера
иной:  иное
нужный:  нужны нужной
геометрический:  геометрический геометрические геометрическая геометрическое
вычесть:  вычтем
годиться:  годится
каждый:  каждого каждому каждой
остальной:  остальные
событие:  событие события
дискретный:  дискретный
невозможно:  невозможно
направить:  направленный
знакочередоваться:  знакочередующиеся
смущать:  смущать
предложить:  предложено
голова:  голову
практически:  практически
произвольный:  произвольных произвольную произвольные
сложный:  сложной сложные сложных
фурье:  фурье
поле:  поля
гипотеза:  гипотез гипотеза гипотезы
свойство:  свойства
исследование:  исследование
вариант:  варианте вариант
точка:  точки точек точке
первый:  первую первой первому первых первая первом первого первый
вариация:  вариации
тот:  та тому те той ту
основа:  основы
слишком:  слишком
интервал:  интервалы
кош:  коши
свободный:  свободных свободная свободные свободной свободную
соответствующий:  соответствующих соответствующие соответствующими
чайник:  чайников чайнику
излишний:  излишнее
вычисленияс:  вычисленияс
матричный:  матричные матричных матричное матричный
заметить:  заметили
вычислить:  вычислить
коэффициент:  коэффициентом коэффициент коэффициенты
очень:  очень
корень:  корнем корни корень корней
скука:  скука
испытанияй:  испытанияи
интегралыть:  интегралыв
научиться:  научимся научиться
привыкнуть:  привык
перегруппировка:  перегруппировка
пропорциональность:  пропорциональности
помощь:  помощью
вариационный:  вариационный
элементарный:  элементарных
взглянуть:  взгляните
партия:  партии
подходящий:  подходящий
линейно:  линейно
блог:  блог
высокий:  высших высшей высшая
произведение:  произведения произведение
паровозик:  паровозиком
пространство:  пространстве
снимать:  снимаем
удобный:  удобный удобнее удобным
курс:  курс
координата:  координаты координата координат координатах
меняться:  меняется
солдат:  солдатом
окончательно:  окончательно
сообщить:  сообщите
аналитический:  аналитическая аналитической
понижение:  понижение понижением
выражаться:  выражается
левый:  левой
центр:  центр
совпасть:  совпала
затмение:  затмение
преобразование:  преобразованиях преобразования преобразованию преобразование преобразований
сопрячь:  сопряжённые
скобка:  скобку скобки
быстрый:  быстрее
перенести:  перенесём
сторона:  сторону
пробовать:  пробуем
затем:  затем
построение:  построение
линейнойкорреляционный:  линейнойкорреляционной
действие:  действия действие
оставаться:  остаётся
просматриваться:  просматривается просматриваются
особо:  особо
почему:  почему
распределениякритерия:  распределениякритерий
удержаться:  удержался
отлично:  отлично
дальнейший:  дальнейшее дальнейшие дальнейшую
решить:  решена решим решить решив
несобственный:  несобственные
следующий:  следующую следующим следующих
сложность:  сложностью сложности
поворот:  повороте поворот поворота
говорить:  говорил говорят
неизменный:  неизменными
касательная:  касательная
задачис:  задачис
герой:  героя
разный:  разных разные
взаимосвязь:  взаимосвязей
правило:  правила правилу правило
функциия:  функциии
возможно:  возможно
степенной:  степенного степенные
функцийдвуха:  функцийдвух
выборка:  выборке
годный:  годен
функцийнесколький:  функцийнескольких
удачный:  удачный
чисто:  чисто
градус:  градусов
перекос:  перекоса перекос
вычитать:  вычитая
налево:  налево
убеждаться:  убеждаемся
множественнойлинейный:  множественнойлинейной
рассматривать:  рассматриваемого рассматриваемые
зависимость:  зависимости зависимость
распределение:  распределение распределения
лицо:  лице лицом
представимый:  представима представим
весь:  всему
задачипо:  задачипо
независимый:  независимых независимы независимые
востребовать:  востребованную
приблизить:  приближенные
видно:  видно
анализировать:  анализируя
образец:  образец образца
примечание:  примечание
выкладка:  выкладки
зависимый:  зависимые зависимы
отклонение:  отклонение
неосуществимый:  неосуществимо
таблица:  таблицы
красивый:  красивый красивее
существование:  существования
вполне:  вполне
случайный:  случайных случайные
пособие:  пособиях
время:  времени
коллинеарный:  коллинеарный коллинеарны коллинеарных коллинеарные
дуга:  дуги
частность:  частности
отрезкать:  отрезкав
дивергенция:  дивергенция
соотношение:  соотношение
опытный:  опытных
сайт:  сайт сайты сайта
графика:  графики графика
оформление:  оформления
простой:  простейший простой простое простыми простого простым
неверно:  неверно
синий:  синий
причина:  причине
возрастание:  возрастание возрастания
эмпирический:  эмпирические
подставить:  подставим подставить
найтись:  нашлось
место:  месте местами
этот:  этих эта
тривиальный:  тривиальное
указать:  указать
иррациональный:  иррациональных
отличный:  отличный
определение:  определению определение определения
смотреться:  смотрится
квадратичнуюформ:  квадратичнуюформу
карта:  карта
методический:  методических
прежний:  прежним
единица:  единица
гипербола:  гипербола
быть:  будут будем будь
равно:  равно
они:  ними ими
произойти:  произошло
логика:  логики
материал:  материалов материалы
спирмена:  спирмена
вид:  виду виды виде
пропорциональный:  пропорциональны
пожелание:  пожелание
определять:  определяет
возникать:  возникает
минимальный:  минимальной
лишь:  лишь
св:  св
пара:  пара паре пару
беда:  беда
отложить:  отложите
отображаться:  отображается
чувство:  чувство
достаточно:  достаточно
показательный:  показательное
диффура:  диффурами
шестой:  шестое
узнать:  узнать
разумный:  разумные
множество:  множество множества
представлять:  представляет
статистика:  статистика
подставлять:  подставляем
коварно:  коварно
биномиальный:  биномиальное
записаться:  запишется
проскочить:  проскочили
особый:  особые
линиюв:  линиюв
рабочий:  рабочим
самостоятельный:  самостоятельного самостоятельные
отношение:  отношении
второе:  второе
поменять:  поменяли
академичный:  академичном
внешний:  внешние
иксовый:  иксовая
смысл:  смысл смысла
чёрный:  чёрный
трёхчлен:  трёхчлен трёхчлена
дуприближённо:  дуприближённо
воодушевиться:  воодушевились
информация:  информации
асимптота:  асимптоты
повторный:  повторные
заходить:  заходит
сменить:  сменили
состоять:  состоит состоять состояло
тетрадь:  тетрадь
фнп:  фнп
простейшее:  простейшие
подбирать:  подбираем
конец:  конце
часть:  частям часть части
общество:  обществе
двойной:  двойные двойной
несобство:  несобств
невзирая:  невзирая
нелинейный:  нелинейная
преобразованиеквадратичный:  преобразованиеквадратичной
принудительно:  принудительно
напрашиваться:  напрашивается
функциональный:  функциональные
оный:  оная
освоить:  освоить
абсолютный:  абсолютная
интересный:  интересные интересный интересного
одинаковый:  одинаковы
срабатывать:  срабатывает
сложенияй:  сложенияи
регрессия:  регрессии регрессия
выявиться:  выявилась
исчисление:  исчисления
гораздо:  гораздо
локальный:  локальная
ожидание:  ожидание
лаплас:  лапласа
такой:  таким такое такого такая такому таких
перегиб:  перегиба
сходимость:  сходимости сходимость
оказаться:  оказаться оказались
посередине:  посередине
ду:  ду
неопределённый:  неопределенный неопределенном
приходить:  приходим
дробь:  дробей
обязательный:  обязательное
ловкий:  ловкие
признак:  признак признаки
поэтому:  поэтому
практика:  практике практики
неприятность:  неприятностей
принцип:  принципе принципу
коль:  коль
асимметрия:  асимметрия
шаг:  шаге
скажем:  скажем
сводиться:  сводящиеся
собственно:  собственно
замена:  замены
записать:  запишем записать
маленький:  меньше
показывать:  показывает
строгий:  строгом
результат:  результате результату
например:  например
решенияопределённый:  решенияопределенных
выглядеть:  выглядит
хотя:  хотя
коэффициентковариация:  коэффициентковариации
штука:  штук
обозначить:  обозначим
перечисленный:  перечисленные
притормозить:  притормозим
лямбда:  лямбду
вынести:  вынесли вынесем
лопиталя:  лопиталя
называться:  называется
обычно:  обычно
ступенчатый:  ступенчатому
интуитивный:  интуитивном
долгий:  долгих
поляформула:  поляформула
фехнера:  фехнера
формальность:  формальности
заниматься:  занимались
эффективный:  эффективные
условный:  условные
наблюдатель:  наблюдатели
эллипс:  эллипс
желать:  желают желающие
обладать:  обладают
даламбер:  даламбера
теорема:  теоремы
двойка:  двойка
повторнойя:  повторнойи
эстетичный:  эстетичнее
ровно:  ровно
комплексный:  комплексные комплексного комплексный комплексными
аналогия:  аналогии
ранг:  ранг
расписывать:  расписывать
другой:  другое другие
кривая:  кривой
тяжестиплоска:  тяжестиплоской
относительно:  относительно
проверка:  проверка
касаться:  касается
построить:  построить
внимание:  внимание
предназначить:  предназначена
лейбниц:  лейбница
лениться:  ленимся
неравенство:  неравенства
комментарий:  комментария
поток:  поток
кратность:  кратность
подробный:  подробный
птица:  птицей
медиана:  медиана
бывать:  бывает
подобие:  подобия
направлениюй:  направлениюи
использовать:  использовать используйте
единственный:  единственное единственный
гостевой:  гостевая
снять:  снимем
скоро:  скоро
недобор:  недобор
кроме:  кроме
привести:  приведём привело привести
понятно:  понятно
никакой:  никакой
вывод:  вывод выводе
внутригрупповаяй:  внутригрупповаяи
алгебра:  алгебры
сумма:  сумму сумма
исходить:  исходя
учебник:  учебник
существовать:  существует существовать существуют
прямоугольник:  прямоугольников
отличаться:  отличаться отличаются
эксцессэмпирический:  эксцессэмпирического
выбрать:  выбрать
четырёхмерный:  четырехмерных
оценка:  оценка оценки
криволинейный:  криволинейные
алгебраический:  алгебраический
библиотека:  библиотека
чистовой:  чистовой чистового
наименьшеезначение:  наименьшеезначения
сила:  силы
жертва:  жертвой
вычислимый:  вычислим
запросто:  запросто
протяжение:  протяжении
википедия:  википедии
разница:  разницы разница
остановиться:  остановитесь
системылинейный:  системылинейных
нужно:  нужно
внести:  внесём
маскхалат:  маскхалатах
устраивать:  устраивает
замкнутый:  замкнутому
очевидный:  очевидно
располагать:  располагать
показатель:  показатели
стержень:  стержнем
свет:  свете
площадьс:  площадьс
большинство:  большинстве
фундаментальный:  фундаментальной фундаментальная
переводить:  переводит
убыванией:  убываниеи
повышенный:  повышенной
статистический:  статистическая статистические
также:  также
интегрирование:  интегрирование
легко:  легко
рациональный:  рациональные рациональную
использование:  использование
пока:  пока
нуль:  нулю
интервальный:  интервальный
противоположно:  противоположно
итак:  итак
соответственно:  соответственно
объяснение:  объяснение
вообще:  вообще
оценкия:  оценкии
неявный:  неявной
несобственныхинтеграл:  несобственныхинтегралов
вероятностибиномиальный:  вероятностибиномиального
возродиться:  возродился
род:  рода
гаусс:  гаусса
примечательный:  примечательного
честно:  честно
экстремальный:  экстремальные
нормаль:  нормали
определитель:  определитель
выдержать:  выдержать
выпуклость:  выпуклость
элемент:  элементы
принципиально:  принципиально
значенияй:  значенияи
кстати:  кстати
классическоеопределение:  классическоеопределение
инормаль:  инормаль
далёкий:  дальше
ступенька:  ступенькой
пирамида:  пирамида
нестандартно:  нестандартно
выносить:  вынося
аналогичный:  аналогичный
автор:  автор автора
руководствоваться:  руководствоваться
критерий:  критерию
ссылка:  ссылки
цель:  целях
распоряжение:  распоряжении
дифференциальный:  дифференциальные
прибегнуть:  прибегнем
уравненияс:  уравненияс
онлайн:  онлайн
работа:  работа
затруднение:  затруднений
новый:  новому
произвольныйтройный:  произвольныйтройной
дизайн:  дизайна
это:  это
поляй:  поляи
машинально:  машинально
продолжать:  продолжаем продолжая
неудивительный:  неудивительно
речь:  речь
технически:  технически
разбираться:  разбираются
показаться:  показалась
формулировка:  формулировка
непременно:  непременно
методомоперационный:  методомоперационного
бесповторный:  бесповторной
лишний:  лишних
л:  л
степень:  степени
внутренний:  внутренним
важно:  важно
слово:  слову
касательный:  касательных
скупой:  скуп
константа:  константу
типовыхзадача:  типовыхзадач
выясниться:  выяснилось
ранговойкорреляция:  ранговойкорреляции
существенный:  существенная
подсказывать:  подсказывает
разделаться:  разделаемся
генеральный:  генеральная
приравнивать:  приравниваем
сколько:  сколько
представить:  представить
исследовать:  исследовать
полезный:  полезным
порядок:  порядке порядка порядков
поверхность:  поверхности
образовать:  образуют
мытарство:  мытарств
пойти:  пошла
линейныйкоэффициент:  линейныйкоэффициент
контекст:  контексте
несобственныйинтеграл:  несобственныйинтеграл
положим:  положим
доступно:  доступно
понятие:  понятия
причём:  причём
учиться:  учимся
добиваться:  добиваться
ипример:  ипримеры
добывать:  добывать
требоваться:  требуется требовалось требовался
искать:  ищите
поверхностный:  поверхностные
удаление:  удалении
фигура:  фигуры
застопориться:  застопорилось
пуассон:  пуассона
успех:  успехов
однако:  однако
человек:  людей люди
пора:  поры
стандартный:  стандартное
математическоеожидание:  математическоеожидание
итог:  итоге
тройка:  тройка
школа:  школа
неоднородный:  неоднородные
проверять:  проверяем
картинка:  картинку
положительный:  положительной
системудифференциальный:  системудифференциальных
превращаться:  превращается
помимо:  помимо
стать:  стать
последовательность:  последовательностей
квадратичный:  квадратичные
объём:  объем
проверить:  проверить
джоконда:  джоконды
поскольку:  поскольку
гипергеометрическоераспределение:  гипергеометрическоераспределение
оба:  обоих
редкий:  редкое
обратить:  обратите
подробно:  подробно
равномерный:  равномерная равномерное
иначе:  иначе
треугольный:  треугольная
определённый:  определенное определенный определенного
спрашивать:  спрашивал
пожалуйста:  пожалуйста
принимать:  принимать
разделить:  разделили
следовать:  следует
себя:  собой
квадрат:  квадратов
вкурить:  вкурить
объект:  объекты
сразу:  сразу
функциюкомплексный:  функциюкомплексной
мода:  мода
свойстваэлементарный:  свойстваэлементарных
дэ:  дэ
калькулятор:  калькулятор
корректность:  корректность
чётко:  четко
удовлетворять:  удовлетворяет удовлетворяют
нелегальный:  нелегальный
принять:  принять
формально:  формально
наличие:  наличие
приносить:  приносит
недиагональный:  недиагональную
экстремум:  экстремумы
горнера:  горнера
получать:  получаем
функцийв:  функцийв
ознакомиться:  ознакомиться
доводка:  доводка
довольно:  довольно
размерность:  размерность
вкладываться:  вкладывается
должный:  должна
среди:  среди
иллюстрация:  иллюстрации
предостерегать:  предостерегаю
три:  трёх
дискретнойслучайный:  дискретнойслучайной
отработать:  отработал
знак:  знак
удивляться:  удивляйтесь
крамер:  крамера
разрешить:  разрешив
сохранять:  сохраняют
парабола:  парабола
повторимый:  повторим
запретить:  запрещено
к:  ко
функциидвуха:  функциидвух
черновик:  черновике
емелин:  емелин
источник:  источниках
вычисленияопределенный:  вычисленияопределенных
задачин:  задачина
замечательный:  замечательные
системый:  системыи
удовлетворяетлить:  удовлетворяетли
солнечный:  солнечное
направление:  направления
тригонометрический:  тригонометрических
проводить:  проводим
заданав:  заданав
всё:  всё
описать:  описанных
тройной:  тройные
психотерапевтический:  психотерапевтических
деление:  деления
контуруформула:  контуруформула
график:  график
дело:  деле дело
иллюстрировать:  иллюстрирующий
прийти:  пришёл
либо:  либо
трёхмерный:  трёхмерные
рекомендовать:  рекомендую
выяснить:  выяснили
примерно:  примерно
зет:  зет
студент:  студенты
способ:  способ
корреляция:  корреляции
прежде:  прежде
определить:  определены
заочник:  заочников
повторять:  повторяем
