сколь:  сколь
упустить:  упустите
производный:  производные производная производной производную
предел:  предел пределы пределов предела пределе пределах
указательный:  указательный
положительный:  положительного положительный положительному
числовой:  числовые числового числовой числовых
производныенеявно:  производныенеявно
значение:  значение значений значениях значения
отрицательный:  отрицательные
заскок:  заскоков
разрыв:  разрыв разрыва
дочитать:  дочитали
формула:  формулы формула
смотреть:  см
состоять:  состоящую состоит
особенно:  особенно
прийтись:  придётся
канонический:  каноническому
сталкиваться:  сталкивались
дифференциал:  дифференциалах дифференциала
слиться:  сольётся
больший:  наибольшее большего больших
нередко:  нередко
многие:  многие
львиный:  львиная
бок:  боку
сам:  самого самом сама
луна:  луны
вогнутостья:  вогнутостьи
посему:  посему
многий:  многих
становиться:  становится
выяснить:  выяснить
распаковать:  распакую
случай:  случай случаев случае случаях
упрощать:  упрощаем
профессия:  профессию
условие:  условии условиями условие
находиться:  находиться
пусть:  пусть
удобно:  удобно
умножение:  умножения
развивать:  развивать
система:  система системе систему системы
группировка:  группировок группировка
условнаясходимость:  условнаясходимость
слово:  словами слово
александр:  александр
ось:  ось оси
зря:  зря
термин:  термины
который:  которые которыми котором который которое которого которым которой
линейный:  линейные линейная линейных линейной
частичный:  частичная частичные частичной частичных
согласие:  согласия
решать:  решаем решать
дуоперационный:  дуоперационным
необходимый:  необходимым
базис:  базисах базису базис
бохан:  бохана
предположить:  предположить
зависимостьвектор:  зависимостьвекторов
справиться:  справиться
предложный:  предложен
оно:  оно
сначала:  сначала
свой:  своими своё своей свои
метод:  методы методом метод
составлять:  составляем
тема:  теме тема тему
страница:  страницу
мажорантный:  мажорантным мажорантного мажорантному
обычный:  обычные
стройный:  стройную
математический:  математическая математического математические математической
данные:  данных
интеграл:  интеграл интегралов интегралы интеграла интеграле
урок:  урока урок уроке
похожий:  похожее похож похожи
разложение:  разложением разложениях разложении разложение
радикальный:  радикального радикальном
расходиться:  расходится
попадать:  попадает
гармонический:  гармонический
икс:  икс
сумма:  суммой суммы сумме сумму сумма сумм
кусок:  кусок куска
уравнение:  уравнению уравнения уравнение уравнений
подвесить:  подвешен
переход:  переход
внутрь:  внутрь
сходиться:  сходящемуся сходится сходящегося сходиться сходящихся сходящийся сходящиеся
застукать:  застукает
целиком:  целиком
мажорировать:  мажорирует мажорирующий
малый:  малые малую наименьших
связь:  связь
кисло:  кисло
отличный:  отличен
нормальный:  нормальное
интегральнаятеорема:  интегральнаятеоремы
корнимногочлен:  корнимногочлена
логарифмический:  логарифмическая
условно:  условно
подбирать:  подбирать
рад:  рад
начать:  начнём начать начал
подчёркивать:  подчёркиваю
основной:  основные
функция:  функцией функции функция функций функцию
соответствовать:  соответствующей соответствует
бернулли:  бернулли
полярный:  полярные полярных полярной
рассмотреть:  рассмотрим рассмотреть рассмотрели
ряд:  ряды ряда ряду ряд рядах рядов
уровень:  уровня
лишний:  лишнего
показать:  показал
охватываться:  охватываются
краткий:  краткие
доверительный:  доверительные
среднееквадратический:  среднееквадратическое
посвятить:  посвящён
комбинационный:  комбинационная
смешанноепроизведение:  смешанноепроизведение
оказаться:  окажутся окажется
хитрость:  хитростей
дисперсия:  дисперсия дисперсии дисперсию
постараться:  постарайтесь
школьный:  школьный
мы:  нам
образ:  образом
непрерывнаяслучайный:  непрерывнаяслучайная
другой:  других другие
ибо:  ибо
длина:  длина
материал:  материал материалов материалы
немного:  немного
мочь:  могут могу
знакопостоянство:  знакопостоянства
обещание:  обещание
интервал:  интервале интервала интервалы интервал
градиент:  градиент
линия:  линия линии линиями
комбинаторика:  комбинаторике
случайнаявеличина:  случайнаявеличина
бесконечно:  бесконечно
отношение:  отношению отношении
числитель:  числитель числителя
встречаться:  встречался встречается
форма:  формы
отметить:  отметить
статья:  статьи статье статью
возвращаться:  возвращаемся
обратный:  обратную обратная
читаемый:  читаем
график:  графиком графику график
готовый:  готовых
просто:  просто
ещё:  ещё
произвольный:  произвольного произвольной произвольных произвольное
заметить:  заметит заметили заметить
убедиться:  убедимся
быть:  буду будут будем
сформулировать:  сформулировано сформулированное
единственный:  единственным единственной
понятие:  понятии понятие
настоящий:  настоящие настоящий
очевидный:  очевидна очевидно
данный:  данного данном данный
грамотно:  грамотно
непрерывный:  непрерывных непрерывная непрерывны
производныефункция:  производныефункции
средний:  средняя
область:  области область
получать:  получаемой получаем получает
подобрать:  подобрать
извлечь:  извлечь
корректно:  корректно
предположим:  предположим
далеко:  далеко
число:  числами числу числа
математик:  математика
синус:  синуса
переменный:  переменных переменной
пример:  пример примера примере примерах примеры
возрастать:  возрастающей возрастает
пограничный:  пограничные
несовместный:  несовместные
независимыеслучайный:  независимыеслучайные
модуль:  модулю модуля модуле модуль
вверх:  вверх
следовательно:  следовательно
модель:  модель модели
непрерывность:  непрерывность
небольшой:  небольшое
функциис:  функциис
угодный:  угодно
право:  правом права
полный:  полной полных полное
зеркало:  зеркало
значит:  значит
пирсон:  пирсона
член:  члены член членов
вопрос:  вопрос вопросу вопросы
межгрупповой:  межгрупповая
ортогональный:  ортогональное
преодолеть:  преодолели
неабсолютно:  неабсолютно
нсв:  нсв
стиль:  стиле
расходимость:  расходимости
убывать:  убывающая убывающей убывает
упасть:  упал
ход:  ходе
один:  одно одном
гарантированно:  гарантированно
отрезка:  отрезке
трудно:  трудно
величина:  величина величин величины
дебри:  дебри
прихватить:  прихватили
она:  неё
детерминация:  детерминации
трудный:  трудные
выполнить:  выполнить выполнены выполнено
специальный:  специальными
дифференциальныеуравнение:  дифференциальныеуравнения
неравномерный:  неравномерной неравномерный
прямой:  прямая прямой прямую
взять:  возьмём взять
проявляться:  проявляется проявляться
наглядный:  нагляднее
столкнуться:  столкнуться
подстановка:  подстановке
постоянный:  постоянных
стокс:  стокса
схема:  схема
свести:  свести
самостоятельно:  самостоятельно
жизнь:  жизнь
окрестность:  окрестность
равномерно:  равномерно
дробовик:  дробовик
известный:  известнейшим
математика:  математике математики
векторный:  векторное векторного
десерт:  десерт
нечто:  нечто
вероятностия:  вероятностии
скалярный:  скалярное
совершенно:  совершенно
значимость:  значимости
мысленно:  мысленно
функциональный:  функциональных функциональные функционального функциональному функциональный функциональную
признак:  признака признаками признак признаке признаку признаки признаком
анализ:  анализа анализ
её:  её
мажорироваться:  мажорируется
частный:  частное частные
парный:  парной
выходить:  выходит
поднять:  поднимите поднять
солнце:  солнца
примерный:  примерный
найти:  найдём найти
доказать:  доказаны доказанный доказать
сборник:  сборники
параметрический:  параметрическом параметрической
практика:  практика практике
дать:  данному дать
делать:  делаем делать
часто:  часто
получаться:  получается
хороший:  хороший
находить:  находим
решение:  решение решением решения решений
форум:  форум форуме
книга:  книги книга
порвать:  порвали
задание:  задание
вектор:  векторы векторов
справедливый:  справедлив справедливы
встретиться:  встретиться
вращение:  вращения
именно:  именно
копирование:  копирование
выражение:  выражения
предыдущий:  предыдущей
своеобразный:  своеобразный
рабочий:  рабочий
напоминать:  напоминают напоминать
отблагодарить:  отблагодарить
байес:  байеса
простой:  проще простым
коллекция:  коллекции
теория:  теория теории
продолжение:  продолжение
подвисания:  подвисаний
двумерный:  двумерная
задать:  заданной задайте
тело:  тела
циркуляция:  циркуляция
достаточный:  достаточным
плоскость:  плоскости плоскость
общий:  общим общая общий общем
поздний:  позже
хрестоматийный:  хрестоматийный
определителяй:  определителяи
первоначальный:  первоначальный
подчищать:  подчищаем
закон:  законы
справа:  справа
воспоминание:  воспоминания
качество:  качестве
впечатление:  впечатление
ситуация:  ситуацию ситуация
вероятность:  вероятностей вероятность вероятности
заключение:  заключение
уравненийв:  уравненийв
жизненный:  жизненную
иметь:  имеют имеем
отрезок:  отрезок отрезка отрезков
типично:  типично
грин:  грина
суть:  сути
входить:  входит
эйлер:  эйлера
суровый:  суровый
дискретный:  дискретный
знакочередоваться:  знакочередующиеся
итог:  итоги
сомневаться:  сомневающихся
пожалуй:  пожалуй
практически:  практически
меняться:  меняться
происходить:  происходят
подумать:  подумайте
явственно:  явственно
сложный:  сложной сложного сложные сложных
машинальный:  машинальную
мотив:  мотив
фурье:  фурье
поле:  поля
гипотеза:  гипотез гипотеза гипотезы
заранее:  заранее
свойство:  свойства свойством свойство
момент:  момент
действительный:  действительного
исследовать:  исследуемом исследуем исследовать исследуемого
равномерный:  равномерной равномерна равномерную равномерная равномерное
исследование:  исследование исследования
точка:  точки точке
проблема:  проблем
вариация:  вариации
ссылка:  ссылка
основа:  основы
мало:  мало
обильный:  обильная
кош:  коши
выше:  выше
чайник:  чайников чайникам
дополнительный:  дополнительными дополнительный
вычисленияс:  вычисленияс
рваться:  рвутся
матричный:  матричные матричных матричный
последний:  последний
однородный:  однородные однородным
вычислить:  вычислить
очень:  очень
матрица:  матрицу матрицы матрицами
волна:  волна волной волны
испытанияй:  испытанияи
интегралыть:  интегралыв
перегруппировка:  перегруппировка
практический:  практической практическая
интересный:  интересная интереснее
обнаруживаться:  обнаруживается
помощь:  помощью
начало:  начало
вариационный:  вариационный
конец:  концов конце концах конца
день:  дне
блог:  блог
тонкость:  тонкостями
высокий:  высших высшей высшая высоких
год:  лет
последовательность:  последовательности последовательностей последовательность
пространство:  пространстве
плюшка:  плюшек
удобный:  удобный удобнее
путь:  путь
курс:  курс курсе
координата:  координаты координат координатах
сообщить:  сообщите
сделать:  сделать
аналитический:  аналитическая аналитической
понижение:  понижение понижением
центр:  центр
видеть:  видеть видите
наноскопический:  наноскопический
терпеть:  терпит
построение:  построение
вспоминать:  вспоминаем
линейнойкорреляционный:  линейнойкорреляционной
действие:  действия
пользоваться:  пользовались пользуются
время:  время
почему:  почему
распределениякритерия:  распределениякритерий
отлично:  отлично
вылезать:  вылезает
эффект:  эффект
разогреваться:  разогреваемся
результат:  результата
несобственный:  несобственные
зрение:  зрения
зависеть:  зависеть зависящий
откуда:  откуда
остаток:  остаток
увеличение:  увеличением
полностью:  полностью
касательная:  касательная
ответ:  ответ ответы
задачис:  задачис
друг:  другом
закрытый:  закрыта
правило:  правила правило
функциия:  функциии
возможно:  возможно
степенной:  степенного степенным степенной степенные
функцийдвуха:  функцийдвух
выборка:  выборке
истончаться:  истончаться
приходиться:  приходиться
функцийнесколький:  функцийнескольких
удачный:  удачный
налево:  налево
множественнойлинейный:  множественнойлинейной
некоторый:  некоторого некоторыми некоторых некотором некоторое некоторые
распределение:  распределение распределения
оказываться:  оказывается
дифференцировать:  дифференцировать
задачипо:  задачипо
прикасаться:  прикасаться
востребовать:  востребованную
приблизить:  приближенные
вариант:  вариант
важный:  важнейшим важна
образец:  образец образца
примечание:  примечание
выкладка:  выкладки
зависимый:  зависимые
отклонение:  отклонение
таблица:  таблицы
произведение:  произведение
случайный:  случайных случайные
предварительно:  предварительно
дуга:  дуги
частность:  частности
отрезкать:  отрезкав
дивергенция:  дивергенция
чертёж:  чертежа
мужественно:  мужественно
сайт:  сайт сайты сайта
наш:  наш
графика:  графики графика
оформление:  оформления
прорешать:  прорешали
пересчитать:  пересчитать
идти:  идёт
эпсилон:  эпсилон
синий:  синий синего
возрастание:  возрастание
эмпирический:  эмпирические
найтись:  нашлось найдётся
этот:  этих
заключить:  заключим
неотрицательный:  неотрицательны
указать:  указать
иррациональный:  иррациональных
человеческий:  человеческий
определение:  определению определение определения
квадратичнуюформ:  квадратичнуюформу
карта:  карта
гипербола:  гипербола
они:  ними
мелочиться:  мелочиться
мажор:  мажор
шеренга:  шеренгу
логика:  логики
спирмена:  спирмена
следующий:  следующим следующих следующий
вид:  виду виды виде
номер:  номеров номер номера
знаменатель:  знаменателем
близко:  близко
лишь:  лишь
св:  св
самый:  самый самые
второй:  второго
даламбер:  даламберу даламбера
достаточно:  достаточно
познакомиться:  познакомиться
показательный:  показательное
преобразование:  преобразования преобразований
условный:  условная условные
диффура:  диффурами
почленно:  почленно
соответствующий:  соответствующие
весьма:  весьма
подразумевать:  подразумевает
соседний:  соседнего
косинус:  косинуса
вычисление:  вычисление
неограниченный:  неограниченным
статистика:  статистика
ненулевой:  ненулевом
биномиальный:  биномиальное
записаться:  запишется
коридор:  коридор коридоре коридора
прижиматься:  прижимается
линиюв:  линиюв
сессия:  сессию
самостоятельный:  самостоятельного
участок:  участка участок
везде:  везде
обманчивый:  обманчиво
смысл:  смысл
решить:  решить
дуприближённо:  дуприближённо
асимптота:  асимптоты
событие:  события
приближение:  приближения приближение
повторный:  повторные
установить:  установлена установим
квадрат:  квадратом квадратов
прогрессия:  прогрессией прогрессия
преобразовать:  преобразуем
вейерштрасса:  вейерштрасса
фнп:  фнп
простейшее:  простейшие
иной:  иными
примитивный:  примитивным
часть:  частям часть части
двойной:  двойные двойной двойное
синусоида:  синусоиды
назвать:  назвал
несобство:  несобств
настать:  настал
нелинейный:  нелинейная
брать:  берём
преобразованиеквадратичный:  преобразованиеквадратичной
пережить:  пережили
ответить:  ответить
геометрический:  геометрическая геометрической геометрическое
абсолютный:  абсолютная
согнуть:  согните
тот:  тому
срабатывать:  срабатывает
сложенияй:  сложенияи
рыжий:  рыжих
регрессия:  регрессии регрессия
рассматривать:  рассматриваемом
исчисление:  исчисления
квалификация:  квалификацию
гораздо:  гораздо
локальный:  локальная
начинать:  начиная
оправдаться:  оправдаться
ожидание:  ожидание
лаплас:  лапласа
такой:  таким такие такое такого такая
перегиб:  перегиба
сходимость:  сходимости сходимость
задача:  задачи задачах
посередине:  посередине
выбрать:  выбранного
ду:  ду
коэффициент:  коэффициент
неопределённый:  неопределенный неопределенном
промежуток:  промежуток промежутки промежутке промежутка
дробь:  дробей
собственный:  собственные
удивительно:  удивительно
ваш:  ваш вашей
предложить:  предложенный предложены
поэтому:  поэтому
разумеется:  разумеется
теоретический:  теоретический
неравенство:  неравенство неравенства
малое:  малого малым
никакой:  никаких
коль:  коль
асимметрия:  асимметрия
главный:  главную
сводиться:  сводящиеся
собственно:  собственно
замена:  замены
характер:  характер
маленький:  меньше
показывать:  показывает
составить:  составим
например:  например
подвести:  подвести
решенияопределённый:  решенияопределенных
выглядеть:  выглядит
выявление:  выявления
коэффициентковариация:  коэффициентковариации
прекрасный:  прекрасную
разобрать:  разобрать разберём
равномерность:  равномерности равномерностью равномерность
ограниченность:  ограниченность
обозначить:  обозначим
первый:  первой первых первом первого
удержаться:  удержаться
теорема:  теореме теорему теоремы теорема
абсцисса:  абсцисс
абсолютно:  абсолютно
лопиталя:  лопиталя
называться:  называется
обычно:  обычно
естественный:  естественным
поляформула:  поляформула
наверное:  наверное
фехнера:  фехнера
водиться:  водится
эффективный:  эффективные
эллипс:  эллипс
доказательство:  доказательство доказательства
левый:  левом
факт:  факт факта
повторнойя:  повторнойи
рассказать:  рассказал
комплексный:  комплексные комплексного комплексный комплексными
ранг:  ранг
кривая:  кривой
тяжестиплоска:  тяжестиплоской
использовать:  используя использовать используйте
появление:  появление
проверка:  проверка
преподаватель:  преподаватель
носить:  носит
построить:  построить
разобраться:  разберёмся
внимание:  внимание
лейбниц:  лейбница
поток:  поток
расписать:  распишем
эквивалентный:  эквивалентное
медиана:  медиана
направлениюй:  направлениюи
гостевой:  гостевая
скоро:  скоро
кроме:  кроме
основание:  основание
обещать:  обещал
равный:  равен
понятно:  понятно
знание:  знаний
вывод:  вывод
отнюдь:  отнюдь
внутригрупповаяй:  внутригрупповаяи
алгебра:  алгебры
мешать:  мешает
существовать:  существует существуют
прямоугольник:  прямоугольников
отличаться:  отличаться
освежить:  освежим
эксцессэмпирический:  эксцессэмпирического
продолжить:  продолжите
типовой:  типовое
оценка:  оценка оценки
криволинейный:  криволинейные
различный:  различных
библиотека:  библиотека
определяться:  определяется
название:  названием
наименьшеезначение:  наименьшеезначения
сила:  силы
длинный:  длинного
вычислимый:  вычислим
запросто:  запросто
системылинейный:  системылинейных
нужно:  нужно
чистовой:  чистового
зависимость:  зависимость
пять:  пять
замкнутый:  замкнутому
глаз:  глазу
показатель:  показатели
отличие:  отличие
площадьс:  площадьс
большинство:  большинстве
шаблон:  шаблоны
убыванией:  убываниеи
повышенный:  повышенной
статистический:  статистическая статистические
также:  также
интегрирование:  интегрирование
легко:  легко
рациональный:  рациональные
натуральный:  натуральный
интервальный:  интервальный
речь:  речи речь
итак:  итак
неравномерность:  неравномерность
рука:  руку руки
вообще:  вообще
оценкия:  оценкии
неявный:  неявной
несобственныхинтеграл:  несобственныхинтегралов
вероятностибиномиальный:  вероятностибиномиального
род:  рода
гаусс:  гаусса
хитро:  хитро
лежать:  лежит лежало
баян:  баяна
экстремальный:  экстремальные
нормаль:  нормали
определитель:  определитель
выпуклость:  выпуклость
мой:  мои моей
верхний:  верхней
элемент:  элементы
обращать:  обращаем
интересно:  интересно
сложность:  сложности
значенияй:  значенияи
справедливо:  справедливо
никуда:  никуда
объяснять:  объяснять
нужный:  нужной
кстати:  кстати
классическоеопределение:  классическоеопределение
инормаль:  инормаль
изложить:  изложен изложенное
далёкий:  дальше
пригодный:  пригоден
пирамида:  пирамида
счастие:  счастье
любой:  любого любую любом
аналогичный:  аналогичный
автор:  автор автора
счёт:  счёт
копейка:  копеек
близкий:  ближайшем ближе
дифференциальный:  дифференциальные
уравненияс:  уравненияс
онлайн:  онлайн
геометрия:  геометрии геометрия
работа:  работа
расхождение:  расхождение
новый:  новому
произвольныйтройный:  произвольныйтройной
дизайн:  дизайна
дом:  дома
это:  это
поляй:  поляи
опечатка:  опечатку
превосходить:  превосходит
навык:  навык
методомоперационный:  методомоперационного
бесповторный:  бесповторной
правильно:  правильно
том:  томе
ошибка:  ошибку
л:  л
вещь:  вещь вещи
степень:  степени
важно:  важно
касательный:  касательных
большой:  большой большое
типовыхзадача:  типовыхзадач
ранговойкорреляция:  ранговойкорреляции
прийти:  пришло
цвет:  цвет
застрелиться:  застрелиться
набить:  набили
нордический:  нордический
переходить:  перехожу
полуинтервал:  полуинтервалах полуинтервале
прикладной:  прикладной
подметить:  подметили
кот:  котов
поверхность:  поверхности
точный:  точной
опровергать:  опровергаем
линейныйкоэффициент:  линейныйкоэффициент
несобственныйинтеграл:  несобственныйинтеграл
доступно:  доступно
причём:  причём
логично:  логично
учиться:  учимся
задавать:  задаваемые
раздача:  раздача
ипример:  ипримеры
множество:  множества
возможный:  возможна
требоваться:  требуется требовалось
поверхностный:  поверхностные
объяснить:  объяснить
фигура:  фигуры
изучать:  изучаем
менять:  меняю
пуассон:  пуассона
однако:  однако
таки:  таки
несмотря:  несмотря
гарантировать:  гарантирована
математическоеожидание:  математическоеожидание
школа:  школа
неоднородный:  неоднородные
оформить:  оформить
кратное:  кратные
серьёзно:  серьёзно
системудифференциальный:  системудифференциальных
рубль:  рубль
алгоритм:  алгоритм
квадратичный:  квадратичные
необычный:  необычный
объём:  объем
мучить:  мучить
проверить:  проверить
трудность:  трудность
поскольку:  поскольку
жест:  жест
гипергеометрическоераспределение:  гипергеометрическоераспределение
обратить:  обратите
удаться:  удастся
многое:  многом
возможность:  возможность
треугольный:  треугольная
упомянуть:  упомянутом
палец:  палец
пожалуйста:  пожалуйста
устроить:  устроит
неловкий:  неловкой
план:  плане
следовать:  следует
усложнить:  усложним
головоломка:  головоломки
экран:  экране
кадр:  кадром
сразу:  сразу
функциюкомплексный:  функциюкомплексной
мода:  мода
провидец:  провидцем
свойстваэлементарный:  свойстваэлементарных
калькулятор:  калькулятор
научиться:  научиться
фихтенголец:  фихтенгольца
приближаться:  приближаться
принцип:  принципу
малюсенький:  малюсенький
реально:  реально
говорить:  говорят
формально:  формально
определённый:  определенный определенного
остаться:  останется
приносить:  приносит
действительно:  действительно
экстремум:  экстремумы
горнера:  горнера
видный:  виден
сравнение:  сравнения
шаг:  шагов
функцийв:  функцийв
активно:  активно
ознакомиться:  ознакомиться
установление:  установления
допускать:  допускают
приблизиться:  приблизится
довольно:  довольно
интегрировать:  интегрировать
гигантский:  гигантский
среди:  среди
сдержать:  сдержать
патрон:  патроны
три:  трёх
полезный:  полезного
дискретнойслучайный:  дискретнойслучайной
взор:  взор
знак:  знак
хотеть:  хочет
мизерный:  мизерный
перемещаться:  перемещаться
буквально:  буквально
крамер:  крамера
прочить:  прочим
парабола:  парабола
строго:  строго
поставить:  поставленный
запретить:  запрещено
функциидвуха:  функциидвух
емелин:  емелин
вычисленияопределенный:  вычисленияопределенных
задачин:  задачина
замечательный:  замечательные
учебник:  учебнике
системый:  системыи
удовлетворяетлить:  удовлетворяетли
поза:  позе
подопытный:  подопытного
сегодня:  сегодня
всякий:  всякий
тригонометрический:  тригонометрических
два:  двух
деться:  денется
обязательный:  обязателен
аналитически:  аналитически
казаться:  казалось
довести:  довела
конкретный:  конкретный
оставить:  оставлю
заданав:  заданав
порядок:  порядка порядков
всё:  всё
что:  чём
заявить:  заявленного
тройной:  тройные
море:  моря
деление:  деления
являться:  является
контуруформула:  контуруформула
дело:  дела деле дело
нулевой:  нулевой
обобщённый:  обобщённый
внутри:  внутри
неравномерно:  неравномерно
элементарно:  элементарно
эн:  эн
независимый:  независимые
получить:  получи
добавить:  добавим
изучение:  изучения
привести:  привести
замалчивать:  замалчивает
весь:  всей
конечный:  конечному
доказываться:  доказывается
основать:  основанный
малопригодный:  малопригодным
корреляция:  корреляции
вблизи:  вблизи
заочник:  заочников
вкусный:  вкусен
повторять:  повторяем
опустить:  опустить
