скобка:  скобками скобки скобках
ошибка:  ошибкой ошибку ошибок
полезный:  полезен полезной полезны
справка:  справка справки
математический:  математических математическая математические математический математической
производный:  производные производная производной производную
пытаться:  пытаемся пытайтесь
предел:  предел пределы пределов пределом пределах
небольшой:  небольшой
числовой:  числовые
производныенеявно:  производныенеявно
значение:  значение значения
детально:  детально
маленький:  маленькими маленькой меньше
дальнейший:  дальнейшем
находить:  находить находим
литература:  литературу литература литературе
формула:  формулы формуле формула формулу
смотреть:  см смотрят
читатель:  читатель читателю
особенно:  особенно
отрицательный:  отрицательный
канонический:  каноническому
приходить:  приходят
трёхмерный:  трехмерном трехмерные трехмерного
два:  две двум двумя
дифференциал:  дифференциалах дифференциала
больший:  наибольшее большего большими
стрелка:  стрелки стрелка стрелку стрелкой
многие:  многие
нередко:  нередко
означать:  означает
любой:  любому любой любого любую
прямоугольный:  прямоугольной прямоугольную прямоугольная
отождествлять:  отождествлять
запоминать:  запоминать
подразумевать:  подразумевая подразумевает
число:  число числами числа
вогнутостья:  вогнутостьи
преспокойно:  преспокойно
нечётный:  нечетная
параллелограмм:  параллелограмм параллелограмма
допустимый:  допустима
доступный:  доступную доступной
случай:  случай случаи случая случаю случае случаях
профессия:  профессию
условие:  условии условие условию
некорректно:  некорректно
построение:  построением построение
срок:  сроки
пусть:  пусть
долгожданный:  долгожданной
удобно:  удобно
умножение:  умножения умножение
доказываться:  доказываются
предмет:  предмет предмета
развивать:  развивать
выполнимый:  выполним
система:  система системе систему системы
декартов:  декартову
группировка:  группировок группировка
условнаясходимость:  условнаясходимость
слово:  словами слову слова
физический:  физического физический
значительный:  значительной
александр:  александр
вспомниться:  вспомнился
ось:  ось оси
стрелочка:  стрелочки
который:  которые котором который которая которую которого которых которой
редко:  редко
линейный:  линейные линейная линейных линейной
латинский:  латинской латинскими
шрифт:  шрифтом
быть:  суть буду будут е
запись:  записи запись
согласие:  согласия
студент:  студента студенты
дуоперационный:  дуоперационным
пуговица:  пуговицы
базис:  базисах базису базисе базисов базис базисом базиса
миллиметр:  миллиметры
чертёж:  чертеж чертежу чертежах чертежа чертежи чертёж чертежей чертежами
способ:  способах способом способ
несколько:  нескольких несколько
вычитание:  вычитания вычитание
зависимостьвектор:  зависимостьвекторов
сначала:  сначала
рассматриваться:  рассматривается рассматриваться
свой:  своими свои свой
метод:  методы методом метод
геометрически:  геометрически
страница:  страницу
обычный:  обычные обычной обычный
различие:  различие
данные:  данных
прямой:  прямых прямая прямой прямую
весомый:  весомым
цифра:  цифра
интеграл:  интеграл интегралов интегралы интеграла интеграле
связать:  связан
урок:  урока уроки уроков уроку
разложение:  разложением разложении разложение разложения
разница:  разницу
сумма:  суммой суммы сумму сумма
уравнение:  уравнению уравнения уравнение уравнений
мочь:  можете могут можем
переход:  переход
указывать:  указывать
совпадать:  совпадают
неизвлекаемый:  неизвлекаемое
желательно:  желательно
типовой:  типовые
вектор:  векторах векторы вектору вектором векторов вектора векторам векторами вектор векторе
практический:  практических практическом практической
лектор:  лектору
целесообразно:  целесообразно
малый:  малые наименьших
связь:  связь связи
точка:  точку точки точка точкам точек точке
извлекать:  извлекать
наглядность:  наглядности
нормальный:  нормальное
интегральнаятеорема:  интегральнаятеоремы
корнимногочлен:  корнимногочлена
логарифмический:  логарифмическая
сведение:  сведения
поедание:  поедание
разработка:  разработку
основной:  основные
нужный:  нужные нужен нужна нужной нужную
соответствовать:  соответствующей соответствует
бернулли:  бернулли
полярный:  полярные полярных полярной
мой:  моего мои моей
рассмотреть:  рассмотрим рассмотренное рассмотрены рассмотренные рассмотренной
ряд:  ряды ряда ряд рядов
уровень:  уровня
аффинный:  аффинного
штамповать:  штампованных
значительно:  значительно
привести:  приведённых приведённые привёл привести
вычисляться:  вычисляется
доверительный:  доверительные
буква:  буквой буквы буква буквами
излагать:  излагаемого
среднееквадратический:  среднееквадратическое
говориться:  говорится
ужин:  ужин
вышесказанный:  вышесказанное
комбинационный:  комбинационная
проследить:  проследите
смешанноепроизведение:  смешанноепроизведение
зигзаг:  зигзагу
функция:  функции функция функций
сетка:  сетку
дисперсия:  дисперсия дисперсии дисперсию
постараться:  постарайтесь постараюсь
тянуть:  тянет
ваш:  вашему ваших
школьный:  школьный школьной школьное школьном
треугольник:  треугольника треугольников треугольник
образ:  образом
конструкция:  конструкций
иллюстрировать:  иллюстрируют
непрерывнаяслучайный:  непрерывнаяслучайная
одинаковый:  одинаковую одинаковой одинаковом одинаковых
длина:  длина длины длину длине длиной
материал:  материал материала материалов материалы материалам
немного:  немного
знакопостоянство:  знакопостоянства
проводить:  проводить
орт:  ортами орт
попробовать:  попробуйте
градиент:  градиент
конец:  конец конце концом конца
равный:  равных равны равные равными равна
коллоквиум:  коллоквиума
линия:  линия линии линиями
избыточный:  избыточным
ясно:  ясно
комбинаторика:  комбинаторике
измениться:  изменится
случайнаявеличина:  случайнаявеличина
бесконечно:  бесконечно
плюс:  плюсом плюс
знак:  знаков знаком
отношение:  отношению отношении
внимательный:  внимательным
удар:  удар
форма:  формы
задача:  задачу задаче задачи задач задачах задача
знание:  знания знаниями
отметить:  отметить отмечу
статья:  статьи статье статью
радоваться:  радоваться
смешанный:  смешанное
значок:  значком
алфавит:  алфавита
алгебра:  алгебре алгебры
обратный:  обратную обратная обратное
читаемый:  читаем
клетка:  клетки
третий:  третий
готовый:  готовых готов готово
просто:  просто
приём:  приём
ещё:  ещё
произвольный:  произвольного произвольной произвольных
тело:  тело тела
переставить:  переставить
приложение:  приложения
единственный:  единственным единственный
нахождение:  нахождения
частый:  чаще
подобный:  подобных
данный:  данного данную данном данное
вы:  вами
непрерывный:  непрерывных непрерывная
распространить:  распространён распространенные
производныефункция:  производныефункции
средний:  средняя
единица:  единице единицы
область:  области область
корректно:  корректно
математик:  математика
переменный:  переменных переменной
пример:  пример примера примеров примере примерами примерах примеры
др:  др
посмотреть:  посмотрим
несовместный:  несовместные
средство:  средств
строгий:  строгим строгой
независимыеслучайный:  независимыеслучайные
модуль:  модулю модуля модулем
координатный:  координатными координатных координатной координатные координатную
проект:  проекта
модель:  модель модели
непрерывность:  непрерывность
рассчитывать:  рассчитывать
поддержка:  поддержку
функциис:  функциис
угодный:  угодно
полный:  полной полном полных полное полная
зеркало:  зеркало
второй:  втором второго второй вторым вторая
пирсон:  пирсона
вопрос:  вопрос вопросы
прозрачный:  прозрачен прозрачны
аналогичный:  аналогичные аналогичное
межгрупповой:  межгрупповая
ортогональный:  ортогональное ортогональны
нсв:  нсв
бесконечный:  бесконечное
вроде:  вроде
мохнатый:  мохнатыми
термин:  терминов терминам
упасть:  упал
ход:  ходе
прочитать:  прочитать
отрезка:  отрезке
базылевый:  базылев
величина:  величина величин величины
важный:  важный важнейшую важным важных
округление:  округление
оказать:  окажет
зачесть:  зачтено
ущерб:  ущерб
один:  одним одна одной
аз:  азы
умножать:  умножаем
плоский:  плоские плоскому
детерминация:  детерминации
сторона:  стороны
обязательно:  обязательно
следующий:  следующие следующую следующим следующий
тот:  тех тому те той
начать:  начать начнем
запомнить:  запомнить
степень:  степенями степени
дифференциальныеуравнение:  дифференциальныеуравнения
влёчета:  влёчет
ортонормированный:  ортонормированным ортонормированному ортонормированных ортонормированный ортонормированном
постоянный:  постоянных
стокс:  стокса
схема:  схема
обращаться:  обращаться
нацело:  нацело
нос:  носу
взять:  взял взятый
предполагать:  предполагает
низкий:  низкой
измерить:  измерив
жизнь:  жизнь
проявить:  проявит
дробовик:  дробовик
клонировать:  клонировать
математика:  математике математики
векторный:  векторное векторного
сам:  самом сами само
зайти:  зайти
поступать:  поступаем
множитель:  множителя множитель множители
вероятностия:  вероятностии
поделить:  поделить
скалярный:  скалярное
атанасян:  атанасяну атанасян
подробный:  подробную подробнее
совершенно:  совершенно
неоценимый:  неоценимую
значимость:  значимости
рубашка:  рубашке
строить:  строить
мысленно:  мысленно
школьник:  школьникам
анализ:  анализа анализ
красный:  красная
частный:  частное частные частный
парный:  парной
координата:  координатами координату координаты координата координат координатах
найти:  найдём найти
сборник:  сборники
верно:  верно
параметрический:  параметрическом параметрической
отсутствие:  отсутствие
подать:  подан
раскрыть:  раскрыть
часто:  часто
получение:  получения
получаться:  получается получались
старое:  старое
хороший:  хороший лучшего
какой:  какие
базовый:  базовыми базовому
решение:  решение решении решением решения решений
форум:  форум форуме
книга:  книги книга
придирка:  придирку придирки
интуитивно:  интуитивно
сонаправить:  сонаправлены сонаправлен сонаправленными
провести:  провести
многий:  многим
дополнительный:  дополнительное дополнительная
научный:  научному
замечание:  замечанию
теоретический:  теоретического теоретические теоретической теоретическую
вынести:  вынести
задание:  задание задания
раздел:  разделе разделы
справедливый:  справедлив справедливы справедлива
вращение:  вращения
полениться:  поленюсь
привет:  привет
ненужный:  ненужных
копирование:  копирование
давать:  давайте
использовать:  используют используем использовать используйте
привыкать:  привыкать
разрыв:  разрыва
свободный:  свободным свободных свободны свободный свободными свободные свободного
выражение:  выражения выражение
использоваться:  используются использоваться
своеобразный:  своеобразный
перемещение:  перемещения
необходимость:  необходимости
набивать:  набиваем
грубо:  грубо
отблагодарить:  отблагодарить
являться:  являются является
технический:  технический
байес:  байеса
упростить:  упростит
простой:  проще прост простейших простыми просты
решать:  решать
точность:  точности
перечитать:  перечитать
класс:  класса
результат:  результат результатам результате
теория:  теория теории
отсутствовать:  отсутствует
называть:  называемый называют называть называемым
нулевой:  нулевым нулевого
умножить:  умножить
избежание:  избежание
двумерный:  двумерная
задать:  заданной заданы задайте
циркуляция:  циркуляция
непосредственно:  непосредственно
слева:  слева
отдельный:  отдельные
лежать:  лежат
плоскость:  плоскости плоскость
эстет:  эстеты
общий:  общим общая общем
странно:  странно
получиться:  получится получился
оставить:  оставить
поздний:  позже
определителяй:  определителяи
итог:  итогу
итоговый:  итоговую
закон:  законы
справа:  справа
первый:  первым первой первая первом первого первый
графический:  графическое графический
утыкаться:  утыкается
самый:  самым
переобозначить:  переобозначить переобозначив
впечатление:  впечатление
корень:  корня корнем корни корней
единичный:  единичные единичный единичных единичному
последовательно:  последовательно
действие:  действий действия
вероятность:  вероятностей вероятность вероятности
записывать:  записывают записываем
заключение:  заключение
уравненийв:  уравненийв
ортогональность:  ортогональность
ограничиться:  ограничусь
иметь:  имеют имеет
называться:  называются называется
отрезок:  отрезок отрезка отрезков отрезком
количество:  количества количество
грин:  грина
суть:  сути
эйлер:  эйлера
иной:  иное иной
насыщенный:  насыщенная
запятая:  запятой
дискретный:  дискретный
направить:  направленный направленных направлены направлен
знакочередоваться:  знакочередующиеся
выполнение:  выполнением
доля:  доли
ситуация:  ситуациях
пожалуй:  пожалуй
практически:  практически
сложный:  сложной сложнее сложные сложных
сверх:  сверх
приблизить:  приближенного приближенные приближенное
работать:  работает работают
фурье:  фурье
дать:  дан дано данные даны
поле:  поля
посредством:  посредством
гипотеза:  гипотез гипотеза гипотезы
стилистика:  стилистика
доработка:  доработкой
демонстрация:  демонстрация
свойство:  свойства свойство
исходный:  исходной исходному
добавиться:  добавится
исследование:  исследование
начинаться:  начинается
весь:  всем
вариация:  вариации
пойти:  пойдет пойдёт
основа:  основы основе
слишком:  слишком
переходить:  переходим
интервал:  интервалы
кош:  коши
параграф:  параграфа параграфе
нарисовать:  нарисовать нарисует
чайник:  чайников чайникам
вычисленияс:  вычисленияс
аналитический:  аналитический аналитическая аналитическим аналитическое аналитической
полюбить:  полюбят
матричный:  матричные матричных матричный
заметить:  заметили заметьте
ответ:  ответе ответ ответы
однородный:  однородные однородным
существенный:  существенное
вычислить:  вычислить
очень:  очень
записать:  запишу запишем записать запишите
матрица:  матрицу матрицы матрицами
испытанияй:  испытанияи
интегралыть:  интегралыв
привыкнуть:  привык привыкли
перегруппировка:  перегруппировка
верхний:  верхние
параллельность:  параллельности
помощь:  помощью помощь
начало:  начало начала началом начале
вариационный:  вариационный
элементарный:  элементарных элементарные
практиковаться:  практикуется
заморачиваться:  заморачиваются
отложить:  отложить отложите отложим отложу
блог:  блог
высокий:  высших высшей высшая
школа:  школы школе школа
помнить:  помнить помню
формулироваться:  формулируется
последовательность:  последовательности последовательностей
пространство:  пространстве пространства
удобный:  удобный
путь:  путь
перечисляться:  перечисляются
курс:  курс курсе курсом
сообщить:  сообщите
понижение:  понижение понижением
выражаться:  выражается выражаются
центр:  центр
теорема:  теоремами теорему теоремы
автомат:  автомате
последний:  последняя
сложение:  сложения сложение
позволить:  позволит
узнать:  узнаем
каждый:  каждому каждая каждую
доказательство:  доказательств доказательствами
считаться:  считаются
визуальный:  визуальное
пробовать:  пробуем
затем:  затем
преимущественно:  преимущественно
сомневаться:  сомневался
линейнойкорреляционный:  линейнойкорреляционной
туда:  туда
время:  время времени
сила:  силу силы
прилагательное:  прилагательное
почему:  почему
распределениякритерия:  распределениякритерий
произведение:  произведением произведение
несобственный:  несобственные
выполнять:  выполнять
зрение:  зрения
ссылаться:  ссылаемся
процесс:  процесс
параллельный:  параллельным параллельных
касательная:  касательная
задачис:  задачис
разный:  разных разный разные
правило:  правила правил правилу правило правиле
функциия:  функциии
возможно:  возможно
степенной:  степенного степенные
функцийдвуха:  функцийдвух
выборка:  выборке
уменьшаться:  уменьшается
ортый:  орто
функцийнесколький:  функцийнескольких
чисто:  чисто
градус:  градусов
понять:  понять поймёте
разнокалиберный:  разнокалиберными
деление:  деление деления
квадрат:  квадрат квадратов
обозначить:  обозначен
множественнойлинейный:  множественнойлинейной
тема:  темы
распределение:  распределение распределения
забывать:  забываем
прибытие:  прибытия
задачипо:  задачипо
аргумент:  аргументом
востребовать:  востребованную
видно:  видно
сложить:  сложить
краткий:  кратчайшие
идти:  идет идёт шла
вариант:  вариант варианта
километр:  километры
хотеться:  хотелось
примечание:  примечание
выкладка:  выкладки
зависимый:  зависимые
отклонение:  отклонение
вешалка:  вешалка
рисунок:  рисунка
таблица:  таблицы
вполне:  вполне
случайный:  случайных случайные
предварительно:  предварительно
коллинеарный:  коллинеарный коллинеарными коллинеарны коллинеарных коллинеарные
дуга:  дуги
частность:  частности
отрезкать:  отрезкав
дивергенция:  дивергенция
спасибо:  спасибо
пространственный:  пространственного
сайт:  сайт сайты сайта
наш:  наш
графика:  графики графика
спешить:  спешите
недостаточно:  недостаточно
напугать:  напугаете
причина:  причине
расположить:  расположены
возрастание:  возрастание
эмпирический:  эмпирические
найтись:  нашлось
место:  месте местом местами
этот:  этих
аналогично:  аналогично
характерный:  характерно
потребоваться:  потребуется
свершиться:  свершилось
научиться:  научитесь научиться
иррациональный:  иррациональных
определение:  определению определение определений определения
квадратичнуюформ:  квадратичнуюформу
карта:  карта
господин:  господа
гипербола:  гипербола
равно:  равно
свобода:  свобода свободу
начертить:  начертить
остроумный:  остроумная
они:  ними ими
включить:  включу
обозначение:  обозначение обозначении обозначения
логика:  логики
спирмена:  спирмена
дотошно:  дотошно
обратить:  обратили обратите
вид:  виду виды виде вида
специально:  специально
лишь:  лишь
св:  св
масса:  массу
пара:  пара
достаточно:  достаточно
показательный:  показательное
преобразование:  преобразования преобразований
рекомендовать:  рекомендуемые рекомендую
диффура:  диффурами
соответствующий:  соответствующие
весьма:  весьма
сдача:  сдачи
вычисление:  вычисление вычислений
множество:  множество множества
учебный:  учебное учебной
представлять:  представляет
статистика:  статистика
бумага:  бумаге
биномиальный:  биномиальное
выводиться:  выводятся
повторить:  повторю
пренебрегать:  пренебрегать
линиюв:  линиюв
открывать:  открываемый
встречаться:  встречающиеся встречаются
самостоятельный:  самостоятельного
извиняться:  извиняюсь
везде:  везде
фундамент:  фундамент
смысл:  смысл
решить:  решить решат
том:  томах
девять:  девять
дуприближённо:  дуприближённо
добрый:  доброе
определённый:  определённой определенный определенного
информация:  информации информацию
наклонить:  наклонена
асимптота:  асимптоты
раздевалка:  раздевалки
событие:  события
пифагор:  пифагора
повторный:  повторные
выполнить:  выполните выполню
указать:  указано
б:  б
геометрический:  геометрическими геометрическая геометрическое
корректный:  корректными
освоить:  освойте освоить
базисный:  базисным базисному базисные
состоять:  состоит
ориентировать:  ориентирован
забавно:  забавно
фнп:  фнп
ум:  ум
простейшее:  простейшие простейшими
часть:  частям части
знакомый:  знакомые знакомы знакомо
двойной:  двойные двойной
малопонятный:  малопонятный
несобство:  несобств
нелинейный:  нелинейная
применить:  применить
рисовать:  рисовать рисуйте
линейка:  линейкой
преобразованиеквадратичный:  преобразованиеквадратичной
заключить:  заключен
функциональный:  функциональные
последствие:  последствия
абсолютный:  абсолютная
коллинеарность:  коллинеарность коллинеарности
сложенияй:  сложенияи
сказать:  сказано сказать сказали скажу
куб:  куб
регрессия:  регрессии регрессия
вычислительный:  вычислительных
исчисление:  исчисления
откладывать:  откладывать
дверь:  дверей двери
применительно:  применительно
вложить:  вложить
зачастую:  зачастую
локальный:  локальная
понятие:  понятиями понятия понятие
настоятельно:  настоятельно
крутой:  крутое
ожидание:  ожидание
согласиться:  согласитесь
лаплас:  лапласа
такой:  таким такие такое такого такая таких
перегиб:  перегиба
предыдущий:  предыдущем
сходимость:  сходимости сходимость
представить:  представьте
комплекс:  комплекс
ду:  ду
далее:  далее
делать:  делать
обладать:  обладает
коэффициент:  коэффициент
неопределённый:  неопределенный неопределенном
дробь:  дробей
собственный:  собственные собственную
признак:  признак признаки
соображение:  соображений
палочка:  палочку
зелёный:  зеленая
поэтому:  поэтому
разделить:  разделить
практика:  практике
вместо:  вместо
разумеется:  разумеется
менять:  меняет
увидеть:  увидите
хватить:  хватит
складываться:  складывалось
малиновый:  малиновая
дама:  дамы
коль:  коль
асимметрия:  асимметрия
скажем:  скажем
главный:  главную
сводиться:  сводящиеся
собственно:  собственно
замена:  замены
краткость:  краткости
сонаправленность:  сонаправленность
методичка:  методички
например:  например
решенияопределённый:  решенияопределенных
выглядеть:  выглядит
хотя:  хотя
короткий:  короткое
приоритет:  приоритет
вверху:  вверху
коэффициентковариация:  коэффициентковариации
зачёт:  зачета
обозначать:  обозначает
лоб:  лбу
желание:  желании
приводить:  приводить
абсолютно:  абсолютно
лопиталя:  лопиталя
крайне:  крайне
обычно:  обычно
жирный:  жирным
досадный:  досадно
ставить:  ставим ставят
поляформула:  поляформула
просить:  прошу
фехнера:  фехнера
эффективный:  эффективные
условный:  условные
ненулевой:  ненулевых ненулевого
эллипс:  эллипс
профессор:  профессору
разность:  разности
версия:  версии
даламбер:  даламбера
повторнойя:  повторнойи
естественно:  естественно
рассказать:  рассказал
делиться:  делится
комплексный:  комплексные комплексного комплексный комплексными
нормировать:  нормированный
ранг:  ранг
кривая:  кривой
несвободный:  несвободные
тяжестиплоска:  тяжестиплоской
задавать:  задают задаваемые
сантиметр:  сантиметры
скрывать:  скрывать
проверка:  проверка
нуль:  нули нулю
преподаватель:  преподаватель преподавателя
носить:  носит
построить:  построить построенный
вышмат:  вышмата
результирующий:  результирующему результирующего
внимание:  внимание
лейбниц:  лейбница
неравенство:  неравенства
поток:  поток
кто:  кого
алгебраический:  алгебраических алгебраический
эквивалентный:  эквивалентное
медиана:  медиана
привязать:  привязан
направлениюй:  направлениюи
гостевой:  гостевая
многовато:  многовато
скоро:  скоро
грамотный:  грамотным
перемещать:  перемещать
кроме:  кроме
аккуратно:  аккуратно
говорить:  говорить говоря
понятно:  понятно
вывод:  вывод
главное:  главное
внутригрупповаяй:  внутригрупповаяи
он:  нём
выделять:  выделяют
учебник:  учебник учебнике
существовать:  существует
прямоугольник:  прямоугольников
эксцессэмпирический:  эксцессэмпирического
изложение:  изложения изложение
запомниться:  запомнятся
оценка:  оценка оценки
криволинейный:  криволинейные
различный:  различных
записываться:  записываются
библиотека:  библиотека
наименьшеезначение:  наименьшеезначения
вычислимый:  вычислим
минимальный:  минимальные
системылинейный:  системылинейных
нужно:  нужно
принципиальный:  принципиальное
зависимость:  зависимость
другой:  другие
математически:  математически
физика:  физики
замкнутый:  замкнутому
заморочка:  заморочек
очевидный:  очевидно
сей:  сия
показатель:  показатели
отличие:  отличие
небезызвестный:  небезызвестной
сильно:  сильно
площадьс:  площадьс
ранее:  ранее
любить:  любите
многочисленный:  многочисленными
мастерская:  мастерскую
убыванией:  убываниеи
повышенный:  повышенной
статистический:  статистическая статистические
также:  также
интегрирование:  интегрирование
легко:  легко
рациональный:  рациональные
читать:  читайте
некоторый:  некоторых некоторое некоторые
интервальный:  интервальный
институт:  института
противоположно:  противоположно
итак:  итак
соответственно:  соответственно
г:  г
вообще:  вообще
рука:  руку руки
лично:  лично
оценкия:  оценкии
неявный:  неявной
неточный:  неточным
несобственныхинтеграл:  несобственныхинтегралов
вероятностибиномиальный:  вероятностибиномиального
род:  рода
выраженный:  выражен
гаусс:  гаусса
автопилот:  автопилоте
остаться:  останутся останется
полезно:  полезно
выразить:  выразить
точно:  точно
экстремальный:  экстремальные
нормаль:  нормали
определитель:  определитель
выпуклость:  выпуклость
автор:  авторы автор автора
элемент:  элементы
вынесение:  вынесение
подраздел:  подразделу
интересно:  интересно
менее:  менее
сложность:  сложности
перпендикулярность:  перпендикулярности
значенияй:  значенияи
полнота:  полноту
справедливо:  справедливо
пособие:  пособие
кстати:  кстати
классическоеопределение:  классическоеопределение
инормаль:  инормаль
пирамида:  пирамида
видимо:  видимо
интересный:  интересной
понимание:  понимания пониманию
цель:  целях
отмечать:  отмечал
разобраться:  разобрались
дифференциальный:  дифференциальные
уравненияс:  уравненияс
онлайн:  онлайн
геометрия:  геометрии геометрия
работа:  работа
студенческий:  студенческая
новый:  новому
произвольныйтройный:  произвольныйтройной
ниже:  ниже
разложить:  разложить
дизайн:  дизайна
это:  это
допустить:  допустил допустить
поляй:  поляи
опечатка:  опечатку
переиздание:  переизданий
тратить:  тратить
метр:  метры
речь:  речь
формулировка:  формулировка
увеличиваться:  увеличивается
оговариваться:  оговаривается
направление:  направлении направление направления
методомоперационный:  методомоперационного
бесповторный:  бесповторной
наверняка:  наверняка
правильно:  правильно
компания:  компания
поклон:  поклон
л:  л
уметь:  умеют
вещь:  вещь вещи
важно:  важно
график:  графиков график
внизу:  внизу
привычный:  привычным
ед:  ед
рассматривать:  рассматриваемые рассматривали
касательный:  касательных
актуальный:  актуальны
разбираться:  разбираемся
стиль:  стиль стилю
типовыхзадача:  типовыхзадач
ранговойкорреляция:  ранговойкорреляции
сходство:  сходство
пешка:  пешек
поколение:  поколений
наизусть:  наизусть
страдать:  страдают
параллелепипед:  параллелепипед
переставлять:  переставлять
ошибиться:  ошибся
необходимый:  необходима необходимые
исследовать:  исследовать
показаться:  показаться
поверхность:  поверхности
образовать:  образуют
нелюбимый:  нелюбимый
линейныйкоэффициент:  линейныйкоэффициент
несобственныйинтеграл:  несобственныйинтеграл
указываться:  указываются
доступно:  доступно
удобство:  удобства
причём:  причём
логично:  логично
учиться:  учимся
затравка:  затравки
пройти:  пройти
перпендикулярный:  перпендикулярны
ипример:  ипримеры
возможный:  возможна
требоваться:  требуется требовалось
поверхностный:  поверхностные
фигура:  фигуры фигурами
следовать:  следовать следует
пуассон:  пуассона
изучение:  изучению
большой:  большое
потихоньку:  потихоньку
осмыслить:  осмыслить
математическоеожидание:  математическоеожидание
ставиться:  ставятся
неоднородный:  неоднородные
проверять:  проверяем
угол:  углом
думать:  думаю
кратное:  кратные
добраться:  добрались
системудифференциальный:  системудифференциальных
масштаб:  масштабе
помимо:  помимо
алгоритм:  алгоритм
ходить:  ходите
квадратичный:  квадратичные
объём:  объем
предполагаться:  предполагается
проверить:  проверить
разделиться:  разделилось
усвоение:  усвоения
поскольку:  поскольку
гипергеометрическоераспределение:  гипергеометрическоераспределение
пояснение:  пояснения
раз:  раза
удаться:  удастся
подробно:  подробно
равномерный:  равномерная равномерное
занятный:  занятный
треугольный:  треугольная
сэкономить:  сэкономит
получить:  полученный получи
пожалуйста:  пожалуйста
инструментальный:  инструментальных
попутно:  попутно
отправление:  отправления
выпадать:  выпадать
привычка:  привычка
план:  плане
момент:  моментов
себя:  собой
программный:  программный
обширный:  обширной
окупиться:  окупится
сразу:  сразу
функциюкомплексный:  функциюкомплексной
картинка:  картинки
лишний:  лишней лишним
второгодник:  второгодникам
заодно:  заодно
мода:  мода
свойстваэлементарный:  свойстваэлементарных
считать:  считать
дэ:  дэ
калькулятор:  калькулятор калькуляторе
совершить:  совершило
оригинальность:  оригинальность
поддатый:  поддатым
движение:  движением
обстоятельный:  обстоятельной
явно:  явно
тренировка:  тренировки
предлагать:  предлагаю
действительно:  действительно
оборот:  оборота
экстремум:  экстремумы
горнера:  горнера
отмечаться:  отмечалось
шутка:  шуток
факт:  факты
предельно:  предельно
функцийв:  функцийв
вышеуказанный:  вышеуказанной
видеть:  видите
шифровать:  шифрую
размерность:  размерность
возведение:  возведение
кипеть:  кипит
обойтись:  обойдется
вычесть:  вычесть
чертить:  чертить
неотступно:  неотступно
лёгкий:  легче
понимать:  понимать
три:  трёх
дискретнойслучайный:  дискретнойслучайной
крамер:  крамера
пункт:  пунктом
выдержать:  выдержала
круглый:  круглых
базироваться:  базируются
правда:  правда
парабола:  парабола
путаница:  путаницы
строго:  строго
повторимый:  повторим
схожий:  схожи
тетрадный:  тетрадные
запретить:  запрещено
функциидвуха:  функциидвух
емелин:  емелин
широко:  широко
вычисленияопределенный:  вычисленияопределенных
пояснить:  пояснить
задачин:  задачина
замечательный:  замечательные
системый:  системыи
удовлетворяетлить:  удовлетворяетли
вуз:  вузе
неожиданный:  неожиданном
дурацкий:  дурацкий
присказка:  присказка
всякий:  всякий
применение:  применения
тригонометрический:  тригонометрических
обозначаться:  обозначается
аналитически:  аналитически
чётко:  чётко
рифма:  рифма
переместить:  переместить
выйти:  выйти
конкретный:  конкретный
детализация:  детализация
заданав:  заданав
порядок:  порядка порядков
всё:  всё
что:  чём
клетчатый:  клетчатой
лекция:  лекции
претендовать:  претендует
изобразить:  изобразим
стандартный:  стандартен
тройной:  тройные
противоположный:  противоположное
контуруформула:  контуруформула
внутри:  внутри
застёгивать:  застёгивать
создать:  создана
простота:  простоты
либо:  либо
огрех:  огрех
независимый:  независимые
тяжко:  тяжко
ученик:  учеников
добавить:  добавим
клинопись:  клинописью
попарно:  попарно
группа:  группы
сокращённо:  сокращенно
корреляция:  корреляции
заочник:  заочников
сложиться:  сложилась
пристроить:  пристроить
повторять:  повторяем
складывать:  складываем
равенство:  равенства
