техника:  технику техники
перемещаться:  перемещается
производный:  производные производная производной производную
предел:  предел пределы пределов пределам
небольшой:  небольшой
числовой:  числовые
точнее:  точнее
производныенеявно:  производныенеявно
длинный:  длиннее длинное
значение:  значение значениям значению
непрерывный:  непрерывной непрерывных непрерывная
общий:  общему общим общая
находить:  находить находили
формула:  формулы формулами формула формулу
смотреть:  см смотрит смотреть смотрят
определять:  определять
оттуда:  оттуда
прийтись:  придётся
канонический:  каноническому
отрезок:  отрезках
дифференциал:  дифференциалах дифференциала
больший:  наибольшее большая
выразить:  выразим
один:  одну
различный:  различные различных
образно:  образно
против:  против
означать:  означает означало
двигаться:  движется
подразумевать:  подразумевая
вогнутостья:  вогнутостьи
многий:  многих
выяснить:  выяснить
русло:  русла
профессия:  профессию
задува:  задува
перечислить:  перечислить
пусть:  пусть
умножение:  умножения
выполнимый:  выполним
система:  система системе систему системы
группировка:  группировок группировка
познакомиться:  познакомимся
условнаясходимость:  условнаясходимость
улица:  улицу улица
максимальный:  максимальным максимальное
угол:  угол углы углом
александр:  александр
ось:  ось оси осей
остаться:  осталось оставшиеся
напор:  напора
суммарный:  суммарного
который:  которые которыми который которая которой
скорость:  скоростей скорость скорости
линейный:  линейные линейная линейных линейной
упрощаться:  упрощается
раздел:  разделах
водопроводный:  водопроводный водопроводной
согласие:  согласия
знать:  знают
дуоперационный:  дуоперационным
сформулировать:  сформулировать
базис:  базисах базису базис
зависимостьвектор:  зависимостьвекторов
движение:  движения
снова:  снова
сначала:  сначала
свой:  своими своей свои
метод:  методы методом метод
страница:  страницу
вода:  воды
математический:  математическая математические математической
данные:  данных
нормальный:  нормальные нормальное нормальный нормальным нормального
призывать:  призываю
интеграл:  интеграл интегралу интегралов интегралы интеграла интеграле интегралам
урок:  урока уроке
разложение:  разложением разложение
исходящий:  исходящий
посмотреть:  посмотрели
уравнение:  уравнению уравнения уравнение уравнений
переход:  переход перехода
внутрь:  внутрь
желательно:  желательно
координатный:  координатным координатными координатных координатные координатную
сфера:  сферу
комната:  комнаты комнату комната комнате комнатой
малый:  малые наименьших
связь:  связь
ответить:  ответим
грустный:  грустный
применение:  применение
смысловой:  смысловому
внутренний:  внутренний внутренняя
уметь:  умеете умеют
интегральнаятеорема:  интегральнаятеоремы
некоторый:  некоторой некоторые
корнимногочлен:  корнимногочлена
логарифмический:  логарифмическая
условие:  условие условию
начать:  начнём начать
основной:  основные
бернулли:  бернулли
единица:  единицу единице единица единиц
полярный:  полярные полярных полярной
рассмотреть:  рассмотрим рассмотреть
спроецировать:  спроецируем спроецировать
ряд:  ряды ряда ряд рядов
уровень:  уровня
сигма:  сигму сигма
доверительный:  доверительные
сторона:  сторонами стороны сторону стороне стороной сторона
буква:  буквой
смысл:  смысле смысл
нечего:  нечему
определённый:  определённую определенный определенного
среднееквадратический:  среднееквадратическое
комбинационный:  комбинационная
декартов:  декартовой
научный:  научного
смешанноепроизведение:  смешанноепроизведение
функция:  функции функция функций функцию
вместе:  вместе
дисперсия:  дисперсия дисперсии дисперсию
школьный:  школьный
мы:  нам
треугольник:  треугольника треугольников треугольник
непростой:  непростое
прямоугольный:  прямоугольный
образ:  образом
непрерывнаяслучайный:  непрерывнаяслучайная
ибо:  ибо
прямо:  прямо
длина:  длина длины
мочь:  могут
знакопостоянство:  знакопостоянства
попробовать:  попробуйте
градиент:  градиент
удачно:  удачно
линия:  линия линии линию линиями
уличный:  уличной уличную
ладонь:  ладони
вспомнить:  вспомним
комбинаторика:  комбинаторике
полуось:  полуосью
измениться:  изменится измениться изменилось
случайнаявеличина:  случайнаявеличина
бесконечно:  бесконечно
вычисление:  вычислению вычисления вычисление
форма:  формы
равный:  равны равен равна
статья:  статьи
развернуть:  развернуть
перекрой:  перекроем
случай:  случаи случае
искомый:  искомую
обратный:  обратную обратная
рассматривать:  рассматривать рассматриваемых
особенность:  особенности
попасть:  попадёт
готовый:  готовых готово
нормаль:  нормаль нормалей нормали
просто:  просто
ещё:  ещё
порядок:  порядком порядок порядку порядка порядков
убедиться:  убедимся
поставить:  поставим поставить
тема:  тема тему
торчать:  торчит торчат
нахождение:  нахождения
грань:  граням грани грань
исключить:  исключено
производныефункция:  производныефункции
средний:  средняя
определённость:  определённости
пересечение:  пересечения
область:  области область
ссылка:  ссылке
поверхностный:  поверхностных поверхностного поверхностный поверхностные поверхностному
число:  числами числа
математик:  математика
переменный:  переменных переменной
пример:  пример примера примеров примере примеры
др:  др
несовместный:  несовместные
независимыеслучайный:  независимыеслучайные
модуль:  модулю
бутылка:  бутылку
следовательно:  следовательно
модель:  модель модели
непрерывность:  непрерывность
способ:  способами
верхний:  верхняя верхнюю
сечение:  сечение
функциис:  функциис
угодный:  угодно
полный:  полной полных полное
зеркало:  зеркало
второй:  втором второго
читатель:  читатели
значит:  значит
уменьшаться:  уменьшаться
пирсон:  пирсона
вопрос:  вопрос вопроса вопросы
вычислить:  вычислив вычислить
межгрупповой:  межгрупповая
ортогональный:  ортогональное ортогональны
ориентировать:  ориентированную ориентированный ориентированным ориентирована
нсв:  нсв
фильм:  фильм
проанализировать:  проанализировать проанализируйте
упасть:  упал
ход:  ходе ход
отрезка:  отрезке
величина:  величина величин величине величины
пройти:  прошло
поверхность:  поверхность поверхностей поверхностям поверхности
разрулить:  разрулить
она:  неё
детерминация:  детерминации
мысль:  мыслям
обязательно:  обязательно
тот:  тех той ту
отрицательный:  отрицательное отрицательной отрицательным
поток:  потоков потока поток
дифференциальныеуравнение:  дифференциальныеуравнения
название:  названия
прямой:  прямая прямой прямом прямую
взять:  возьмём
постоянный:  постоянных постоянной
стокс:  стокса
схема:  схема
соответствие:  соответствие
размер:  размеры размерам
предполагать:  предполагает
небо:  небо
дробовик:  дробовик
короткий:  короткие
математика:  математике математики
векторный:  векторное векторного
сам:  самом само самой
устраивать:  устраивать устраивает
вероятностия:  вероятностии
скалярный:  скалярное скалярного
значимость:  значимости
стрелочка:  стрелочку
мысленно:  мысленно
дать:  дана данная данной
вершина:  вершины
анализ:  анализа анализ
её:  её
частный:  частное частные
парный:  парной
перечислять:  перечислять
увеличивать:  увеличивать
найти:  найдём найти
несколько:  несколько
вращательный:  вращательного
сборник:  сборники
параметрический:  параметрическом параметрической
условный:  условную условные
часто:  часто
получаться:  получается
решение:  решение решением решения решений
место:  место
внешний:  внешнем внешних внешнее внешнему внешней внешняя внешний
форум:  форум форуме
книга:  книги книга
интуитивно:  интуитивно
полевой:  полевыми
содержательный:  содержательный
вектор:  векторы вектором векторов вектора векторами вектор
внимательный:  внимательны
вращение:  вращения
именно:  именно
принять:  принято
копирование:  копирование
разрыв:  разрыва
выражение:  выражения
совпадать:  совпадает
предпочесть:  предпочёл
максимум:  максимум
отблагодарить:  отблагодарить
сильный:  сильнее
байес:  байеса
простой:  проще прост
решать:  решать
двумерный:  двумерном двумерная двумерный
результат:  результат результате
теория:  теория теории
несвободный:  несвободный
дополнительно:  дополнительно
знаменательный:  знаменательный
равновесие:  равновесие
избежание:  избежание
задать:  заданной задайте
тело:  тела
циркуляция:  циркуляция
непосредственно:  непосредственно
лежать:  лежат лежит
плоскость:  плоскости плоскостью плоскостями плоскостей плоскость
убыть:  убыла
дуть:  дует дуть
замкнутый:  замкнутую замкнутому замкнута замкнутым
определителяй:  определителяи
итог:  итогу
расположить:  расположенная
согласно:  согласно
закон:  законы
штопор:  штопора
ситуация:  ситуацию ситуациях ситуации ситуация
вероятность:  вероятностей вероятность вероятности
уравненийв:  уравненийв
напрасно:  напрасно
грин:  грина
суть:  сути
эйлер:  эйлера
открытие:  открытий
годиться:  годится
дискретный:  дискретный
направить:  направленный направлен направленного
знакочередоваться:  знакочередующиеся
поделать:  поделать
сменить:  сменит
практически:  практически
произвольный:  произвольных произвольное произвольная
сложный:  сложной сложные сложных
фурье:  фурье
поле:  поля поле
треугольный:  треугольную треугольная
гипотеза:  гипотез гипотеза гипотезы
свойство:  свойства свойством
момент:  момент
исследование:  исследование
весь:  всем
точка:  точки точек точке
вариация:  вариации
основа:  основы основе основам
мало:  мало
интервал:  интервалы
кош:  коши
открыть:  откройте
выше:  выше
чайник:  чайников
каждый:  каждым каждой
вычисленияс:  вычисленияс
фигура:  фигур фигуры
ориентация:  ориентацию
матричный:  матричные матричных матричный
аддитивность:  аддитивности
заметить:  заметили заметьте
однородный:  однородные однородным
очень:  очень
матрица:  матрицу матрицы матрицами
испытанияй:  испытанияи
интегралыть:  интегралыв
научиться:  научимся научиться
перегруппировка:  перегруппировка
пойти:  пойдёт пойти
помощь:  помощью
начало:  начало
вариационный:  вариационный
блог:  блог
простейшее:  простейшим простейшие
высокий:  высших высшей высшая
произведение:  произведения произведение
вкручивать:  вкручиваете
пространство:  пространстве
удобный:  удобный удобнее
курс:  курс
быть:  будьте будут будем
начинающий:  начинающим
координата:  координаты координат координатах
сообщить:  сообщите
сделать:  сделать
аналитический:  аналитическая аналитической
понижение:  понижение понижением
определить:  определить
центр:  центр
протечь:  протекла протекло
призма:  призму призма призмы
вкладывать:  вкладывать
узнать:  узнаем
свободный:  свободен
самый:  самую
пересекаться:  пересекаются
затем:  затем
преимущественно:  преимущественно
построение:  построение
предложить:  предложенную
называть:  называть
линейнойкорреляционный:  линейнойкорреляционной
действие:  действия
туда:  туда
пора:  пор
тупой:  тупой
распределениякритерия:  распределениякритерий
дальнейший:  дальнейшее
несобственный:  несобственные
выбрать:  выбранной выбрать выберем
повестись:  повелось
полностью:  полностью
касательная:  касательная
ответ:  ответ
задачис:  задачис
указывать:  указывает
правило:  правила правилу правило
функциия:  функциии
возможно:  возможно
степенной:  степенного степенные
функцийдвуха:  функцийдвух
выборка:  выборке
функцийнесколький:  функцийнескольких
градус:  градусов
квадрат:  квадрат квадратов
множественнойлинейный:  множественнойлинейной
символический:  символический
плоский:  плоская
единичный:  единичный единичной единичного
распределение:  распределение распределения
конкретный:  конкретнее конкретных
этот:  этими этих эта
задачипо:  задачипо
два:  двумя
востребовать:  востребованную
приблизить:  приближенные
учиться:  учащиеся учимся
вариант:  вариант
остальной:  остальным
графически:  графически
сосредоточиться:  сосредоточиться
примечание:  примечание
пункт:  пункта
следующий:  следующего следующий
зависимый:  зависимые
путём:  путём
отклонение:  отклонение
сквозняк:  сквозняк
таблица:  таблицы
вполне:  вполне
случайный:  случайных случаен случайные
время:  времени
течение:  течения течение
воздух:  воздух воздуха
материал:  материала материалов материалы
дуга:  дуги
частность:  частности
численно:  численно
отрезкать:  отрезкав
дивергенция:  дивергенция
чертёж:  чертежа чертёж чертеже
течь:  течь
сайт:  сайт сайты сайта
наш:  наш нашего наша
графика:  графики графика
оформление:  оформления
причина:  причине
возрастание:  возрастание
эмпирический:  эмпирические
абсолютный:  абсолютной абсолютная абсолютный
найтись:  нашлось
характерный:  характерно
громоздкий:  громоздкие
иррациональный:  иррациональных
определение:  определению определения
получиться:  получился
квадратичнуюформ:  квадратичнуюформу
карта:  карта
косинус:  косинус косинуса
гипербола:  гипербола
начертить:  начертить
пирамида:  пирамиды пирамиду пирамида
они:  ними
логика:  логики
спирмена:  спирмена
вид:  виду виды вид виде
известный:  известная
лишь:  лишь
обход:  обхода
св:  св
иметь:  имеет
сумма:  суммы сумму сумма
четыре:  четырёх
показательный:  показательное
преобразование:  преобразования преобразований
соответствовать:  соответствует соответствующий соответствуют
кружочек:  кружочек
положительный:  положительную положительной положительным
диффура:  диффурами
образовать:  образует образующего
перейти:  перейдём перейдите
противоположный:  противоположную противоположном
множество:  множество множества
использовать:  используем использовать используйте
представлять:  представляет
статистика:  статистика
параллельный:  параллельна параллельны
призмочка:  призмочке
биномиальный:  биномиальное
линиюв:  линиюв
отношение:  отношении
хотеться:  хочется
страшный:  страшный
любопытный:  любопытные
ветер:  ветер
окно:  окно окна
решить:  решить
дуприближённо:  дуприближённо
прочитать:  прочитайте
информация:  информации
асимптота:  асимптоты
уходить:  уходит
событие:  события
повторный:  повторные повторным
воздержаться:  воздержусь
б:  б
фнп:  фнп
потренироваться:  потренируйтесь
часть:  частям часть части
достигаться:  достигается
гидродинамический:  гидродинамический гидродинамическом
двойной:  двойные двойной
проецирование:  проецирование
несобство:  несобств
настать:  настал
нелинейный:  нелинейная
преобразованиеквадратичный:  преобразованиеквадратичной
нижний:  нижней
функциональный:  функциональные
ручка:  ручки
классический:  классический
геометрический:  геометрическая геометрическое
встречаться:  встречаются встречалась
водоворот:  водоворот
сложенияй:  сложенияи
регрессия:  регрессии регрессия
контроль:  контроль
исчисление:  исчисления
зачастую:  зачастую
локальный:  локальная
сказать:  сказать скажу
ожидание:  ожидание
лаплас:  лапласа
такой:  таким такое
перегиб:  перегиба
сходимость:  сходимости сходимость
представить:  представьте представить
задача:  задачи
удивительный:  удивительных
ду:  ду
делать:  делать
коэффициент:  коэффициент
неопределённый:  неопределенный неопределенном
дробь:  дробей
собственный:  собственные
признак:  признак признаки
запутаться:  запутаться
соображение:  соображений
поэтому:  поэтому
асимметрия:  асимметрия
главный:  главную
ставить:  ставить
представимый:  представим
сводиться:  сводящиеся
собственно:  собственно
замена:  замены
характер:  характер
нисколько:  нисколько
записать:  запишем
маленький:  меньше
например:  например
решенияопределённый:  решенияопределенных
выглядеть:  выглядит
мерило:  мерилом
хотя:  хотя
изобразить:  изобразил изобразим
коэффициентковариация:  коэффициентковариации
утечка:  утечка
проекция:  проекцией проекции проекцию проекция
ограничивать:  ограничивает
лопиталя:  лопиталя
крайне:  крайне
обычно:  обычно
стандартный:  стандартными стандартный
прочувствовать:  прочувствовали
поляформула:  поляформула
наверное:  наверное
фехнера:  фехнера
заниматься:  занимались
эффективный:  эффективные
эллипс:  эллипс
разговор:  разговора
хороший:  лучшего хорошего
количество:  количество
даламбер:  даламбера
говорящий:  говорящие
теорема:  теоремы
повторнойя:  повторнойи
комплексный:  комплексные комплексного комплексный комплексными
ранг:  ранг
кривая:  кривой
тяжестиплоска:  тяжестиплоской
зато:  зато
понятный:  понятнее
проверка:  проверка
построить:  построить
производная:  производными
внимание:  внимание
лейбниц:  лейбница
лениться:  ленимся
невероятный:  невероятная невероятные
неравенство:  неравенства
отдельный:  отдельная
открытый:  открытое
предыдущий:  предыдущего предыдущему
медиана:  медиана
глаз:  глазах
направлениюй:  направлениюи
гостевой:  гостевая
стать:  станет
переписать:  перепишем
кроме:  кроме
понятно:  понятно
внутригрупповаяй:  внутригрупповаяи
алгебра:  алгебры
добавлять:  добавляют
наоборот:  наоборот
прямоугольник:  прямоугольников
эксцессэмпирический:  эксцессэмпирического
оценка:  оценка оценки
криволинейный:  криволинейные
библиотека:  библиотека
объединять:  объединяет
сводить:  сводить
возможность:  возможности
наименьшеезначение:  наименьшеезначения
сила:  силы
вычислимый:  вычислим
интересный:  интереснее
системылинейный:  системылинейных
нужно:  нужно
обозначение:  обозначению обозначения
видеть:  вижу
зависимость:  зависимость
другой:  другие другую
математически:  математически
эф:  эф
физика:  физики
октант:  октанте
очевидный:  очевидно очевиден
благо:  благо
показатель:  показатели
энтузиазм:  энтузиазма
сильно:  сильно
площадьс:  площадьс
ранее:  ранее
убыванией:  убываниеи
повышенный:  повышенной
статистический:  статистическая статистические
штиль:  штиль
также:  также
интегрирование:  интегрирование интегрирования
рациональный:  рациональные рациональную
привести:  приведёт привести
нуль:  нулю нуля
противоречие:  противоречию
интервальный:  интервальный
противоположно:  противоположно
соответственно:  соответственно
рука:  руку
вообще:  вообще
жидкость:  жидкости жидкостью
оценкия:  оценкии
неявный:  неявной
несобственныхинтеграл:  несобственныхинтегралов
вероятностибиномиальный:  вероятностибиномиального
род:  рода
гаусс:  гаусса
полезно:  полезно
острый:  острые острый
экстремальный:  экстремальные
определитель:  определитель
выпуклость:  выпуклость
элемент:  элементы
сложность:  сложности
значенияй:  значенияи
никуда:  никуда
некий:  некоего
объяснять:  объяснять
нужный:  нужной
первый:  первого
труба:  трубы
кстати:  кстати
уйти:  ушло
классическоеопределение:  классическоеопределение
инормаль:  инормаль
нежелательно:  нежелательно
находиться:  находятся находится
наслать:  нашли
аналогичный:  аналогичный аналогичных
автор:  автор автора
понимание:  понимания
оказаться:  окажется
поступать:  поступает
столько:  столько
дифференциальный:  дифференциальные
уравненияс:  уравненияс
онлайн:  онлайн
гидродинамика:  гидродинамики
проецироваться:  проецируется
геометрия:  геометрии геометрия
работа:  работа
широкий:  широкое
фрагмент:  фрагмент
новый:  новому
произвольныйтройный:  произвольныйтройной
ниже:  ниже
дизайн:  дизайна
ограниченный:  ограниченную
это:  это
поляй:  поляи
опечатка:  опечатку
привычный:  привычного привычным привычную
продолжать:  продолжаем
речь:  речь
данный:  данном данный
направление:  направлении направление направления направлению
коротенький:  коротеньким
методомоперационный:  методомоперационного
поступить:  поступило
бесповторный:  бесповторной
ошибка:  ошибку
л:  л
обойтись:  обойтись
секунда:  секунд
касательный:  касательных
продолжить:  продолжим
каноничный:  каноничного
типовыхзадача:  типовыхзадач
прошедшее:  прошедшее
воспользоваться:  воспользоваться
ранговойкорреляция:  ранговойкорреляции
прийти:  пришло
эквивалентный:  эквивалентно
сколько:  сколько
исследовать:  исследовать исследуете
вытечь:  вытекло
линейныйкоэффициент:  линейныйкоэффициент
изложение:  изложение
несобственныйинтеграл:  несобственныйинтеграл
доступно:  доступно
причём:  причём
логично:  логично
задавать:  задаваемые
ипример:  ипримеры
требоваться:  требуется
пуассон:  пуассона
приводиться:  приводится
абстрагироваться:  абстрагируемся
таки:  таки
несмотря:  несмотря
фактически:  фактически
математическоеожидание:  математическоеожидание
школа:  школа
физический:  физических
неоднородный:  неоднородные
титаник:  титаник
кратное:  кратные
определиться:  определился
системудифференциальный:  системудифференциальных
пускать:  пускаем
последовательность:  последовательностей
комнатный:  комнатную
квадратичный:  квадратичные
поподставлять:  поподставлять
ассоциироваться:  ассоциируется
объём:  объем
предполагаться:  предполагается
проверить:  проверить
килограмм:  килограммов
поскольку:  поскольку
гипергеометрическоераспределение:  гипергеометрическоераспределение
раз:  раза
ваш:  ваших
обратить:  обратите
понятие:  понятие
равномерный:  равномерная равномерное
исключительно:  исключительно
получить:  полученный получили получи
добавить:  добавлю
вытянуть:  вытяните
обозначать:  обозначать
пожалуйста:  пожалуйста
следовать:  следует
успеть:  успел успело
обстоять:  обстоит
себя:  собой
однозначно:  однозначно
функциюкомплексный:  функциюкомплексной
напоминать:  напоминаю
мода:  мода
свойстваэлементарный:  свойстваэлементарных
проходить:  проходят
калькулятор:  калькулятор
принцип:  принципу
свести:  сведём
действительно:  действительно
прочий:  прочих
экстремум:  экстремумы
горнера:  горнера
шутка:  шуток
функцийв:  функцийв
довольно:  довольно
начинать:  начинаем
формулировка:  формулировкам
распространиться:  распространилось
три:  трёх
дискретнойслучайный:  дискретнойслучайной
знак:  знак
горячий:  горячим
крамер:  крамера
чёрточка:  чёрточкой
парабола:  парабола
путаница:  путаницы
строго:  строго
запретить:  запрещено
к:  ко
функциидвуха:  функциидвух
тонна:  тонны
емелин:  емелин
произойти:  произошла
вычисленияопределенный:  вычисленияопределенных
источник:  источниках
задачин:  задачина
замечательный:  замечательные
системый:  системыи
удовлетворяетлить:  удовлетворяетли
сей:  сих
тригонометрический:  тригонометрических
обозначаться:  обозначается
аналитически:  аналитически
наклон:  наклон
водный:  водного
понимать:  понимают
заданав:  заданав
кран:  кран
всё:  всё
тройной:  тройные
деление:  деления
являться:  является
контуруформула:  контуруформула
график:  график
дело:  дела деле дело
скопировать:  скопирую
слабый:  слабое
догадываться:  догадываетесь
тык:  тыка
либо:  либо
рекомендовать:  рекомендую
независимый:  независимые
тяжко:  тяжко
зет:  зет
бурный:  бурный
корреляция:  корреляции
слово:  слово
заочник:  заочников
разный:  разные
отнести:  отнести
говорить:  говоря
повторять:  повторяем
плюсик:  плюсик
ждать:  ждёт
экран:  экраном
