основный:  основными
формальный:  формальна формальной
полезный:  полезен
провести:  проведённую
математический:  математических математическую математическая математические математический математической
неоднократно:  неоднократно
производный:  производные производная производной производную
предел:  предел пределы пределов
конъюнкция:  конъюнкция конъюнкцию конъюнкцией
обеспечение:  обеспечение
числовой:  числовые
точнее:  точнее
производныенеявно:  производныенеявно
значение:  значение
скорее:  скорее
курсовой:  курсовую курсовой
обозначать:  обозначают
поддерживать:  поддерживает
формула:  формулы формулами формулой формуле формула формулах
смотреть:  см
погаснуть:  погаснет
сухо:  сухо
канонический:  каноническому
сталкиваться:  сталкивались
два:  две двумя двух
дифференциал:  дифференциалах дифференциала
больший:  наибольшее большего большее большая
нередко:  нередко
многие:  многие
один:  одну одно одного одной одном
указать:  указав
означать:  означает означают
учить:  учить
квадратный:  квадратная
число:  число числами числа
вогнутостья:  вогнутостьи
становиться:  становится
особенность:  особенность
формулировка:  формулировки формулировка
случай:  случай случае случаях
штанга:  штангу штангой
профессия:  профессию
подключение:  подключение подключением
пусть:  пусть
применимый:  применимы применима
умножение:  умножения умножение
система:  система системе систему системы
группировка:  группировок группировка
познакомиться:  познакомимся
условнаясходимость:  условнаясходимость
путать:  путать
окружность:  окружность
слово:  словами слову слова
прикол:  прикола
александр:  александр
высказывательный:  высказывательные высказывательная высказывательной
остаться:  осталось
дорогой:  дорогого
существование:  существование существования
выучить:  выучил
который:  которые которыми котором который которая которое которую которым которых которой
ложь:  ложью лжи ложь
линейный:  линейные линейная линейных линейной
вниз:  вниз
работа:  работ работе работа работу
равенство:  равенство равенства
быть:  суть
улица:  улице
обычный:  обычных обычная обычной обычный
запись:  записи запись
согласие:  согласия
союз:  союз
стандартный:  стандартную стандартные
решать:  решаем решать
дуоперационный:  дуоперационным
пример:  примером пример примера примеров примере примеры
необходимый:  необходимым необходимое необходима необходимой необходимого необходимые
из:  изо
базис:  базисах базису базис
импликация:  импликацией импликации импликацию импликация
предположить:  предположить
зависимостьвектор:  зависимостьвекторов
оно:  оно
метод:  методы методом метод
тема:  теме
страница:  страницу страницы
намеренно:  намеренно
данные:  данных
интеграл:  интеграл интегралов интегралы интеграла интеграле
урок:  урока урок уроку
сдать:  сдал сдать сдано сдана сданы сдаст сдашь
разложение:  разложением разложение
битый:  бит
современный:  современного
уравнение:  уравнению уравнения уравнение уравнений
переход:  переход
утверждение:  утверждение
малый:  малые наименьших
связь:  связь связей
петров:  петрова
рассуждение:  рассуждениях рассуждения
нормальный:  нормальное
интегральнаятеорема:  интегральнаятеоремы
корнимногочлен:  корнимногочлена
логарифмический:  логарифмическая
условие:  условие условием условия
условно:  условно
парта:  парты
библиотека:  библиотеку библиотека
основной:  основные
бернулли:  бернулли
достаточный:  достаточного достаточное достаточным достаточна достаточные
полярный:  полярные полярных полярной
ложность:  ложность
рассмотреть:  рассмотрим рассмотренный рассмотреть рассмотрю рассмотренных
ряд:  ряды ряда ряд рядов
истина:  истину истина истины истиной истине
уровень:  уровня
обоснование:  обоснования обоснованию
должный:  должны должно
импликационный:  импликационной
истинность:  истинности истинность
доверительный:  доверительные
смысл:  смысле смысл смыслом
сгореть:  сгоревший
стараться:  стараются старайтесь
делиться:  делилось делится
среднееквадратический:  среднееквадратическое
транзистор:  транзисторов
тип:  типа
посвятить:  посвящён
тривиальный:  тривиальный
иной:  ином иного иными
комбинационный:  комбинационная
истинный:  истинных истинной истинным истинные истинное истинна истинны
листок:  листок
смешанноепроизведение:  смешанноепроизведение
функция:  функции функция функций
дисперсия:  дисперсия дисперсии дисперсию
занести:  занести
дерзать:  дерзайте
школьный:  школьный школьной
класс:  классов
мы:  нам
треугольник:  треугольника треугольник
прямоугольный:  прямоугольный прямоугольным
образ:  образом
вывод:  вывода вывод
непрерывнаяслучайный:  непрерывнаяслучайная
вдумываться:  вдумываемся
другой:  других другое другие другую
ибо:  ибо
единственно:  единственно
длина:  длина
процесс:  процессе
материал:  материал материалов материалы
мочь:  могут
знакопостоянство:  знакопостоянства
проводить:  проводить
доопределить:  доопределить
градиент:  градиент
диск:  дисками
линия:  линия линии линиями
полагать:  полагаем
вспомнить:  вспомним
наворотить:  навороченная
комбинаторика:  комбинаторике
случайнаявеличина:  случайнаявеличина
маша:  маша маши маше
обоюдоострый:  обоюдоострым
бесконечно:  бесконечно
форма:  формы форма
задача:  задачу задачи задач
отметить:  отметить
делимость:  делимости делимость
значок:  значком
обратный:  обратную обратная обратной
сыро:  сыро
читаемый:  читаем
завтра:  завтра
готовый:  готовых
конкретный:  конкретном
просто:  просто
компьютер:  компьютера компьютерах компьютером
ещё:  ещё
подготовка:  подготовка
вернуться:  вернёмся вернитесь
нуль:  нулём нулей
горячий:  горячую
часть:  частей частям части
преподаватель:  преподавателю преподаватели
уважаемый:  уважаемые
обращать:  обращаю
гипотеза:  гипотезой гипотез гипотеза гипотезы
отрицание:  отрицание отрицанием
черепаха:  черепахи черепахами
данный:  данного данном данный
вы:  вами
умножать:  умножать
непрерывный:  непрерывных непрерывная
производныефункция:  производныефункции
средний:  средняя
бытовой:  бытового
допуск:  допуска допуск
область:  области область
осмыслить:  осмысленные
далеко:  далеко
предположим:  предположим
математик:  математика
переменный:  переменных переменной
герой:  герою
иван:  ивана
дождь:  дождь дождя
несовместный:  несовместные
строгий:  строгим
независимыеслучайный:  независимыеслучайные
обладать:  обладающие
следовательно:  следовательно
модель:  модель модели моделью
непрерывность:  непрерывность
функциис:  функциис
таков:  таков
угодный:  угодно
полный:  полной полных полное
зеркало:  зеркало
читатель:  читатели
второй:  втором второго второму второй
значит:  значит
посылка:  посылок посылки посылка
пугать:  пугать
пирсон:  пирсона
вопрос:  вопрос вопроса вопросов вопросы
межгрупповой:  межгрупповая
ортогональный:  ортогональное
заменить:  заменить
нсв:  нсв
добраться:  доберёмся
схема:  схему схема схеме
процессор:  процессор
вроде:  вроде
рациональный:  рациональный рациональные
аптайм:  аптайм
миллион:  миллионов
упасть:  упал
ход:  ходе ходу
отрезка:  отрезке
величина:  величина величин величины
первопричина:  первопричина
одновременно:  одновременно
важный:  важный важное важном
бп:  бп
утверждать:  утверждаем
заведомо:  заведомо
питание:  питания
она:  неё
высота:  высоту
похожий:  похожая
самый:  самая самым самое
детерминация:  детерминации
сторона:  стороны сторону стороне сторона сторон сторонам
следующий:  следующие следующее
начать:  начать
дифференциальныеуравнение:  дифференциальныеуравнения
название:  названия название
натуральный:  натуральное натуральные натурального
дизъюнкция:  дизъюнкция дизъюнкцией дизъюнкцию
заниматься:  занимается
прямой:  прямая прямой прямую
постоянный:  постоянных
стокс:  стокса
боль:  боли
предполагать:  предполагает
самостоятельно:  самостоятельно
игра:  игра
степень:  степень
дробовик:  дробовик
математика:  математике математики
векторный:  векторное векторного
вероятностия:  вероятностии
скалярный:  скалярное
доморощенный:  доморощенной
совершенно:  совершенно
наш:  нашем нашему наш нашей нашего
значимость:  значимости
страшный:  страшного
анализ:  анализа анализ
запугивать:  запугивают
её:  её
частный:  частное частные
парный:  парной
успешный:  успешного
логический:  логического логическая логическими логических логической логическим логическое логические логическую логический
выключая:  выключая
несколько:  несколько
последовательный:  последовательное
сборник:  сборники
параметрический:  параметрическом параметрической
идти:  шёл идёт
обосновываться:  обосновывается
штамповать:  штампованные
таблица:  таблице таблицу таблицы таблицей
часто:  часто
предчувствовать:  предчувствуете
человек:  человек
никак:  никак
получаться:  получается
какой:  какие каких
угол:  угла углы
физический:  физической
разговор:  разговор
блок:  блоками блок
решение:  решение решением решения решений
место:  место местами
форум:  форум форуме
книга:  книги книга
ответить:  ответил ответит
анализировать:  анализируйте
устойчивый:  устойчивые
подлежать:  подлежит
обратиться:  обратимся
вектор:  векторы векторов вектора вектор
трактат:  трактат
забыть:  забыл
наподобие:  наподобие
вращение:  вращения
именно:  именно
копирование:  копирование
давать:  давайте
знаменитый:  знаменитую
цепь:  цепь цепи
разрыв:  разрыва
выражение:  выражения
необходимость:  необходимости необходимость
отблагодарить:  отблагодарить
являться:  являются является
сила:  сила силы
байес:  байеса
рассматривать:  рассматриваем рассматриваемое рассматриваемая
снабжаться:  снабжаются
свет:  свет
теория:  теория теории
называть:  называют называемыми называемом
двумерный:  двумерная
задать:  заданной задайте
тело:  тела
циркуляция:  циркуляция
непосредственно:  непосредственно
указанный:  указанном
лежать:  лежат лежащая лежит
плоскость:  плоскости плоскость
общий:  общим общая общем
входящий:  входящие
пётр:  пётр
дублироваться:  дублируются
определителяй:  определителяи
дважды:  дважды
закон:  законы законами законах
следствие:  следствием следствие следствия следствий
качество:  качестве
поспорить:  поспоришь
буква:  буква буквами
догадываться:  догадываются
вопросительный:  вопросительные
пункт:  пункт пункта пункте
вероятность:  вероятностей вероятность вероятности
порешать:  порешаем
соотнести:  соотнести
ладный:  ладно
любой:  любое любой любого
подобно:  подобно
уравненийв:  уравненийв
заключение:  заключение заключения
щиток:  щитке
количество:  количества количество
переписать:  переписать перепишем
грин:  грина
суть:  сути
эйлер:  эйлера
скрывать:  скрывает
объект:  объекта объект
экзаменационный:  экзаменационном
качаться:  качается
сделать:  сделает
курсовик:  курсовик
дискретный:  дискретный
дисциплинировать:  дисциплинирует
знакочередоваться:  знакочередующиеся
неполный:  неполной
отпадать:  отпадает
пожалуй:  пожалуй
постулироваться:  постулируется
голова:  голову
произвольный:  произвольных
сложный:  сложной сложные сложное сложных
работать:  работает работают
фурье:  фурье
поле:  поля
белый:  белая
зайти:  зашла
свойство:  свойства
момент:  момент
ложный:  ложной ложным ложна ложно ложные ложны
исследование:  исследование
точка:  точки точке
высказывание:  высказываний высказываниям высказывания высказывание высказываниями
вариация:  вариации
основа:  основы основе основам
студент:  студент
интервал:  интервалы
обрабатываться:  обрабатываются
кош:  коши
выше:  выше
чайник:  чайников
нижний:  нижних нижние
раздел:  раздел
вычисленияс:  вычисленияс
глаз:  глазами
матричный:  матричные матричных матричный
переформулировать:  переформулирую
обеспечить:  обеспечить
ой:  ой
заметить:  заметили заметьте
дружный:  дружные
однородный:  однородные однородным
вычислить:  вычислить
очень:  очень
упряжка:  упряжке
матрица:  матрицу матрицы матрицами
испытанияй:  испытанияи
интегралыть:  интегралыв
перегруппировка:  перегруппировка
аксиома:  аксиома аксиомы
логика:  логика логику логики логике
летать:  летают
помощь:  помощью
понять:  поняли
вариационный:  вариационный
поменяться:  поменялся
элементарный:  элементарных
равняться:  равнялся
неопределённость:  неопределённости
перенос:  перенос
казаться:  кажется
блог:  блог
простейшее:  простейшим простейшие
одиночный:  одиночную
высокий:  высших высшей высшая
произведение:  произведения произведение
школа:  школы школа
научить:  научить
эквивалент:  эквиваленты
пространство:  пространстве пространства
операция:  операциях операция операций операции
удобный:  удобный
курс:  курс курса
начинающий:  начинающим
координата:  координаты координат координатах
сообщить:  сообщите
сессия:  сессии сессию сессия
аналитический:  аналитическая аналитической
понижение:  понижение понижением
двойка:  двойки
выражаться:  выражается
формулировать:  формулируют
снег:  снег
вписать:  вписать
распространяться:  распространяется
центр:  центр
равный:  равные
сложение:  сложения сложение
петя:  пете петя
узнать:  узнаем узнаете
нелегальный:  нелегальна нелегальной
единственность:  единственность
град:  град
обстоятельство:  обстоятельствах
писать:  пишем
баня:  баню
доказательство:  доказательств доказательство доказательства
просматривать:  просматриваем
матлогик:  матлогики
забавный:  забавное
затем:  затем
построение:  построение
линейнойкорреляционный:  линейнойкорреляционной
соединять:  соединяет
действие:  действия
причина:  причиной причине
устанавливать:  устанавливает
время:  время времени
почему:  почему
распределениякритерия:  распределениякритерий
достижение:  достижения
читаться:  читается
приветствоваться:  приветствуется
обозначение:  обозначений обозначениях
пройти:  прошёл пройти
несобственный:  несобственные
выполнять:  выполнять
зрение:  зрения
обывательский:  обывательское
включить:  включен
своевременно:  своевременно
свой:  своей свои
параллельный:  параллельным
финишный:  финишную
касательная:  касательная
задачис:  задачис
некорректный:  некорректен
правило:  правила правилу правило
функциия:  функциии
достаточность:  достаточности достаточность
степенной:  степенного степенные
функцийдвуха:  функцийдвух
выборка:  выборке
таковой:  таковым
выводить:  выводим выводит
функцийнесколький:  функцийнескольких
квадрат:  квадрат квадратов
множественнойлинейный:  множественнойлинейной
напротив:  напротив
распределение:  распределение распределения
задачипо:  задачипо
востребовать:  востребованную
приблизить:  приближенные
луна:  луна
подстанция:  подстанции
перевернуть:  перевёрнутая
зависимый:  зависимые
отклонение:  отклонение
что:  чему чём
завершить:  завершена завершить
случайный:  случайных случайные
экзамен:  экзамена экзамену экзамен
дуга:  дуги
частность:  частности
интернет:  интернета
отрезкать:  отрезкав
детский:  детском
дивергенция:  дивергенция
сократить:  сокращённой
использование:  использования
жёсткий:  жёсткими
сайт:  сайт сайты сайтов сайта
графика:  графики графика
арифметический:  арифметические
штамп:  штампы
лампочка:  лампочки лампочка
изучение:  изучении изучения
неверно:  неверно
сервер:  сервер серверы серверах
хранить:  хранит
площадь:  площадь
расположить:  расположены
возрастание:  возрастание
эмпирический:  эмпирические
решить:  решённые решить
найтись:  нашлось
аналогично:  аналогично
потребоваться:  потребуется
иррациональный:  иррациональных
роль:  роли
единственный:  единственном единственная
отличный:  отличный
определение:  определению определения
получиться:  получился
квадратичнуюформ:  квадратичнуюформу
карта:  карта
единица:  единица единицей единиц
гипербола:  гипербола
равно:  равно
база:  базу
насчитывать:  насчитывает
моделировать:  моделирует
они:  ними
совпадение:  совпадении
зачёт:  зачёт
фраза:  фразы фраза
спирмена:  спирмена
множество:  множествах множество множества
вид:  виду виды виде
связка:  связку связка
вовсе:  вовсе
св:  св
иметь:  имеет
растаять:  растаять растаял
характеристика:  характеристиками характеристикам
достаточно:  достаточно
показательный:  показательное
бывать:  бывают бывает
шар:  шару
преобразование:  преобразования преобразований
соответствовать:  соответствует соответствуют
раскладываться:  раскладывается
запитываться:  запитывается
равносторонний:  равносторонний равносторонним
учиться:  учащихся учимся
диффура:  диффурами
пользоваться:  пользуясь
этот:  эта
ых:  ых
весьма:  весьма
мера:  меры
подразумевать:  подразумевает
вычисление:  вычисление
оформление:  оформлении
интересовать:  интересует
использовать:  используем использовали использовал используйте
представлять:  представляет
статистика:  статистика
эквиваленция:  эквиваленции эквиваленцией эквиваленция
бэ:  бэ
биномиальный:  биномиальное
линиюв:  линиюв
история:  история
отношение:  отношении
четыре:  четырём
ждать:  жду
фундамент:  фундамент
использоваться:  использоваться
скучно:  скучно
дуприближённо:  дуприближённо
информация:  информации информацию
асимптота:  асимптоты
присоединить:  присоединим
событие:  события
пифагор:  пифагора
повторный:  повторные
знакомый:  знакома знакомые
недоказанный:  недоказанная
знать:  знает знаем знать
состоять:  состоит
замена:  замену замены
фнп:  фнп
двойной:  двойные двойной
несобство:  несобств
нелинейный:  нелинейная
увлекательный:  увлекательного
три:  трём трёх
преобразованиеквадратичный:  преобразованиеквадратичной
функциональный:  функциональные
петь:  петь
дисциплина:  дисциплине
закладывать:  закладывать
геометрический:  геометрическая геометрическое
абсолютный:  абсолютная
тот:  тому той
сложенияй:  сложенияи
регрессия:  регрессии регрессия
хорошенько:  хорошенько
исправный:  исправен
корень:  корни
исчисление:  исчисления
удачный:  удачной
подобный:  подобной
зачастую:  зачастую
локальный:  локальная
сказать:  сказать
неверный:  неверная неверна
ожидание:  ожидание
лаплас:  лапласа
перегиб:  перегиба
сходимость:  сходимости сходимость
квантор:  квантора квантор кванторы кванторами
оказаться:  оказаться
ду:  ду
далее:  далее
делать:  делать делает
возбраняться:  возбраняется
коэффициент:  коэффициент
неопределённый:  неопределенный неопределенном
удовлетворять:  удовлетворять удовлетворяет удовлетворяют удовлетворяющего
побудительный:  побудительные
дробь:  дробей
собственный:  собственные
признак:  признак признаки
рядом:  рядом
поэтому:  поэтому
практика:  практике
разумеется:  разумеется
неслабый:  неслабый
принцип:  принципе
неравенство:  неравенство неравенства
противный:  противном противного
коль:  коль
асимметрия:  асимметрия
шаг:  шаге
главный:  главную
сверху:  сверху
сводиться:  сводящиеся
собственно:  собственно
самостоятельный:  самостоятельными
маленький:  меньше
составить:  составим
выключатель:  выключатель
предложение:  предложения предложение
например:  например
решенияопределённый:  решенияопределенных
такой:  такие такое такого такая такими
действительность:  действительности
хотя:  хотя
пойти:  пойдём
исключать:  исключающее
объём:  объёма объем
цель:  цели
независимый:  независимыми независимые
коэффициентковариация:  коэффициентковариации
диван:  диване
профессиональный:  профессиональных
выполнение:  выполнение
первый:  первой первому первого
задуматься:  задумаемся
мегатеорема:  мегатеорему
лопиталя:  лопиталя
называться:  называется
обычно:  обычно
естественный:  естественным
отвлечься:  отвлечёмся
тягать:  тягает
поляформула:  поляформула
наверное:  наверное
фехнера:  фехнера
эффективный:  эффективные
катет:  катетами
условный:  условные
эллипс:  эллипс
ноль:  ноль
теорема:  теорему теоремы теорема теорем
заключительный:  заключительном
огромный:  огромное
даламбер:  даламбера
факт:  факт факты факта
отдельный:  отдельный
повторнойя:  повторнойи
ровно:  ровно
распределить:  распределить
комплексный:  комплексные комплексного комплексный комплексными
ранг:  ранг
кривая:  кривой
пояснять:  пояснять
тяжестиплоска:  тяжестиплоской
задавать:  задают задаваемые
стрелка:  стрелку
зато:  зато
всячески:  всячески
проверка:  проверка
сырость:  сырости сырость
построить:  построить
внимание:  внимание
лейбниц:  лейбница
привести:  приведу привёл привести
поток:  поток
отталкиваться:  отталкивается
расклад:  расклады
медиана:  медиана
записать:  записать
направлениюй:  направлениюи
гостевой:  гостевая
скоро:  скоро
окончить:  окончить
кроме:  кроме
сумма:  сумме сумму сумма
понятно:  понятно
главное:  главное
пропагандировать:  пропагандировать
внутригрупповаяй:  внутригрупповаяи
подъезд:  подъезде
посыл:  посылом
принимать:  принимаемое
пара:  пару
алгебра:  алгебры
опрометчивый:  опрометчивого
наоборот:  наоборот
пониматься:  понимается
существовать:  существует существуют
прямоугольник:  прямоугольников
эксцессэмпирический:  эксцессэмпирического
танец:  танца
шлёпанец:  шлёпанцы
ворона:  ворона
говорить:  говорит говоря
оценка:  оценка оценки
криволинейный:  криволинейные
различный:  различных
записываться:  записываются
объединять:  объединяет
наименьшеезначение:  наименьшеезначения
сад:  саду
интересный:  интереснее
великое:  великое
системылинейный:  системылинейных
нужно:  нужно
зависимость:  зависимость
пять:  пять
замкнутый:  замкнутому
сдача:  сдаче
очевидный:  очевидно
сам:  само
отчитаться:  отчитаться
показатель:  показатели
отличие:  отличие
провод:  проводе провод
парадокс:  парадокс
площадьс:  площадьс
ранее:  ранее
черта:  черту
убыванией:  убываниеи
повышенный:  повышенной
статистический:  статистическая статистические
также:  также
дать:  данная данные данной
интегрирование:  интегрирование
коньяк:  коньяка
ситуация:  ситуация
интервальный:  интервальный
речь:  речи речь
обесточить:  обесточен
соответственно:  соответственно
требовать:  требует
вообще:  вообще
лояльный:  лояльные
оценкия:  оценкии
неявный:  неявной
несобственныхинтеграл:  несобственныхинтегралов
вероятностибиномиальный:  вероятностибиномиального
род:  рода
гаусс:  гаусса
сплошь:  сплошь
получить:  получила получили получи
пренебречь:  пренебречь
выразить:  выразить выражены
точно:  точно
экстремальный:  экстремальные
весь:  вся всей
нормаль:  нормали
определитель:  определитель
справедливость:  справедливость
противоположный:  противоположный противоположное
выпуклость:  выпуклость
элемент:  элементы
связывать:  связываем
пнуть:  пнуть
выключить:  выключили
сложность:  сложности
значенияй:  значенияи
справедливый:  справедлива
нужный:  нужной
кстати:  кстати
классическоеопределение:  классическоеопределение
инормаль:  инормаль
смеяться:  смеяться
заслужить:  заслужил
опираться:  опирается
вновь:  вновь
конъюнктивный:  конъюнктивное
пирамида:  пирамида
находиться:  находятся
автор:  автор автора
фундаментальный:  фундаментальный
оборот:  обороты
переживать:  переживай
выйти:  вышел
столько:  столько
дифференциальный:  дифференциальные
уравненияс:  уравненияс
онлайн:  онлайн
геометрия:  геометрии геометрия
выкладка:  выкладках
электролиния:  электролиниями
новый:  новому
произвольныйтройный:  произвольныйтройной
дизайн:  дизайна
это:  это
дополнительный:  дополнительную
предыдущий:  предыдущие
поляй:  поляи
опечатка:  опечатку
комната:  комнате
носить:  носят
невероятный:  невероятным
статья:  статье
базовый:  базовых
методомоперационный:  методомоперационного
бесповторный:  бесповторной
правильно:  правильно
латинский:  латинскими
ошибка:  ошибку
железка:  железки
строчный:  строчными
л:  л
практический:  практические практического
измерение:  измерения
прописной:  прописная
запороть:  запорет
опровержение:  опровержения
возникнуть:  возникло
секрет:  секрет
касательный:  касательных
разбираться:  разбираемся
типовыхзадача:  типовыхзадач
содержание:  содержание
ранговойкорреляция:  ранговойкорреляции
рубильник:  рубильник
откроить:  открою
подавлять:  подавляющее
проанализировать:  проанализируйте
жизнь:  жизни
школьник:  школьников
сколько:  сколько
исследовать:  исследовать
нетрудно:  нетрудно
поверхность:  поверхности
табличка:  табличек
преподноситься:  преподносится
линейныйкоэффициент:  линейныйкоэффициент
несобственныйинтеграл:  несобственныйинтеграл
электричество:  электричества
доступно:  доступно
понятие:  понятия понятий
причём:  причём
ипример:  ипримеры
найти:  найти
поверхностный:  поверхностные
порядок:  порядку порядка порядков
фигура:  фигуры
следовать:  следовать следует
пуассон:  пуассона
однако:  однако
сотня:  сотни
математическоеожидание:  математическоеожидание
успешно:  успешно
неоднородный:  неоднородные
необходимо:  необходимо
безусловный:  безусловную
танцевать:  танцует
вариант:  вариантов варианта
модуль:  модулем
подсказать:  подскажете
гипотенуза:  гипотенузой
кратное:  кратные
развернуть:  развёрнутая
стоить:  стоит
системудифференциальный:  системудифференциальных
оборудование:  оборудование
изначально:  изначально
большинство:  большинство
центральный:  центральный
программный:  программное
уметь:  уметь
последний:  последнее
последовательность:  последовательностей
истинно:  истинно
квадратичный:  квадратичные
предполагаться:  предполагается
опровергаться:  опровергается
проверить:  проверить
поскольку:  поскольку
сдавать:  сдаёт
заждаться:  заждались
гипергеометрическоераспределение:  гипергеометрическоераспределение
ставить:  ставят
обратить:  обратите
складывать:  складывать
равномерный:  равномерная равномерное
треугольный:  треугольная
исключительно:  исключительно
доказать:  доказанные доказать
пингвин:  пингвины
пожалуйста:  пожалуйста
себя:  собой
простой:  простого
герон:  герона
сразу:  сразу
максимальный:  максимальный
функциюкомплексный:  функциюкомплексной
критерий:  критериям
напоминать:  напоминаю
ходить:  ходят
относиться:  относятся
мода:  мода
терминология:  терминологией
свойстваэлементарный:  свойстваэлементарных
считать:  считать
калькулятор:  калькулятор
законный:  законны
научиться:  научиться
англ:  англ
оба:  оба
определённый:  определенный определенного определённым
строчка:  строчка строчки
предположение:  предположение предположения
дизъюнктивный:  дизъюнктивная
экстремум:  экстремумы
горнера:  горнера
отмечаться:  отмечалось
получать:  получаем получает
функцийв:  функцийв
стол:  столе
начинать:  начинаем
общность:  общности
поверка:  поверку
предостерегать:  предостерегаю
понимать:  понимать понимаем
дискретнойслучайный:  дискретнойслучайной
знак:  знак
билет:  билете
изучать:  изучать
крамер:  крамера
обосновать:  обосновать
вести:  ведём
вышка:  вышки
базироваться:  базируются
правда:  правда
парабола:  парабола
путаница:  путаницы
строго:  строго
валенок:  валенках
электротехника:  электротехнике
символ:  символ
функциидвуха:  функциидвух
запретить:  запрещено
емелин:  емелин
вычисленияопределенный:  вычисленияопределенных
задачин:  задачина
замечательный:  замечательные
системый:  системыи
удовлетворяетлить:  удовлетворяетли
всякий:  всякий
разомкнуться:  разомкнётся
допустить:  допущен
ток:  ток
бабушка:  бабушка
тригонометрический:  тригонометрических
садист:  садисты
ящик:  ящик
обозначаться:  обозначается
завуалированный:  завуалированном
группа:  группа
встречаться:  встречается
исход:  исхода
заданав:  заданав
всё:  всё
описать:  описанных
тройной:  тройные
деление:  деления
выполнить:  выполнено
позволять:  позволяют
контуруформула:  контуруформула
некоторый:  некоторые
график:  график
строка:  строк
скопировать:  скопирую
либо:  либо
прийти:  пришёл
рекомендовать:  рекомендую
эн:  эн
электрический:  электрическом
подход:  подход
дежурный:  дежурные
доказываться:  доказывается
мир:  мире
корреляция:  корреляции
заочник:  заочников
содержательный:  содержательной
повторять:  повторяем
