вектор:  векторы вектору вектор векторов
параметрический:  параметрическая параметрической параметрическом
постараться:  постараться
надобность:  надобности
вытаскивать:  вытаскивать
отходить:  отходя
вращение:  вращения
дифференциальный:  дифференциальные дифференциального
модифицированный:  модифицированные
уравненияс:  уравненияс
совпадение:  совпадения
программирование:  программирования
именно:  именно
онлайн:  онлайн
принять:  принято
геометрия:  геометрии геометрия
копирование:  копирование
полезный:  полезен
решить:  решить
разрыв:  разрыва
работа:  работа
выражение:  выражения
сумма:  сумма сумму
производный:  производные производная производной производную
прямой:  прямой прямую прямая
дуприближённо:  дуприближённо
наш:  нашими наш
новый:  новому
предел:  предел пределы пределов
произвольныйтройный:  произвольныйтройной
модель:  модели модель
буква:  буквами буква буквой буквы
информация:  информации информация
асимптота:  асимптоты
дизайн:  дизайна
забывчивость:  забывчивости
это:  это
максимум:  максимум
отличительный:  отличительных
необходимость:  необходимости
событие:  события
отблагодарить:  отблагодарить
повторный:  повторные
байес:  байеса
числовой:  числовые
дисперсия:  дисперсию дисперсия дисперсии
развиваться:  развивается
решать:  решать
производныенеявно:  производныенеявно
пример:  примере примерами примеры пример примера примеров
значение:  значение значениями
скорее:  скорее
идентифицировать:  идентифицирующие
решение:  решений решением решение решения
писатель:  писателем
явный:  явной
поляй:  поляи
интеграл:  интегралы интеграла интеграл интеграле интегралов
опечатка:  опечатку
теория:  теория теории
математический:  математические математическая математической
данный:  данную данном данный
лихорадочно:  лихорадочно
преобразовать:  преобразуем
постоянно:  постоянно
речь:  речь
формула:  формулы формула формулу формуле формулами
сам:  сами
статья:  статье статья статью
фнп:  фнп
особый:  особую особое особой
ум:  ум
мерещиться:  мерещится
определение:  определениях определение определений определения определению
канонический:  каноническому канонических канонические
простейшее:  простейшие
потренироваться:  потренируйтесь
дифференцирование:  дифференцировании дифференцирования
стремиться:  стремиться
два:  две двух
гипотеза:  гипотезы гипотез гипотеза
дифференциал:  дифференциалах дифференциала
двумерный:  двумерная
больший:  наибольшее большими
базовый:  базовых базовым
методомоперационный:  методомоперационного
задать:  заданной задайте задана заданную
многие:  многие
конец:  конце
часть:  частям части
заметить:  заметьте заметили
косноязычный:  косноязычно
тело:  тела
циркуляция:  циркуляция
бесповторный:  бесповторной
непосредственно:  непосредственно
неявно:  неявно
чебурашка:  чебурашке чебурашка
образец:  образцы
двойной:  двойные двойной
ошибка:  ошибку ошибка
неприятный:  неприятный
лежать:  лежат лежит
плоскость:  плоскости плоскость
несобство:  несобств
экзамен:  экзаменом
трансформироваться:  трансформируется
л:  л
написать:  написал
общий:  общим общая общем общего общее
нелинейный:  нелинейная
белый:  белой
направлять:  направляющий направляющему
частный:  частной частные частную частными частное
поздний:  позже
пара:  парой
задание:  задании задание
преобразованиеквадратичный:  преобразованиеквадратичной
шар:  шар
определителяй:  определителяи
вогнутостья:  вогнутостьи
вид:  виде виды виду
закон:  законы
позволять:  позволяет
функциональный:  функциональные
попасться:  попадётся
секрет:  секрет секретом
точный:  точных
касательный:  касательных касательные
несуществование:  несуществования
убедиться:  убедиться
изящно:  изящно
нюанс:  нюансов
профессия:  профессию
классический:  классический
большой:  большой
геометрический:  геометрическая геометрическое
абсолютный:  абсолютная
графика:  графика графики
типовыхзадача:  типовыхзадач
источник:  источником
форма:  форма формы
спешить:  спешим
один:  одной одном одна одним
умножение:  умножения
предмет:  предмет
вероятность:  вероятностей вероятностью вероятность вероятности
ситуация:  ситуацию ситуации
ранговойкорреляция:  ранговойкорреляции
система:  система систему системе системы
функция:  функций функцией функции функция
изящный:  изящным
непрерывный:  непрерывная непрерывных
группировка:  группировок группировка
познакомиться:  познакомимся
условнаясходимость:  условнаясходимость
сложенияй:  сложенияи
уравненийв:  уравненийв
путать:  путать
регрессия:  регрессии регрессия
величина:  величин величина величины
александр:  александр
найти:  найдены найти найденному найдём
рассказать:  расскажу
сказочный:  сказочный
грин:  грина
полный:  полное полных полной
который:  которые котором который которой
исчисление:  исчисления
линейный:  линейные линейная линейных линейной
скука:  скуки
эйлер:  эйлера
иной:  иное иная
двойка:  двойку
эффективный:  эффективный эффективные
равенство:  равенство
запись:  записи
согласие:  согласия
гораздо:  гораздо
локальный:  локальная
настоятельно:  настоятельно
обозначение:  обозначениями
традиционный:  традиционные
популярный:  популярная популярном
ожидание:  ожидание
математика:  математики математике
лаплас:  лапласа
перегиб:  перегиба
торчать:  торчащей
такой:  таким таком такое такая такими
иметься:  имеющиеся
сходимость:  сходимости сходимость
дуоперационный:  дуоперационным
исследовать:  исследовать
представить:  представьте представил
объект:  объектах
дискретный:  дискретный
нетрудно:  нетрудно
базис:  базисах базис базису
поверхность:  поверхности поверхность
составить:  составить составим
знакочередоваться:  знакочередующиеся
задача:  задачи задач
образовать:  образуют
векторный:  векторного векторное
минимум:  минимума
ду:  ду
принцип:  принцип принципе принципам
поделать:  поделать
правило:  правилами правило правила
конический:  коническую коническая
поделиться:  поделюсь
зависимостьвектор:  зависимостьвекторов
взрослый:  взрослых
линейныйкоэффициент:  линейныйкоэффициент
нахождение:  нахождении нахождения
возбраняться:  возбраняется
коэффициент:  коэффициент коэффициенты
неопределённый:  неопределенный неопределенном
день:  день
сначала:  сначала
метод:  методы методом метод
дробь:  дробей
собственный:  собственные
страница:  страницу
спасти:  спасёт
практически:  практически
несобственныйинтеграл:  несобственныйинтеграл
признак:  признак признаки признаков
произвольный:  произвольных произвольную
интуиция:  интуиции
данные:  данных
сложный:  сложной сложных сложные
запутаться:  запутаться
доступно:  доступно
понятие:  понятия
ребёнок:  детей
фурье:  фурье
учиться:  учимся
команда:  команда
поле:  поля
поэтому:  поэтому
разложение:  разложением разложение
задавать:  задаваемые
свойство:  свойства
практика:  практике
урок:  урока уроке
момент:  момент моменты
приходящий:  приходящая
отвечать:  отвечая
приемлемый:  приемлема
точка:  точка точки точку точке
разумеется:  разумеется
войти:  вошла
исследование:  исследование
весь:  всем
ипример:  ипримеры
уравнение:  уравнению уравнений уравнения уравнение уравнением
множество:  множества
оценка:  оценки оценка
проблема:  проблем
переход:  переход
вариация:  вариации
тот:  та
требоваться:  требуется
асимметрия:  асимметрия
никакой:  никаких
комплексный:  комплексными комплексные комплексного комплексный
основа:  основы
поверхностный:  поверхностные
студент:  студент
технический:  технической технические
мало:  мало
зубрёжка:  зубрёжке зубрёжки
интервал:  интервалы
научный:  научная
книга:  книга книги
существо:  существу
главный:  главную
кош:  коши
желательно:  желательно
координата:  координат координаты координатах
фигура:  фигуры
пуассон:  пуассона
сводиться:  сводящиеся
чайник:  чайников
преобразование:  преобразований преобразования
замена:  замены
вычисленияс:  вычисленияс
однако:  однако
перпендикулярно:  перпендикулярно
глаз:  глазами
малый:  малые наименьших
записать:  запишем
связь:  связь
понижение:  понижением понижение
матричный:  матричные матричных матричный
наука:  наук
эдуард:  эдуардом
фактически:  фактически
помереть:  померли
вывод:  выводов
математическоеожидание:  математическоеожидание
дать:  данной
однородный:  однородные однородным
решенияопределённый:  решенияопределенных
например:  например
небольшой:  небольшая
помощь:  помощь помощью
вычислить:  вычислить
простой:  простая
нормальный:  нормальное нормальной
школа:  школа
очень:  очень
интегральнаятеорема:  интегральнаятеоремы
унылый:  унылы
хотя:  хотя
корнимногочлен:  корнимногочлена
логарифмический:  логарифмическая
курс:  курса курс
матрица:  матрицу матрицы матрицами
испытанияй:  испытанияи
интегралыть:  интегралыв
близкий:  ближе
неоднородный:  неоднородные
начать:  начнём начать начата
дело:  делам дело
перегруппировка:  перегруппировка
экспонента:  экспонентой
проверять:  проверяем
пропорциональность:  пропорциональности
основной:  основные
навсегда:  навсегда
пространственный:  пространственный пространственная пространственных
бернулли:  бернулли
иголка:  иголкой
нужный:  нужен нужной
полярный:  полярные полярной полярных
коэффициентковариация:  коэффициентковариации
понять:  поняли
ряд:  ряд ряды ряда рядов
вариационный:  вариационный
уровень:  уровня уровнем уровне
обратный:  обратная обратную
второй:  второй вторым второго
должный:  должны должно должен
вопрос:  вопросы вопросов вопрос
кратное:  кратные
обозначать:  обозначает обозначать
системудифференциальный:  системудифференциальных
блог:  блог
доверительный:  доверительные
смысл:  смысле
высокий:  высших высшей высшая
редкость:  редкость
линия:  линий линиями линии линия
среднееквадратический:  среднееквадратическое
осьминог:  осьминога
единственный:  единственной
пространство:  пространстве
ухо:  ушами
обладать:  обладая
лопиталя:  лопиталя
примерный:  примерные
снимать:  снимаем
последовательность:  последовательностей
удобный:  удобный
комбинационный:  комбинационная
касание:  касания
неявный:  неявном неявной
отработать:  отработаем
оба:  обе
квадратичный:  квадратичные
смешанноепроизведение:  смешанноепроизведение
напоследок:  напоследок
объём:  объем
накладка:  накладка
препод:  препод
проверить:  проверить
поляформула:  поляформула
наверное:  наверное
сообщить:  сообщите
проверка:  проверки проверка
фехнера:  фехнера
незнание:  незнания
аналитический:  аналитическая аналитической
школьный:  школьный
центр:  центр
принадлежащий:  принадлежащую
образ:  образом
гипергеометрическоераспределение:  гипергеометрическоераспределение
самый:  самых самую самая самый
условный:  условные
непрерывнаяслучайный:  непрерывнаяслучайная
обозначить:  обозначить
прикладной:  прикладных
отразить:  отразить
эллипс:  эллипс
обратить:  обратите
прямо:  прямо
единый:  единой
длина:  длина
подавлять:  подавляющем
любой:  любой любом любого
сайт:  сайта сайты сайт
сократить:  сократить
знакопостоянство:  знакопостоянства
производная:  производных производными
область:  областях область области
равномерный:  равномерная равномерное
треугольный:  треугольная
градиент:  градиент
вероятный:  вероятнее
содержаться:  содержаться
считаться:  считаются
подстановка:  подстановкой
соответствующий:  соответствующими
коричневый:  коричневой
использовать:  используйте использовать используем
пожалуйста:  пожалуйста
даламбер:  даламбера
теорема:  теоремы
факт:  факт
комбинаторика:  комбинаторике
случайнаявеличина:  случайнаявеличина
повторнойя:  повторнойи
построение:  построение
следовать:  следует
бесконечно:  бесконечно
константа:  константами
линейнойкорреляционный:  линейнойкорреляционной
давать:  даёт
действие:  действия
приложение:  приложении
ворона:  вороной
однозначно:  однозначно
квадрат:  квадратов
ранг:  ранг
ассоциация:  ассоциации
кривая:  кривой
сфера:  сфере
тяжестиплоска:  тяжестиплоской
знание:  знания
особо:  особо
возвращаться:  возвращаемся
распределениякритерия:  распределениякритерий
функциюкомплексный:  функциюкомплексной
необычный:  необычные
вывести:  вывести
приобретать:  приобретает
касаться:  касается
построить:  построить
готовый:  готовых
несобственный:  несобственные
просто:  просто
нормаль:  нормаль нормали
мода:  мода
конкретный:  конкретном
свойстваэлементарный:  свойстваэлементарных
приём:  приём
знаменатель:  знаменатели
ещё:  ещё
соображаловка:  соображаловка
проходить:  проходят проходящая проходит
внимание:  внимание
остальной:  остальное
зрение:  зрения
калькулятор:  калькулятор
лейбниц:  лейбница
научиться:  научиться
случай:  случае
неравенство:  неравенства
поток:  поток
кто:  кого
касательная:  касательная касательной
ответ:  ответ ответы
задачис:  задачис
тонкий:  тонкая
алгоритм:  алгоритмом
привыкнуть:  привыкли
обращать:  обращаю
медиана:  медиана
время:  временем
функциия:  функциии
настоящий:  настоящие
степенной:  степенного степенные
функцийдвуха:  функцийдвух
направлениюй:  направлениюи
определённый:  определенный определенного
выборка:  выборке
аккуратный:  аккуратной
подобный:  подобных
гостевой:  гостевая
вы:  вами
закрепить:  закреплена
грамотно:  грамотно
переписать:  перепишем
нормалик:  нормалик
действительно:  действительно
обещать:  обещанный
распределение:  распределения распределение
кроме:  кроме
экстремум:  экстремумы
насущный:  насущным
горнера:  горнера
аккуратно:  аккуратно
производныефункция:  производныефункции
средний:  средняя
понятно:  понятно
функцийнесколький:  функцийнескольких
подготовка:  подготовки
возникнуть:  возникнуть
искомый:  искомой
внутригрупповаяй:  внутригрупповаяи
предельно:  предельно
алгебра:  алгебры
радовать:  радовать
развлекать:  развлекать
предположим:  предположим
далеко:  далеко
удовлетворять:  удовлетворяют
число:  числами числа
математик:  математика
функцийв:  функцийв
переменный:  переменных переменной
видеть:  видите
несовместный:  несовместные
независимыеслучайный:  независимыеслучайные
множественнойлинейный:  множественнойлинейной
добавить:  добавить
вверх:  вверх
довольно:  довольно
существовать:  существует
анализ:  анализ анализа
находить:  находили
существенный:  существенные
остроумный:  остроумное
плоский:  плоская
каждый:  каждой
прямоугольник:  прямоугольников
непрерывность:  непрерывность
эксцессэмпирический:  эксцессэмпирического
догадаться:  догадаться
интересный:  интересное
допускаться:  допускается
функциис:  функциис
зеркало:  зеркало
различный:  различных
криволинейный:  криволинейные
значит:  значит
пирсон:  пирсона
умножить:  умножили
библиотека:  библиотека
три:  трёх
скороговорка:  скороговорка
межгрупповой:  межгрупповая
ортогональный:  ортогональное
трудность:  трудностей трудностями
дискретнойслучайный:  дискретнойслучайной
задачипо:  задачипо
шерсть:  шерстью
востребовать:  востребованную
наименьшеезначение:  наименьшеезначения
перечисление:  перечисление
нсв:  нсв
сила:  силы
приблизить:  приближенные
вычислимый:  вычислим
отвлечь:  отвлечённых
поправить:  поправит
википедия:  википедии
рассказывать:  рассказывал
системылинейный:  системылинейных
расположить:  расположена
нужно:  нужно
упасть:  упал
чистовой:  чистового
ход:  ходе
гарантированно:  гарантированно
встретить:  встретить
зависимый:  зависимые
значимый:  значимая
нечего:  нечего
зависимость:  зависимость
заголовок:  заголовке
отклонение:  отклонение
крамер:  крамера
основный:  основных
отрезка:  отрезке
материал:  материалы материала материалов
что:  чему
другой:  другие другим
содержать:  содержащая
таблица:  таблицы
произведение:  произведение
знать:  знаете
вполне:  вполне
персонаж:  персонажей персонаж
случайный:  случайных случайные
замкнутый:  замкнутому
великий:  величайшая
график:  графику график
важность:  важность
очевидный:  очевидно
дуга:  дуги
отрезкать:  отрезкав
дивергенция:  дивергенция
парабола:  парабола
строго:  строго
форум:  форуме форум
показатель:  показатели
следующий:  следующий следующие следующее следующей
оформление:  оформления
забыть:  забыть
ингредиент:  ингредиенты
принадлежать:  принадлежат
шанс:  шансы
следствие:  следствий
дальнейший:  дальнейшими
площадьс:  площадьс
к:  ко
функциидвуха:  функциидвух
запретить:  запрещено
большинство:  большинстве
статистический:  статистические статистическая
емелин:  емелин
причина:  причине причина
убыванией:  убываниеи
вычисленияопределенный:  вычисленияопределенных
повышенный:  повышенной
первый:  первую первого
избежать:  избежать
предлагать:  предлагаемые
возрастание:  возрастание
эмпирический:  эмпирические
детерминация:  детерминации
интегрирование:  интегрирование
обязательно:  обязательно
нежели:  нежели
легко:  легко
задачин:  задачина
замечательный:  замечательные
рациональный:  рациональные
системый:  системыи
удовлетворяетлить:  удовлетворяетли
этап:  этап
найтись:  нашлось
запомнить:  запомнить
этот:  этих
аналогично:  аналогично
сегодня:  сегодня
дифференциальныеуравнение:  дифференциальныеуравнения
язык:  языка
иррациональный:  иррациональных
некоторый:  некоторых
интервальный:  интервальный
упрощение:  упрощениями
столкнуться:  столкнуться
тригонометрический:  тригонометрических
постоянный:  постоянных
квадратичнуюформ:  квадратичнуюформу
стокс:  стокса
схема:  схема
карта:  карта
смотреться:  смотрится
соответственно:  соответственно
г:  г
гипербола:  гипербола
аналитически:  аналитически
критический:  критической
разъяснить:  разъяснил
дробовик:  дробовик
они:  ними
оценкия:  оценкии
несобственныхинтеграл:  несобственныхинтегралов
вероятностибиномиальный:  вероятностибиномиального
вероятностия:  вероятностии
логика:  логики
ответить:  ответьте
род:  рода
заданав:  заданав
скалярный:  скалярное
спирмена:  спирмена
гаусс:  гаусса
порядок:  порядка порядков
всё:  всё
значимость:  значимости
осознавать:  осознают
пропорциональный:  пропорциональны
тройной:  тройные
деление:  деления
являться:  является
заключительный:  заключительный
контуруформула:  контуруформула
экстремальный:  экстремальные
близко:  близко
верный:  верное
её:  её
рабочий:  рабочими
неточно:  неточно
св:  св
парный:  парной
определитель:  определитель
выпуклость:  выпуклость
несколько:  несколько
направление:  направлению
иметь:  имею
элемент:  элементы
достаточно:  достаточно
сборник:  сборники
простота:  простоты
показательный:  показательное
либо:  либо
нелады:  неладах
избыточно:  избыточно
понравиться:  понравилась
рекомендовать:  рекомендую
независимый:  независимые
успенский:  успенским
зубрить:  зубрит
менее:  менее
получить:  получи
автор:  автора автор
зет:  зет
сложность:  сложности
диффура:  диффурами
подход:  подход
часто:  часто
значенияй:  значенияи
изучение:  изучения
привести:  привести
многочлен:  многочлен
проконтролировать:  проконтролировать
получаться:  получается
кстати:  кстати
аналог:  аналог
вычисление:  вычисление
какой:  какие
номер:  номером
достойный:  достойная
надеяться:  надеюсь
классическоеопределение:  классическоеопределение
инормаль:  инормаль
статистика:  статистика
корреляция:  корреляции
прежде:  прежде
картонка:  картонка
записывать:  записывать
биномиальный:  биномиальное
получиться:  получилась
заочник:  заочников
пирамида:  пирамида
помнить:  помните
линиюв:  линиюв
осознанно:  осознанно
придумать:  придуманный
самостоятельный:  самостоятельного
максимально:  максимально
отношение:  отношении
повторять:  повторяем
однообразный:  однообразны
кривой:  кривым
руководствоваться:  руководствоваться
касса:  кассы
поначалу:  поначалу
