вектор:  векторы векторов
внимательный:  внимательны
заработать:  заработать
ссылка:  ссылки ссылок
динозавр:  динозавр
контент:  контентом контента
сервис:  сервис сервисы сервисом сервисов
вращение:  вращения
дифференциальный:  дифференциальные
последователь:  последователей
замучиться:  замучился
уравненияс:  уравненияс
основный:  основными
благо:  благ
именно:  именно
онлайн:  онлайн
геометрия:  геометрии геометрия
копирование:  копирование
решить:  решить решил решит решённые
казанский:  казанского
заслуживать:  заслуживающих заслуживают
разрыв:  разрыва
работа:  работа работ работах работе работы работу
выражение:  выражения
сумма:  сумма сумму
математический:  математических математические математическую математическая математической математический математическими
производный:  производные производная производной производную
прямой:  прямой прямую прямая
дуприближённо:  дуприближённо
неоднократно:  неоднократно
новый:  новому
предел:  предел пределы пределов
немаловажный:  немаловажно
произвольныйтройный:  произвольныйтройной
модель:  модели модель
небольшой:  небольшой
ниже:  ниже
университет:  университета
информация:  информации информацией
мучение:  мучения
вышка:  вышку вышкой
асимптота:  асимптоты
качественно:  качественно
дизайн:  дизайна
вольфрамальф:  вольфрамальфа
обеспечение:  обеспечение
это:  это
разборчивый:  разборчивый
событие:  события
отблагодарить:  отблагодарить
который:  которую которые котором который которая которыми которое
повторный:  повторные
байес:  байеса
числовой:  числовые
специализировать:  специализированное
дисперсия:  дисперсию дисперсия дисперсии
файл:  файлы файла
решать:  решать
производныенеявно:  производныенеявно
создание:  создания
решение:  решений решениями решения решением решению решение
подставить:  подставьте
многое:  многое
поляй:  поляи
интеграл:  интегралы интеграла интеграл интеграле интегралов
находиться:  находится
опечатка:  опечатку
качественный:  качественных качественный качественной
контрольный:  контрольных контрольные
вёрстка:  вёрсткой
теория:  теория теории
вбить:  вбить
перечисленный:  перечисленный
постоянно:  постоянно
формула:  формулы формула формулу
данный:  данном
задание:  заданий задания задание
доступ:  доступа
агрегатор:  агрегаторы
смотреть:  см смотрим
фнп:  фнп
особенно:  особенно
сюда:  сюда
серьёзный:  серьезную
канонический:  каноническому
простейшее:  простейшие
гипотеза:  гипотезы гипотез гипотеза
дифференциал:  дифференциалах дифференциала
двумерный:  двумерная
больший:  наибольшее
шлак:  шлака
методомоперационный:  методомоперационного
задать:  заданной задайте
многие:  многие
помочь:  помочь поможет
часть:  частям
самый:  самых
различный:  различные различных
тело:  тела
циркуляция:  циркуляция
бесповторный:  бесповторной
непосредственно:  непосредственно
доступный:  доступные
против:  против
образец:  образцы образец образцам
правильно:  правильно
двойной:  двойные двойной
правильность:  правильность
ошибка:  ошибку ошибок ошибками
слуга:  слуга
маткада:  маткада
плоскость:  плоскости плоскость
несобство:  несобств
л:  л
известный:  известны известными
общий:  общим общая
нелинейный:  нелинейная
строчка:  строчках
получиться:  получится
напрасный:  напрасны
преобразованиеквадратичный:  преобразованиеквадратичной
определителяй:  определителяи
вогнутостья:  вогнутостьи
обращаться:  обращался обращаюсь
посему:  посему
многий:  многих
важно:  важно
вид:  виде виды виду
начинаться:  начинаются
бесплатный:  бесплатен
малоизвестный:  малоизвестных
закон:  законы
выяснить:  выяснить
выдача:  выдаче выдачи
встречать:  встречал
юзание:  юзание
функциональный:  функциональные
чудо:  чудо
загрузить:  загрузите
касательный:  касательных
освоить:  освоить
денежный:  денежная
профессия:  профессию
доллар:  долларов
вводить:  вводишь
тот:  той тех
пачка:  пачками
пополняться:  пополняются
геометрический:  геометрическая геометрическое
абсолютный:  абсолютная
графика:  графика графики
типовыхзадача:  типовыхзадач
видеть:  видит
умножение:  умножения
предмет:  предмет предметам
вероятность:  вероятностей вероятность вероятности
встречаться:  встречаются встречается
развивать:  развивает
ранговойкорреляция:  ранговойкорреляции
система:  система систему системе системы
частный:  частные частное
функция:  функций функции функция
летний:  летней
старый:  старейших старая
непрерывный:  непрерывная непрерывных
группировка:  группировок группировка
условнаясходимость:  условнаясходимость
сложенияй:  сложенияи
уравненийв:  уравненийв
мгту:  мгту
регрессия:  регрессии регрессия
величина:  величин величина величины
александр:  александр
оценка:  оценке оценки оценка
запарка:  запарки
процент:  проценты
грин:  грина
полный:  полное полных полной
исчисление:  исчисления
линейный:  линейные линейная линейных линейной
жизнь:  жизни
редко:  редко
эйлер:  эйлера
авторитетный:  авторитетный
получать:  получайте получаешь
пользоваться:  пользуюсь
вовочка:  вовочка
закачать:  закачать закачали
согласие:  согласия
гораздо:  гораздо
локальный:  локальная
зачастую:  зачастую
улучшаться:  улучшаются
сказать:  сказать скажу
удобный:  удобная удобный удобны
указанный:  указанной
ожидание:  ожидание
математика:  математики математике
лаплас:  лапласа
перегиб:  перегиба
такой:  таким такие такое такого таких такая
сам:  самими самой само самом
сходимость:  сходимости сходимость
дуоперационный:  дуоперационным
исследовать:  исследовать
благодарность:  благодарность
студенческий:  студенческая
дискретный:  дискретный
невозможно:  невозможно
базис:  базисах базис базису
бауман:  баумана
поверхность:  поверхности
отупеть:  отупеть
знакочередоваться:  знакочередующиеся
задача:  задачи задач задача
мудрость:  мудрость
оказаться:  оказаться окажется
следующий:  следующая следующий
методический:  методическим методические
векторный:  векторного векторное
страница:  странице страницу страницы страница
ду:  ду
наиболее:  наиболее
поделиться:  поделюсь
далее:  далее
зависимостьвектор:  зависимостьвекторов
линейныйкоэффициент:  линейныйкоэффициент
опасно:  опасно
присылать:  присылают
материально:  материально
коэффициент:  коэффициент
неопределённый:  неопределенный неопределенном
лекция:  лекций лекция лекции
история:  историю
ситуация:  ситуациях ситуации
метод:  методы методом метод
дробь:  дробей
собственный:  собственные
типовик:  типовиков
вода:  воды
ваш:  ваш ваше ваши
откровенный:  откровенного
стырить:  стыренным
практически:  практически
несобственныйинтеграл:  несобственныйинтеграл
признак:  признак признаки
произвольный:  произвольных
данные:  данных
сложный:  сложной сложных сложные
экзамен:  экзамены экзаменах
доступно:  доступно
бездумный:  бездумного бездумное
работать:  работает
фурье:  фурье
учиться:  учимся
поле:  поля
поэтому:  поэтому
разложение:  разложением разложение
задавать:  задаваемые
сдать:  сдал сдать сданы
свойство:  свойства
момент:  момент
разный:  разное разных
интересный:  интересен интересной
свободный:  свободного
теоретический:  теоретический теоретические
район:  районе
исследование:  исследование
рунет:  рунета
безусловно:  безусловно
весь:  всем
посмотреть:  посмотрели посмотреть
ипример:  ипримеры
точка:  точки точке
уравнение:  уравнению уравнений уравнения уравнение
множество:  множества множество
найти:  найти найденная
никакой:  никаких никакой
переход:  переход
вариация:  вариации
сайт:  сайту сайте сайта сайты сайт
требоваться:  требуется
асимметрия:  асимметрия
фонд:  фонда
комплексный:  комплексными комплексные комплексного комплексный
основа:  основы
поверхностный:  поверхностные
студент:  студент студентами студенты
навалиться:  навалились
мало:  мало
тупой:  тупого
интервал:  интервалы
поисковик:  поисковиков поисковик
книга:  книга книги
называть:  называемого
недостаточный:  недостаточную
пополнить:  пополнил
усилие:  усилия
главный:  главную
кош:  коши
практика:  практики
координата:  координат координаты координатах
фигура:  фигуры
обсудить:  обсудили
представимый:  представим
первый:  первое первых первого
пуассон:  пуассона
типовой:  типовые
выше:  выше
сводиться:  сводящиеся
материал:  материале материалы материалов материалам
чайник:  чайников
преобразование:  преобразований преобразования
замена:  замены
раздел:  раздел
медвежий:  медвежья
вычисленияс:  вычисленияс
однако:  однако
выдать:  выдал
малый:  малые наименьших
связь:  связь
несмотря:  несмотря
понижение:  понижением понижение
таки:  таки
матричный:  матричные матричных матричный
элементарный:  элементарный
расчёт:  расчеты
методичка:  методички
сотня:  сотни
заметить:  заметили
математическоеожидание:  математическоеожидание
дать:  данной данному
однородный:  однородные однородным
решенияопределённый:  решенияопределенных
нужный:  нужный нужной
например:  например
успешно:  успешно
итог:  итоге
вычислить:  вычислить
выглядеть:  выглядит
простой:  простая
нормальный:  нормальное
школа:  школа
очень:  очень
исчезать:  исчезают
интегральнаятеорема:  интегральнаятеоремы
позволить:  позволят
хотя:  хотя
корнимногочлен:  корнимногочлена
логарифмический:  логарифмическая
курс:  курса курс курсе
матрица:  матрицу матрицы матрицами
условие:  условие
испытанияй:  испытанияи
интегралыть:  интегралыв
точный:  точным
лететь:  летит
неоднородный:  неоднородные
перегруппировка:  перегруппировка
библиотека:  библиотеку библиотека
правило:  правило правила
основной:  основные
коленка:  коленке
расчётки:  расчетки
пойти:  пошел
мусор:  мусора
помощь:  помощью
заглянуть:  загляните
бернулли:  бернулли
полярный:  полярные полярной полярных
коэффициентковариация:  коэффициентковариации
ряд:  ряд ряды ряда рядов
место:  мест место
вариационный:  вариационный
побывать:  побывать
уровень:  уровня
обратный:  обратная обратную
свой:  своим своего своей свои
внутренний:  внутренняя
вопрос:  вопросы вопрос
краткий:  краткие
кратное:  кратные
захотеть:  захотите
системудифференциальный:  системудифференциальных
попробовать:  попробуете
блог:  блог блога
балл:  баллов баллы
доверительный:  доверительные
выражать:  выражаю
вклад:  вклад
индивидуальный:  индивидуальные
высокий:  высших высшей высшая
приобрести:  приобрести
вычурный:  вычурных
забугорный:  забугорный
лажа:  лажи
разжиться:  разжиться
псевдоэнциклопедия:  псевдоэнциклопедий
кнопочка:  кнопочку
выполнить:  выполнены
помнить:  помнить помните
среднееквадратический:  среднееквадратическое
пространство:  пространстве
программный:  программное
пример:  примеры пример примеров
жать:  жмешь
лопиталя:  лопиталя
начинать:  начинаешь
удовольствие:  удовольствие
последовательность:  последовательностей
комбинационный:  комбинационная
крайне:  крайне
квадратичный:  квадратичные
быть:  будьте
помощник:  помощник
смешанноепроизведение:  смешанноепроизведение
понимать:  понимая понимать
посчитать:  посчитать
учебный:  учебных
объём:  объем
портал:  порталов
препод:  препод
проверить:  проверить
поляформула:  поляформула
образовательный:  образовательный
наверное:  наверное
сообщить:  сообщите
сделать:  сделать сделал
трудность:  трудность
линия:  линиями линии линия
фехнера:  фехнера
сессия:  сессии сессию
аналитический:  аналитическая аналитической
домен:  доменах домене
поддомен:  поддоменах поддомене
достоверность:  достоверность
школьный:  школьный
эффективный:  эффективные эффективного
калькулятор:  калькуляторы калькулятор калькуляторов
центр:  центр
появляться:  появляются
обзор:  обзор
гипергеометрическоераспределение:  гипергеометрическоераспределение
образ:  образом
условный:  условные
непрерывнаяслучайный:  непрерывнаяслучайная
другой:  других другое другие другим
стройный:  стройные
эллипс:  эллипс
ибо:  ибо
раз:  раза
сложно:  сложно
цель:  целью
длина:  длина
чудесенко:  чудесенко
экспонент:  экспоненты
возможность:  возможность
мочь:  могут могу
знакопостоянство:  знакопостоянства
равномерный:  равномерная равномерное
треугольный:  треугольная
прислать:  присланные
градиент:  градиент
посетить:  посетить
количество:  количество
профессиональный:  профессиональной
определение:  определения определению
расположить:  расположенный расположен расположена
правда:  правды правда
мой:  моей
определённый:  определенное определенный определенного
счастие:  счастью
ага:  ага
внимание:  внимания внимание
использовать:  используйте
дурак:  дурак
пожалуйста:  пожалуйста
даламбер:  даламбера
теорема:  теоремы
факт:  факт
бесплатно:  бесплатно
комбинаторика:  комбинаторике
число:  числе числами числа
случайнаявеличина:  случайнаявеличина
повторнойя:  повторнойи
построение:  построение
следовать:  следует
мучиться:  мучиться
бесконечно:  бесконечно
линейнойкорреляционный:  линейнойкорреляционной
действие:  действия
деятельность:  деятельности
себя:  собой
программа:  программа программу
списывать:  списывать
сниматься:  снимается
квадрат:  квадратов
ранг:  ранг
время:  время времени
кривая:  кривой
форма:  формы
тяжестиплоска:  тяжестиплоской
отметить:  отметить
зачёт:  зачеты
сразу:  сразу
пережить:  пережил
распределениякритерия:  распределениякритерий
функциюкомплексный:  функциюкомплексной
кратко:  кратко
недостаток:  недостаткам недостатками
поисковый:  поисковой
щёлкать:  щелкают
область:  область области
проверка:  проверка
допустить:  допустим
приложить:  приложить
преподаватель:  преподаватель преподавателей
год:  годы
построить:  построить
готовый:  готовых готовые готовое
несобственный:  несобственные
просто:  просто
мода:  мода
каков:  каково
свойстваэлементарный:  свойстваэлементарных
архив:  архивы архивами
человек:  людям человек
ещё:  ещё
зрение:  зрения
лейбниц:  лейбница
научиться:  научиться
подозрение:  подозрение
реклама:  рекламы
забывать:  забываю
неравенство:  неравенства
вариант:  варианты вариант
порекомендовать:  порекомендовать
некорректный:  некорректных
поток:  поток
тематический:  тематических
обернуться:  обернётся
касательная:  касательная
ответ:  ответ
задачис:  задачис
проплатить:  проплаченных
использоваться:  использовался
раскрутить:  раскрученных
отличаться:  отличается отличаются
разобраться:  разобраться
медиана:  медиана
доверять:  доверять
полезный:  полезные полезной полезных полезны
потратить:  потратить
бывать:  бывает бывают
функциия:  функциии
частый:  чаще
степенной:  степенного степенные
возможно:  возможно
функцийдвуха:  функцийдвух
направлениюй:  направлениюи
выборка:  выборке
подобный:  подобных
гостевой:  гостевая
многовато:  многовато
приносить:  приносит
тема:  тему
действительно:  действительно
стать:  станет
ресурс:  ресурс ресурсов
распределение:  распределения распределение
кроме:  кроме
экстремум:  экстремумы
быстренько:  быстренько
горнера:  горнера
производныефункция:  производныефункции
средний:  средняя
функцийнесколький:  функцийнескольких
знание:  знаний
основать:  основана
подготовка:  подготовки
главное:  главное
внутригрупповаяй:  внутригрупповаяи
формат:  формате
популярный:  популярных
он:  нём
прорешивать:  прорешивают
понять:  понять
алгебра:  алгебры
машинный:  машинных
наука:  наукам
математик:  математика
ниша:  ниши
функцийв:  функцийв
переменный:  переменных переменной
др:  др
добавить:  добавьте
пакет:  пакетами
несовместный:  несовместные
независимыеслучайный:  независимыеслучайные
множественнойлинейный:  множественнойлинейной
крупный:  крупнейший
существовать:  существует существуют
анализ:  анализ анализа
позитивный:  позитивный
остановиться:  остановлюсь
проект:  проекта
прямоугольник:  прямоугольников
непрерывность:  непрерывность
эксцессэмпирический:  эксцессэмпирического
очко:  очков
хранилище:  хранилищ
десятка:  десятки
составить:  составил
лабораторный:  лабораторные
функциис:  функциис
этот:  этому этих эта
зеркало:  зеркало
криволинейный:  криволинейные
значит:  значит
мгу:  мгу
второй:  втором второго
пирсон:  пирсона
умение:  умения
предостерегать:  предостерегаю
три:  трёх
межгрупповой:  межгрупповая
каждый:  каждый каждую
ортогональный:  ортогональное
дискретнойслучайный:  дискретнойслучайной
задачипо:  задачипо
находить:  находил
востребовать:  востребованную
разместить:  разместить
наименьшеезначение:  наименьшеезначения
нсв:  нсв
банк:  банк
сила:  силы
приблизить:  приближенные
запросто:  запросто
учебник:  учебниках
сильный:  сильное
системылинейный:  системылинейных
укладка:  укладка
нужно:  нужно
вроде:  вроде
прекрасно:  прекрасно
тяжело:  тяжело
совпасть:  совпасть
быстро:  быстро
упасть:  упал
выкладка:  выкладки
семестр:  семестре
зависимый:  зависимые
обучать:  обучающие
буквально:  буквально
зависимость:  зависимость
увидеть:  увидели
отклонение:  отклонение
крамер:  крамера
покорный:  покорный
отрезка:  отрезке
проверяться:  проверяются
эффективно:  эффективно
регистрация:  регистрации
таблица:  таблицы
авторский:  авторские
произведение:  произведение
немало:  немало
знать:  знаете
случайный:  случайных случайные
замкнутый:  замкнутому
симпатично:  симпатично
неприятный:  неприятны
изучать:  изучает
отключаться:  отключается
источник:  источников источнику
дуга:  дуги
скачивание:  скачивание
отрезкать:  отрезкав
дивергенция:  дивергенция
парабола:  парабола
использование:  использования
изложить:  изложена
спасибо:  спасибо
подробность:  подробность
форум:  форуме форум
показатель:  показатели
услуга:  услуга
наш:  наш нашу
отличие:  отличие
рамка:  рамках
перечисление:  перечисления
скан:  сканы
площадьс:  площадьс
запретить:  запрещено
функциидвуха:  функциидвух
один:  одним
отделение:  отделений
статистический:  статистические статистическая
файловый:  файловых
емелин:  емелин
хороший:  хорошие хорошей хороший
студопедия:  студопедии
выдавать:  выдаёт
причина:  причине
задачник:  задачников
убыванией:  убываниеи
вычисленияопределенный:  вычисленияопределенных
повышенный:  повышенной
возрастание:  возрастание
эмпирический:  эмпирические
детерминация:  детерминации
также:  также
интегрирование:  интегрирование
вольный:  вольно
обязательно:  обязательно
легко:  легко
задачин:  задачина
замечательный:  замечательные
решебникнуть:  решебник
настроиться:  настройтесь
рациональный:  рациональные
системый:  системыи
начать:  начать
удовлетворяетлить:  удовлетворяетли
найтись:  нашлось
неплохой:  неплохое
субъективный:  субъективной
списывание:  списыванием
поставить:  поставлю
читатель:  читателям
сборник:  сборникам сборники
решебник:  решебника
вменяемый:  вменяемый
дифференциальныеуравнение:  дифференциальныеуравнения
сеть:  сети
иррациональный:  иррациональных
некоторый:  некоторых
интервальный:  интервальный
очный:  очных
сожаление:  сожалению
тригонометрический:  тригонометрических
постоянный:  постоянных
понятный:  понятной
квадратичнуюформ:  квадратичнуюформу
стокс:  стокса
схема:  схема
карта:  карта
параметрический:  параметрической параметрическом
единица:  единица
многочисленный:  многочисленных
скрип:  скрипом
гипербола:  гипербола
самостоятельно:  самостоятельно
нередко:  нередко
прокатить:  прокатит
дробовик:  дробовик
они:  ними
группа:  группа
оценкия:  оценкии
неявный:  неявной
лично:  лично
армия:  армии
несобственныхинтеграл:  несобственныхинтегралов
вероятностибиномиальный:  вероятностибиномиального
развитие:  развитие
тяжёлый:  тяжелых
вероятностия:  вероятностии
логика:  логики
ценность:  ценность
род:  рода
заданав:  заданав
скалярный:  скалярное
спирмена:  спирмена
гаусс:  гаусса
порядок:  порядка порядков
всё:  всё
значимость:  значимости
тройной:  тройные
английский:  английский
масса:  масса
деление:  деления
являться:  является
контуруформула:  контуруформула
точно:  точно
иной:  иной
экстремальный:  экстремальные
график:  график
ход:  ход
лишь:  лишь
авторитетность:  авторитетность
представить:  представлю
св:  св
парный:  парной
рябушко:  рябушко
ненадёжность:  ненадёжность
качество:  качество
нормаль:  нормали
определитель:  определитель
успеть:  успели
владелец:  владельцам
выпуклость:  выпуклость
федеральный:  федерального
автор:  авторы автора
элемент:  элементы
диковинный:  диковинным
показательный:  показательное
либо:  либо
шар:  шару
моментально:  моментально
элементарно:  элементарно
рекомендовать:  рекомендую
независимый:  независимые
гласить:  гласит
удаться:  удалось
халява:  халяву
менее:  менее
получить:  получи
кузнецов:  кузнецова
сложность:  сложности
диффура:  диффурами
рефератник:  рефератники
часто:  часто
значенияй:  значенияи
прибавить:  прибавит
изучение:  изучения
привести:  привести
лёгкий:  лёгкой
даром:  даром
забить:  забили
поиск:  поиска
позаимствовать:  позаимствовано
вуз:  вузов
физика:  физике
получаться:  получается
вычисление:  вычисление
какой:  какие
я:  мной
содержать:  содержат
почерк:  почерк
классическоеопределение:  классическоеопределение
инормаль:  инормаль
представлять:  представляет представляют
статистика:  статистика
корреляция:  корреляции
прежде:  прежде
уточнить:  уточнить
лад:  лад
зимний:  зимнюю
интеллект:  интеллект
биномиальный:  биномиальное
редкий:  реже
заочник:  заочников
пирамида:  пирамида
линиюв:  линиюв
мозг:  мозг
видимо:  видимо
отнести:  отнести
пробивать:  пробиваем
нефть:  нефть
отношение:  отношении
повторять:  повторяем
вышмат:  вышмату
менять:  менять
скачать:  скачать
