уравнение:  уравнениях уравнению уравнений уравнения уравнение
вектор:  векторы векторов
столько:  столько
получить:  получить полученное полученный получила получи
фиолетовый:  фиолетовая
отработка:  отработки
постараться:  постараться
свести:  сведем сведём
вращение:  вращения
дифференциальный:  дифференциальные
уравненияс:  уравненияс
проверять:  проверяйте проверяем
онлайн:  онлайн
геометрия:  геометрии геометрия
приближаться:  приближаемся
копирование:  копирование
рассмотреть:  рассмотреть рассмотренная рассмотрю рассмотренной
решить:  решить
сколь:  сколь
покарать:  покарать
вдаваться:  вдаваясь
разрыв:  разрыва
работа:  работа
выражение:  выражения
сумма:  сумма сумму
один:  одного одну одной одно одним
производный:  производные производная производной производную
прямой:  прямой прямую прямая
дуприближённо:  дуприближённо
новый:  новому
предел:  предел пределы пределов
произвольныйтройный:  произвольныйтройной
модель:  модели модель
определённый:  определённой определенный определенного
беспорядочный:  беспорядочным
асимптота:  асимптоты
роль:  роль
дизайн:  дизайна
обеспечение:  обеспечение
достигнуть:  достигнем достигнута
это:  это
уточнение:  уточнения уточнение
название:  название
необходимость:  необходимости
событие:  события
приближение:  приближения приближением приближению приближение приближении
отблагодарить:  отблагодарить
кардать:  кардано
больший:  больших наибольшее
основание:  основании
повторный:  повторные
описать:  описанная
байес:  байеса
часы:  часы
числовой:  числовые
экселе:  экселе
дисперсия:  дисперсию дисперсия дисперсии
простой:  проще прост
решать:  решать
производныенеявно:  производныенеявно
пример:  примере примеры пример примера примеров
начинать:  начинать начинаем
значение:  значение значения
точнее:  точнее
таблица:  таблицу таблицы
провернуть:  провернуть
решение:  решений решением решение решения
перпендикуляр:  перпендикуляр
выяснить:  выясним
обозначать:  обозначают
поляй:  поляи
интеграл:  интегралы интеграла интеграл интеграле интегралов
точность:  точности точностью точность
итерация:  итераций итерациями итерации
опечатка:  опечатку
находиться:  находится
указать:  указано
случай:  случаях случай случаи случае
содержаться:  содержится
вшивость:  вшивость
математический:  математические математическая математической
теория:  теория теории
широкий:  широкого
способ:  способом способов способа способ
состоять:  состоит
формула:  формулы формул формула формулу
данный:  данном данного
смотреть:  см
сам:  сами самом
фнп:  фнп
ужесточиться:  ужесточилось
действительный:  действительные действительных действительного действительный
трудный:  труднее
называть:  называют называемых
канонический:  каноническому
графический:  графический графического
простейшее:  простейшие
прийтись:  придётся пришлось
абсцисса:  абсциссой абсцисс
округлить:  округлить
отрезок:  отрезку отрезок отрезка
гипотеза:  гипотезы гипотез гипотеза
дифференциал:  дифференциалах дифференциала
двумерный:  двумерная
который:  которых которые котором которого которому которая которой которое
методомоперационный:  методомоперационного
задать:  заданной зададим задайте заданная
заметить:  заметьте заметили
часть:  частям часть
тело:  тела
циркуляция:  циркуляция
бесповторный:  бесповторной
рекуррентный:  рекуррентную рекуррентной
преимущество:  преимущество
расчёт:  расчёты
фраза:  фраза
двойной:  двойные двойной
предназначить:  предназначен
ошибка:  ошибку
намёк:  намёк
плоскость:  плоскости плоскость
несобство:  несобств
л:  л
аналитический:  аналитического аналитическая аналитическими аналитической
общий:  общим общая общего
судить:  судя
обойтись:  обойтись
нелинейный:  нелинейная
получиться:  получится
убывать:  убывают
задание:  задании задания
поздний:  позже
преобразованиеквадратичный:  преобразованиеквадратичной
примерный:  примерными
определителяй:  определителяи
степень:  степени степеней
вогнутостья:  вогнутостьи
посему:  посему
напрашиваться:  напрашивается
график:  графиков графиком графиках графику график
вид:  виде виды виду
согласно:  согласно
дважды:  дважды
закон:  законы
позволять:  позволяет
функциональный:  функциональные
взять:  взять
касательный:  касательных касательную
статья:  статья
убедиться:  убедиться
качество:  качестве
приближённый:  приближённого приближённое приближённые
тематический:  тематическую
корень:  корня корни корню корень корней
координата:  координату координат координаты координатах
последний:  последнем последнего
профессия:  профессию
получаться:  получаются получается
геометрический:  геометрическая геометрическое
абсолютный:  абсолютная
графика:  графика графики
типовыхзадача:  типовыхзадач
половинный:  половинного
краткий:  краткая
грубый:  грубый
умножение:  умножения
удобно:  удобно
вероятность:  вероятностей вероятностью вероятность вероятности
столбец:  столбец
немалый:  немалой
ранговойкорреляция:  ранговойкорреляции
система:  система систему системе системы
частный:  частные частное
функция:  функций функции функция
рука:  руки рукой
непрерывный:  непрерывная непрерывных
группировка:  группировок группировка
констатироваться:  констатируется
условнаясходимость:  условнаясходимость
сложенияй:  сложенияи
уравненийв:  уравненийв
трюк:  трюка
фигурировать:  фигурирует
правый:  правый
регрессия:  регрессии регрессия
величина:  величин величина величины
александр:  александр
ось:  ось
очевидный:  очевидное очевидно
оценка:  оценке оценки оценка
старание:  старания
конец:  концах концов конца конец
грин:  грина
полный:  полное полных полной
претендовать:  претендовать
исчисление:  исчисления
линейный:  линейные линейная линейных линейной
отыскать:  отыскать
вниз:  вниз
эйлер:  эйлера
тысячная:  тысячной тысячную
метод:  метода методы методом метод
отделить:  отделить
опускать:  опускаем
обеспечиваться:  обеспечивается
быть:  суть будут
подходить:  подходит
удвоенный:  удвоенной
согласие:  согласия
локальный:  локальная
запятая:  запятой
годиться:  годится
идея:  идее
ожидание:  ожидание
сколько:  сколько
математика:  математики математике
лаплас:  лапласа
перегиб:  перегиба
такой:  таким такие такое таких
сходимость:  сходимости сходимостью сходимость
дуоперационный:  дуоперационным
исследовать:  исследовать
невозможно:  невозможно
дискретный:  дискретный
нетрудно:  нетрудно
базис:  базисах базис базису
поверхность:  поверхности
начальный:  начальным начальное начального
знакочередоваться:  знакочередующиеся
задача:  задачи задачу задачах задача
вычисление:  вычислений вычисления вычисление
пересекать:  пересекает
векторный:  векторного векторное
ду:  ду
наиболее:  наиболее
заметно:  заметно
доля:  доли
далее:  далее
зависимостьвектор:  зависимостьвекторов
линейныйкоэффициент:  линейныйкоэффициент
делать:  делать
обладать:  обладает
снова:  снова
оно:  оно
коэффициент:  коэффициент
неопределённый:  неопределенный неопределенном
соответствовать:  соответствующее соответствующей соответствующую
таковой:  таковые
приложение:  приложений
удовлетворять:  удовлетворять удовлетворяет удовлетворяют
сначала:  сначала
круг:  круг
промежуток:  промежуток промежутка
дробь:  дробей дробь
следующий:  следующему следующий следующем следующей
собственный:  собственные
пожалуй:  пожалуй
страница:  страницу
практически:  практически
меняться:  меняться
несобственныйинтеграл:  несобственныйинтеграл
признак:  признак признаки
произвольный:  произвольных
недостаток:  недостаток недостатков
данные:  данных
сложный:  сложной сложных сложные
рядом:  рядом
доступно:  доступно
искать:  искать
приблизить:  приближенного приближенное приближенные
работать:  работает
высокий:  высокое высших высшей высокой высшая
причём:  причём
фурье:  фурье
учиться:  учимся
поле:  поля
поэтому:  поэтому
разложение:  разложением разложение
задавать:  задаваемые
практика:  практике
свойство:  свойства
отделять:  отделяют
точка:  точка точки точку точке
заранее:  заранее
разумеется:  разумеется
лишний:  лишние
просканировать:  просканируем
исследование:  исследование
указанный:  указанных указанному
принцип:  принципе
помогать:  помогает
ипример:  ипримеры
знать:  знаем знаете
множество:  множества множество
переход:  переходе переход
найти:  найти найдём найдем
первый:  первую первое первом первого
вариация:  вариации
умолчать:  умолчал
противный:  противном
асимметрия:  асимметрия
шаг:  шаге шагами шага
комплексный:  комплексными комплексные комплексного комплексный
основа:  основы
поверхностный:  поверхностные
слишком:  слишком
переходить:  переходим
требование:  требование
плавно:  плавно
интервал:  интервалы
книга:  книга книги
главный:  главную
выкладка:  выкладками
кош:  коши
раскрыть:  раскрыл
сверху:  сверху
фигура:  фигуры
представимый:  представим
выше:  выше
пуассон:  пуассона
подобный:  подобные
сводиться:  сводящиеся
чайник:  чайников
преобразование:  преобразований преобразования
замена:  замены
раздел:  раздел
вычисленияс:  вычисленияс
однако:  однако
доступный:  доступен
инженерный:  инженерных
ожидать:  ожидает
результат:  результаты результате
малый:  малые меньшей наименьших малый
связь:  связь
маленький:  меньше мал
элементарный:  элементарный
понижение:  понижением понижение
несмотря:  несмотря
матричный:  матричные матричных матричный
середина:  середину
рациональный:  рациональных рациональные
применять:  применяя
отрицательный:  отрицательными
математическоеожидание:  математическоеожидание
например:  например
однородный:  однородные однородным
решенияопределённый:  решенияопределенных
вычислить:  вычислить вычисленные
расчётный:  расчётную
образец:  образцами
нормальный:  нормальное
школа:  школа
очень:  очень
приближённо:  приближённо
интегральнаятеорема:  интегральнаятеоремы
удобный:  удобнее удобный
хотя:  хотя
корнимногочлен:  корнимногочлена
логарифмический:  логарифмическая
матрица:  матрицу матрицы матрицами
условно:  условно
условие:  условие условия условий условию
испытанияй:  испытанияи
интегралыть:  интегралыв
научиться:  научимся научиться
близкий:  ближе
неоднородный:  неоднородные
ошибиться:  ошиблись
перегруппировка:  перегруппировка
каждый:  каждое каждому
правило:  правило правила
многочлен:  многочленов многочлена
основной:  основные
помощь:  помощью
бернулли:  бернулли
цель:  цели
полярный:  полярные полярной полярных
коэффициентковариация:  коэффициентковариации
ряд:  ряд ряды ряда рядов
обратить:  обратим обратите
вариационный:  вариационный
проявить:  проявить
уровень:  уровня
обратный:  обратная обратную
попадать:  попадаем
должный:  должны должно должен
критерий:  критерия
вопрос:  вопросы вопрос вопроса
толстый:  толстый
последовательный:  последовательные
кратное:  кратные
проблема:  проблема
выполнение:  выполнение выполнении
системудифференциальный:  системудифференциальных
значительно:  значительно
разнознаковый:  разнознакового разнознаковый
блог:  блог
доверительный:  доверительные
доверять:  доверяйте
отметить:  отметим
теорема:  теореме теоремы
среднееквадратический:  среднееквадратическое
единственный:  единственной единственный единственного
пространство:  пространстве
программный:  программное
алгоритм:  алгоритм
лопиталя:  лопиталя
последовательность:  последовательностей
комбинационный:  комбинационная
развитие:  развитием
курс:  курс
квадратичный:  квадратичные
обычно:  обычно
смешанноепроизведение:  смешанноепроизведение
известный:  известен
строиться:  строятся
вычислять:  вычисляем
подойти:  подошёл
объём:  объем
проверить:  проверить проверим
поляформула:  поляформула
сообщить:  сообщите
сделать:  сделать
линия:  линиями линии линия
фехнера:  фехнера
рассчитываться:  рассчитывается
определить:  определить
иррациональный:  иррациональный иррациональные иррациональных
вычислительный:  вычислительной
поскольку:  поскольку
школьный:  школьный
эффективный:  эффективные эффективных
парабола:  параболу парабола
мы:  нам
энный:  энное
центр:  центр
образ:  образом
гипергеометрическоераспределение:  гипергеометрическоераспределение
выбирать:  выбираем
условный:  условные
непрерывнаяслучайный:  непрерывнаяслучайная
прикладной:  прикладных
другой:  других другое другие
эллипс:  эллипс
третий:  третьем
ноль:  ноль
узнать:  узнаем
длина:  длина
смочь:  сможем
сайт:  сайта сайты сайт
сократить:  сократить
мочь:  могут
знакопостоянство:  знакопостоянства
технический:  техническую
равномерный:  равномерная равномерное
проводить:  проводить проводят проводим
треугольный:  треугольная
градиент:  градиент
количество:  количество
чертёж:  чертёж чертежа чертеже
требовать:  требуемая требуемой
определение:  определения определению
трудность:  трудности
подстановка:  подстановкой
точный:  точные
быстрый:  быстрее
использовать:  используйте используя использовать
пожалуйста:  пожалуйста
даламбер:  даламбера
сторона:  сторону
разобрать:  разобранном
урок:  урок
факт:  факт факта
комбинаторика:  комбинаторике
случайнаявеличина:  случайнаявеличина
повторнойя:  повторнойи
тяжёлый:  тяжелый
построение:  построение построения
следовать:  следует следовало
бесконечно:  бесконечно
знак:  знаков знаки
скорость:  скорости
модуль:  модуль модулю
линейнойкорреляционный:  линейнойкорреляционной
синий:  синяя
действие:  действия
квадрат:  квадратов
ранг:  ранг
кривая:  кривой
форма:  формы
пора:  пор
тяжестиплоска:  тяжестиплоской
ньютон:  ньютона
сразу:  сразу
изолироваться:  изолируется
примитивный:  примитивен
распределениякритерия:  распределениякритерий
достижение:  достижения
функциюкомплексный:  функциюкомплексной
уменьшить:  уменьшить
напоминать:  напоминаю
область:  область области
проверка:  проверка
эффект:  эффект
сомневаться:  сомневающиеся
приобретать:  приобретает
перетекать:  перетекает
построить:  построить построим
дорога:  дорога
готовый:  готовых
несобственный:  несобственные
просто:  просто
мода:  мода
выполнять:  выполнять
свойстваэлементарный:  свойстваэлементарных
приём:  приём
ещё:  ещё
принимать:  принимает
внимание:  внимание
обычный:  обычная
калькулятор:  калькулятор
лейбниц:  лейбница
неравенство:  неравенства
наш:  наше наш нашего нашем
процесс:  процесс
принадлежащий:  принадлежащий
занять:  займут
поток:  поток
поставить:  поставим
наобум:  наобум
выбираться:  выбирается
касательная:  касательная
потребность:  потребность
задачис:  задачис
ответ:  ответ ответы
оба:  оба
реально:  реально
разный:  разных разные
медиана:  медиана
явно:  явно
бывать:  бывает
нахождение:  нахождения
иксовый:  иксовую
функциия:  функциии
техника:  техники
частый:  чаще
степенной:  степенного степенные
функцийдвуха:  функцийдвух
специальный:  специального
направлениюй:  направлениюи
выборка:  выборке
камень:  камней
гостевой:  гостевая
вы:  вами
рисунок:  рисунок
наличие:  наличие
левый:  левый левую
стать:  станет статей
распределение:  распределения распределение
кроме:  кроме
экстремум:  экстремумы
приниматься:  принимается
аккуратно:  аккуратно
горнера:  горнера
производныефункция:  производныефункции
средний:  средняя
пересечь:  пересекла пересечёт
пересечение:  пересечения
понятно:  понятно
равный:  равен
функцийнесколький:  функцийнескольких
поточечный:  поточечно
спасительный:  спасительного
щадить:  щадящая
попасть:  попали попал
схематичный:  схематичный
видный:  виден
чисто:  чисто
внутригрупповаяй:  внутригрупповаяи
формулировка:  формулировке
он:  нём
ссылка:  ссылке
понять:  понять
алгебра:  алгебры
путь:  пути
далеко:  далеко
число:  числами числа
математик:  математика
функцийв:  функцийв
переменный:  переменных переменной
попробовать:  попробовать
ознакомиться:  ознакомиться
несовместный:  несовместные
независимыеслучайный:  независимыеслучайные
множественнойлинейный:  множественнойлинейной
громоздкий:  громоздок
существовать:  существует существуют
анализ:  анализ анализа
следовательно:  следовательно
намного:  намного
кубический:  кубическую
прямоугольник:  прямоугольников
непрерывность:  непрерывность непрерывности
эксцессэмпирический:  эксцессэмпирического
единичный:  единичный
выбрать:  выбрать
подставить:  подставить
естественный:  естественное
функциис:  функциис
угодный:  угодно
зеркало:  зеркало
различный:  различных
тестировать:  тестируем
криволинейный:  криволинейные
значит:  значит
иллюстрация:  иллюстрации
весь:  всему
второй:  втором второго вторую
пирсон:  пирсона
библиотека:  библиотека
три:  трёх
межгрупповой:  межгрупповая
ортогональный:  ортогональное
дискретнойслучайный:  дискретнойслучайной
определяться:  определяется
задачипо:  задачипо
возможность:  возможности
нуль:  нулей
пополам:  пополам
востребовать:  востребованную
наименьшеезначение:  наименьшеезначения
рутинный:  рутинные
нсв:  нсв
сила:  силы
системылинейный:  системылинейных
нужно:  нужно
неуклонно:  неуклонно
быстро:  быстро
графически:  графически
микрокалькулятор:  микрокалькулятор
самый:  самое самый
упасть:  упал
чистовой:  чистового
соответствие:  соответствии
гарантированно:  гарантированно
обоснование:  обоснование
зависимый:  зависимые
путём:  путём
буквально:  буквально
зависимость:  зависимость
отклонение:  отклонение
крамер:  крамера
отрезка:  отрезке
материал:  материалы материалов
произведение:  произведение
случайный:  случайных случайные
замкнутый:  замкнутому
последующий:  последующее
важность:  важность
частность:  частности
дуга:  дуги
оставаться:  остаются
отрезкать:  отрезкав
округление:  округление
запись:  запись
дивергенция:  дивергенция
правда:  правда
форум:  форуме форум
теоретический:  теоретическое
показатель:  показатели
оформление:  оформления
площадьс:  площадьс
к:  ко
функциидвуха:  функциидвух
запретить:  запрещено
статистический:  статистические статистическая
емелин:  емелин
встречаться:  встречались встречается
допустимый:  допустимо
немножко:  немножко
причина:  причине
убыванией:  убываниеи
вычисленияопределенный:  вычисленияопределенных
повышенный:  повышенной повышенное
возрастание:  возрастание
эмпирический:  эмпирические
детерминация:  детерминации
дать:  данная
интегрирование:  интегрирование
предложить:  предложенное
легко:  легко
задачин:  задачина
замечательный:  замечательные
системый:  системыи
начать:  начать
удовлетворяетлить:  удовлетворяетли
тот:  тех
найтись:  нашлось
важный:  важные
пока:  пока
подробный:  подробное
сегодня:  сегодня
потребоваться:  потребуется
дифференциальныеуравнение:  дифференциальныеуравнения
приходиться:  приходится
заполнить:  заполним
интервальный:  интервальный
перейти:  перейти
тригонометрический:  тригонометрических
постоянный:  постоянных
квадратичнуюформ:  квадратичнуюформу
стокс:  стокса
схема:  схема
карта:  карта
параметрический:  параметрической параметрическом
итак:  итак
мера:  мере
гипербола:  гипербола
провести:  проведем провести
жёлтый:  жёлтой жёлтый
прозванивать:  прозваниваем
звание:  звание
дробовик:  дробовик
они:  ними
принадлежать:  принадлежит
оценкия:  оценкии
неявный:  неявной
несобственныхинтеграл:  несобственныхинтегралов
вероятностибиномиальный:  вероятностибиномиального
закончить:  закончены
истинный:  истинного
подводный:  подводных
вероятностия:  вероятностии
совладать:  совладать
логика:  логики
медленно:  медленно
род:  рода
заданав:  заданав
скалярный:  скалярное
спирмена:  спирмена
гаусс:  гаусса
оранжевый:  оранжевую
следствие:  следствие
совершенно:  совершенно
порядок:  порядка порядков
всё:  всё
завершиться:  завершился
значимость:  значимости
изобразить:  изобразим
тройной:  тройные
возникать:  возникает
деление:  деления
являться:  является
выразить:  выразить
контуруформула:  контуруформула
точно:  точно
завершить:  завершить
какой:  каким
экстремальный:  экстремальные
вовсе:  вовсе
отделение:  отделения
очередь:  очереди
лишь:  лишь
дело:  деле дело
выполнимый:  выполним
её:  её
св:  св
парный:  парной
нормаль:  нормали
иметь:  имеет
совершить:  совершить
определитель:  определитель
секунда:  секунды
клиент:  клиент
выпуклость:  выпуклость
ошибаться:  ошибаемся
несколько:  несколько
элемент:  элементы
достаточно:  достаточно
сборник:  сборники
момент:  моменты
показательный:  показательное
версия:  версия
примерно:  примерно
независимый:  независимые
нечётный:  нечётной
автор:  автора автор
понимать:  понимаете
сложность:  сложности
диффура:  диффурами
подход:  подход
часто:  часто
значенияй:  значенияи
пользоваться:  пользуясь
глазок:  глазок
привести:  привести
заносить:  заносить
этот:  эта
изолировать:  изолировать
семимильный:  семимильными
весьма:  весьма
подразумевать:  подразумевает
нужный:  нужной
радикал:  радикалы
кстати:  кстати
находить:  находим
классическоеопределение:  классическоеопределение
инормаль:  инормаль
место:  место
статистика:  статистика
корреляция:  корреляции
прежде:  прежде
биномиальный:  биномиальное
слово:  слово
заочник:  заочников
пирамида:  пирамида
линиюв:  линиюв
предшествовать:  предшествующих
самостоятельный:  самостоятельного
заходить:  заходим
отношение:  отношении
делимый:  делим
повыситься:  повысилось
говорить:  говоря
повторять:  повторяем
парочка:  парочка
завершаться:  завершается
неиллюзорный:  неиллюзорную
