помечать:  помечать
вектор:  векторы векторов
цель:  целях
счёт:  счёт
вращение:  вращения
дифференциальный:  дифференциальные
уравненияс:  уравненияс
однозначный:  однозначной
онлайн:  онлайн
накапливать:  накапливает
смысл:  смысл
геометрия:  геометрии геометрия
неотрицательный:  неотрицательна
копирование:  копирование
решить:  решить
сколь:  сколь
разрыв:  разрыва
работа:  работа работе
выражение:  выражения
сумма:  сумма сумму
производный:  производные производная производной производную
прямой:  прямой прямую прямая
дуприближённо:  дуприближённо
новый:  новому новые
предел:  предел пределах пределы пределов
произвольныйтройный:  произвольныйтройной
модель:  модели модель
затеряться:  затерялось
асимптота:  асимптоты асимптотами
дизайн:  дизайна
это:  это
парабола:  параболы парабола
событие:  события событий
отблагодарить:  отблагодарить
повторный:  повторные
байес:  байеса
преодоление:  преодолению
интерес:  интереса
число:  числу числами числа
числовой:  числовые числовой
дисперсия:  дисперсию дисперсией дисперсия дисперсии
табличный:  табличный
решать:  решать
производныенеявно:  производныенеявно
пример:  примере примеры пример
значение:  значение значения значениями значений
решение:  решений решением решение решения
непрерывный:  непрерывной непрерывная непрерывных
явный:  явной
поляй:  поляи
интеграл:  интегралы интеграла интеграл интегралом интеграле интегралу интегралов интегралами
находиться:  находится находиться
опечатка:  опечатку опечатка
определённый:  определённому определенный определенного определённый
маньячить:  маньячить
оценить:  оценить оцените
результат:  результат результаты
отрицательный:  отрицательной
бесконечный:  бесконечной
теория:  теория теории
математический:  математические математическая математической математического математическое
технический:  техническими
описывать:  описывает
вероятный:  вероятны вероятные
сконцентрировать:  сконцентрированы сконцентрирована
продолжать:  продолжаем
состоять:  состоит
формула:  формулы формула формулу формуле
данный:  данном данный
свериться:  свериться
самоконтроль:  самоконтроля
показать:  показать покажем
замена:  замену замены
фнп:  фнп
высокий:  высшему высших высшей высшая
канонический:  каноническому
простейшее:  простейшие
гипотеза:  гипотезы гипотез гипотеза
косвенный:  косвенную косвенным
дифференциал:  дифференциалах дифференциала
двумерный:  двумерная
больший:  наибольшее большему большие большее
рецензент:  рецензенты
методомоперационный:  методомоперационного
задать:  заданной задайте задана
конец:  конце концу
посвятить:  посвящены
часть:  частям часть части
который:  которых которые которого которой которое
тело:  тела
циркуляция:  циркуляция
бесповторный:  бесповторной
знакомый:  знакомые
слева:  слева
образно:  образно
двойной:  двойные двойной
означать:  означает
отклонение:  отклонения отклонение
ошибка:  ошибку ошибка ошибке
плоскость:  плоскости плоскость
следующий:  следующих следующее
несобство:  несобств
случайный:  случайная случайной случайных случайные
избавляться:  избавляемся
л:  л
общий:  общим общая общем
нелинейный:  нелинейная
милость:  милости
итоговый:  итоговые
плотность:  плотностью плотность плотности
возрастать:  возрастать
преобразованиеквадратичный:  преобразованиеквадратичной
определителяй:  определителяи
выносить:  выносим
вогнутостья:  вогнутостьи
наименее:  наименее
вид:  виде виды виду
согласно:  согласно
дважды:  дважды
закон:  законы
дифференцирование:  дифференцированием
функциональный:  функциональные
реалистично:  реалистично
касательный:  касательных
профессия:  профессию
константа:  константу
условие:  условии
геометрический:  геометрическая геометрическое
абсолютный:  абсолютная
графика:  графика графики
типовыхзадача:  типовыхзадач
удобно:  удобно
один:  одной одно
умножение:  умножения
интересный:  интересные
вероятность:  вероятностей вероятность вероятности
ранговойкорреляция:  ранговойкорреляции
система:  система систему системе системы
частный:  частные частное
функция:  функций функцией функцию функции функция
выполнимый:  выполним
группировка:  группировок группировка
условнаясходимость:  условнаясходимость
сложенияй:  сложенияи
захватывать:  захватывающее
уравненийв:  уравненийв
немедленный:  немедленным
самый:  самые самое
правдоподобность:  правдоподобность
регрессия:  регрессии регрессия
величина:  величин величине величиной величина величины
александр:  александр
полениться:  полениться
служить:  служит служить
грин:  грина
полный:  полное полных полной
исчисление:  исчисления
линейный:  линейные линейная линейных линейной
борьба:  борьбе
смещение:  смещение
эйлер:  эйлера
правый:  правой правому
поместить:  поместил
согласие:  согласия
гораздо:  гораздо
локальный:  локальная
зачастую:  зачастую
ожидание:  ожидание ожидания
придерживаться:  придерживаться
математика:  математики математике
лаплас:  лапласа
перегиб:  перегиба
такой:  таким такие такое
представить:  представить
сходимость:  сходимости сходимость
дуоперационный:  дуоперационным
исследовать:  исследовать
достигать:  достигает
дискретный:  дискретный дискретной дискретном
базис:  базисах базис базису
ход:  ходу
поверхность:  поверхности
составить:  составить составим
знакочередоваться:  знакочередующиеся
задача:  задачи задач задачах задача
вычисление:  вычислений вычисления вычисление
векторный:  векторного векторное
минимум:  минимума
ду:  ду
теоретически:  теоретически
зависимостьвектор:  зависимостьвекторов
линейныйкоэффициент:  линейныйкоэффициент
приступать:  приступаем
обладать:  обладает
память:  памяти
снова:  снова
коэффициент:  коэффициент
неопределённый:  неопределенный неопределенном неопределённый
правдоподобный:  правдоподобным
сначала:  сначала
метод:  методы методах методом метод
промежуток:  промежуток промежутку промежутке промежутка
дробь:  дробей
слово:  слов
собственный:  собственные
инструкция:  инструкции
страница:  страницу
отмерить:  отмерьте
несобственныйинтеграл:  несобственныйинтеграл
признак:  признак признаки
произвольный:  произвольных
запутаться:  запутаться
данные:  данных
сложный:  сложной сложных сложные
чётность:  чётностью чётность чётности
ось:  оси
доступно:  доступно
дсв:  дсв
причём:  причём
фурье:  фурье
учиться:  учимся
поле:  поля
урок:  урока
разложение:  разложением разложение
задавать:  задаваемые
поэтому:  поэтому
свойство:  свойства свойством свойству свойство
соскучиться:  соскучились
конечный:  конечен
исследование:  исследование
кусок:  кусок кусками
принцип:  принципе
ипример:  ипримеры
уравнение:  уравнению уравнений уравнения уравнение
точка:  точки точкой точках точкам точке
рассмотреть:  рассмотрены рассмотренной
множество:  множества
найти:  найти найдём найдем
оценка:  оценки оценка
переход:  переход
вариация:  вариации вариация
получиться:  получилось получился
асимметрия:  асимметрия
коль:  коль
комплексный:  комплексными комплексные комплексного комплексный
основа:  основы
поверхностный:  поверхностные
мало:  мало
интервал:  интервалы интервале
книга:  книга книги
рука:  руках
оцениваться:  оцениваются
принять:  примет
главный:  главную главном
кош:  коши
координата:  координат координаты координатах
фигура:  фигуры
представимый:  представим
выше:  выше
пуассон:  пуассона
сводиться:  сводящиеся
чайник:  чайников
преобразование:  преобразований преобразования
практический:  практических
алгоритм:  алгоритма
однако:  однако
вычисленияс:  вычисленияс
вертикальный:  вертикальными
малый:  малые наименьших меньшее
записать:  запишем записать
связь:  связь
понижение:  понижением понижение
показывать:  показывает
матричный:  матричные матричных матричный
аддитивность:  аддитивности
убывать:  убывает убывать
заметить:  заметили
стандартный:  стандартное стандартного
математическоеожидание:  математическоеожидание
например:  например
однородный:  однородные однородным
решенияопределённый:  решенияопределенных
подвести:  подвести
выйти:  вышел вышло
вычислить:  вычислить
нормальный:  нормальное
школа:  школа
очень:  очень
требовать:  требовали
интегральнаятеорема:  интегральнаятеоремы
удобный:  удобнее удобный
корнимногочлен:  корнимногочлена
логарифмический:  логарифмическая
матрица:  матрицу матрицы матрицами
испытанияй:  испытанияи
интегралыть:  интегралыв
близкий:  ближе
неоднородный:  неоднородные
начать:  начнём начать
сопрячь:  сопряжено
перегруппировка:  перегруппировка
верхний:  верхние
проверять:  проверяем проверять
библиотека:  библиотеку библиотека
правило:  правило правила
основной:  основные
около:  около
помощь:  помощью
бернулли:  бернулли
полярный:  полярные полярной полярных
коэффициентковариация:  коэффициентковариации
ряд:  ряд ряды ряда рядов
вариационный:  вариационный
уровень:  уровня
обратный:  обратная обратную
вопрос:  вопросы вопрос
кратное:  кратные
взглянуть:  взгляните
системудифференциальный:  системудифференциальных
чертёж:  чертежи чертежу чертёж чертеже
отложить:  отложить
блог:  блог
вычисляться:  вычисляется
доверительный:  доверительные
пункт:  пунктов
симметричный:  симметричных симметричном симметричному
знать:  знал
отметить:  отметим отметить отметил
правильность:  правильности
помешать:  помешает
среднееквадратический:  среднееквадратическое
мера:  меру
строгий:  строгие
пространство:  пространстве
любимый:  любимому
лопиталя:  лопиталя
расти:  растёт
последовательность:  последовательностей
комбинационный:  комбинационная
должный:  должно
путь:  путь
курс:  курс
квадратичный:  квадратичные
смешанноепроизведение:  смешанноепроизведение
расписать:  расписать
объём:  объем
проверить:  проверить
поляформула:  поляформула
иметь:  иметь имеет
окончательно:  окончательно
сообщить:  сообщите
просить:  прошу
линия:  линиями линии линия
фехнера:  фехнера
аналитический:  аналитическая аналитическом аналитической
матожидание:  матожидание
поскольку:  поскольку
школьный:  школьный
эффективный:  эффективные эффективных
популярный:  популярные
единичный:  единичную
центр:  центр
образ:  образом
гипергеометрическоераспределение:  гипергеометрическоераспределение
условный:  условные
непрерывнаяслучайный:  непрерывнаяслучайная
равный:  равные равен равным
разделить:  разделило
эллипс:  эллипс
нахождение:  нахождение
обратить:  обратите
прямо:  прямо
длина:  длина
ссылка:  ссылкам
сайт:  сайта сайты сайт
немного:  немного
заштриховать:  заштрихованной
знакопостоянство:  знакопостоянства
отрезок:  отрезка
подробно:  подробно
равномерный:  равномерная равномерному равномерное
пробегать:  пробегающая
площадь:  площади площадь
треугольный:  треугольная
градиент:  градиент
определение:  определения определению
мой:  моей
предлагать:  предлагают предлагаю
десятка:  десятками
использовать:  используйте используем
пожалуйста:  пожалуйста
даламбер:  даламбера
примечать:  примечал
теорема:  теоремы
единица:  единицы
принимать:  принимать принимает
факт:  факт
комбинаторика:  комбинаторике
красный:  красной
случайнаявеличина:  случайнаявеличина
повторнойя:  повторнойи
затем:  затем
статья:  статьях
построение:  построение построении
сходиться:  сходящимся
вспоминать:  вспоминаем
следовать:  следует следовало
проверка:  проверку проверка
бесконечно:  бесконечно
наш:  наша наш нашем
модуль:  модуль
линейнойкорреляционный:  линейнойкорреляционной
действие:  действия
себя:  собой
желать:  желающих
живой:  живом
аналогия:  аналогии
квадрат:  квадратов
ранг:  ранг
время:  время
расписывать:  расписывать
кривая:  кривой
форма:  формы
тяжестиплоска:  тяжестиплоской
учёба:  учёбе
сила:  силу силы
сразу:  сразу
подынтегральный:  подынтегральной
каламбур:  каламбур
распределениякритерия:  распределениякритерий
относительно:  относительно
функциюкомплексный:  функциюкомплексной
случай:  случаи случае
область:  область области
средний:  среднее средняя
построить:  построить построим
готовый:  готовых
несобственный:  несобственные несобственными несобственный несобственным
просто:  просто
мода:  мода
свойстваэлементарный:  свойстваэлементарных
ещё:  ещё
внимание:  внимание
краткий:  краткое
зрение:  зрения
остановиться:  остановился
калькулятор:  калькулятор
лейбниц:  лейбница
говорить:  говорило говоря
научиться:  научиться
ради:  ради
поисковик:  поисковика
откуда:  откуда
неравенство:  неравенства
убедиться:  убедимся
поток:  поток
удивляться:  удивляться
быть:  буду будут
делить:  делит
опорный:  опорные
свой:  своей
определяться:  определяются определяется
касательная:  касательная
ответ:  ответ ответы
задачис:  задачис
разобраться:  разобраться
медиана:  медиана
бывать:  бывает бывают
правдоподобно:  правдоподобно
функциия:  функциии
чертёжом:  чертёжом
освежить:  освежить
степенной:  степенного степенные
функцийдвуха:  функцийдвух
направлениюй:  направлениюи
выборка:  выборке
подтянуться:  подтянулся
дело:  делу
гостевой:  гостевая
вы:  вами
скоро:  скоро
распределение:  распределения распределение распределений
экстремум:  экстремумы
известный:  известного
аккуратно:  аккуратно
горнера:  горнера
производныефункция:  производныефункции
понятно:  понятно
функцийнесколький:  функцийнескольких
вывод:  вывод
попасть:  попали
применять:  применять
внутригрупповаяй:  внутригрупповаяи
алгебра:  алгебры
подтверждение:  подтверждением
математик:  математика
функцийв:  функцийв
переменный:  переменных переменная переменной
несовместный:  несовместные
независимыеслучайный:  независимыеслучайные
множественнойлинейный:  множественнойлинейной
инструмент:  инструменты
добавить:  добавить
строка:  строкой строки
существовать:  существует
анализ:  анализ анализа
следовательно:  следовательно
квадратический:  квадратическое
прямоугольник:  прямоугольников
непрерывность:  непрерывность непрерывности
эксцессэмпирический:  эксцессэмпирического
забывать:  забываем
функциис:  функциис
угодный:  угодно
зеркало:  зеркало
различный:  различных
криволинейный:  криволинейные
промежуточный:  промежуточное
исходный:  исходная
пирсон:  пирсона
три:  трёх
межгрупповой:  межгрупповая
ортогональный:  ортогональное
дискретнойслучайный:  дискретнойслучайной
задачипо:  задачипо
два:  двумя
востребовать:  востребованную
наименьшеезначение:  наименьшеезначения
нсв:  нсв
приблизить:  приближенные
стать:  стал
вычислимый:  вычислим
знак:  знак
видно:  видно
вероятностный:  вероятностной
рассказывать:  рассказывал
системылинейный:  системылинейных
нужно:  нужно
трудный:  трудное трудная
сосредоточиться:  сосредоточиться
примечание:  примечание
упасть:  упал
зависимый:  зависимые
последний:  последних
зависимость:  зависимость
значительный:  значительная
крамер:  крамера
отрезка:  отрезке
материал:  материалы материалов
другой:  другие
таблица:  таблицы
похожий:  похожий
произведение:  произведение
вполне:  вполне
замкнутый:  замкнутому
очевидный:  очевидно
дуга:  дуги
пособие:  пособии
частность:  частности
отрезкать:  отрезкав
дивергенция:  дивергенция
учебный:  учебном
гуща:  гуща
карандаш:  карандашом
строго:  строго
форум:  форуме форум
повторимый:  повторим
показатель:  показатели
отличие:  отличие
предчувствие:  предчувствие
трудность:  трудностями
пользоваться:  пользуемся
добрый:  добрый
площадьс:  площадьс
спрашиваться:  спрашивалось
функциидвуха:  функциидвух
интегрировать:  интегрируем
ранее:  ранее
статистический:  статистические статистическая
обводить:  обводить
задание:  задание
энтузиазм:  энтузиазмом
емелин:  емелин
оформлять:  оформлять
встречаться:  встречались
хороший:  хорошие хороший
допустимый:  допустимо
причина:  причине
убыванией:  убываниеи
вычисленияопределенный:  вычисленияопределенных
повышенный:  повышенной
возрастание:  возрастание
эмпирический:  эмпирические
детерминация:  детерминации
дать:  данная дана
интегрирование:  интегрирование интегрирования
также:  также
заключительный:  заключительные
задачин:  задачина
замечательный:  замечательные
арксинус:  арксинуса
рациональный:  рациональные
системый:  системыи
удовлетворяетлить:  удовлетворяетли
тот:  тех
разбирать:  разбирали
найтись:  нашлось
выполнить:  выполнить
аппетит:  аппетит
нуль:  нулю
дифференциальныеуравнение:  дифференциальныеуравнения
ручной:  ручном
иррациональный:  иррациональных
интервальный:  интервальный
тригонометрический:  тригонометрических
постоянный:  постоянных
квадратичнуюформ:  квадратичнуюформу
стокс:  стокса
характеристика:  характеристики
схема:  схема
карта:  карта
параметрический:  параметрической параметрическом
итак:  итак
несложный:  несложный
иллюзия:  иллюзии
гипербола:  гипербола
самостоятельно:  самостоятельно
аналитически:  аналитически
запретить:  запрещено
равно:  равно
дробовик:  дробовик
они:  ними
оценкия:  оценкии
неявный:  неявной
несобственныхинтеграл:  несобственныхинтегралов
вероятностибиномиальный:  вероятностибиномиального
вероятностия:  вероятностии
логика:  логики
кубический:  кубической
род:  рода
заданав:  заданав
скалярный:  скалярное
спирмена:  спирмена
гаусс:  гаусса
порядок:  порядка порядков
всё:  всё
значимость:  значимости
тройной:  тройные
полезно:  полезно
тематический:  тематический
деление:  деления
являться:  является
мысленно:  мысленно
контуруформула:  контуруформула
точно:  точно
подчёркивать:  подчёркивать
экстремальный:  экстремальные
график:  график
близко:  близко
лишь:  лишь
её:  её
св:  св
парный:  парной
второй:  второго
нормаль:  нормали
приветствовать:  приветствую
определитель:  определитель
предыдущий:  предыдущих
разряд:  разряду
разрывный:  разрывна
выпуклость:  выпуклость
положительный:  положительным
среднеожидаемый:  среднеожидаемое
элемент:  элементы
сборник:  сборники
показательный:  показательное
проверочка:  проверочка
распространить:  распространённой
интересно:  интересно
гмурман:  гмурмана
независимый:  независимые
первообразный:  первообразную
менее:  менее
нечётный:  нечётной
получить:  получи
автор:  автора автор
сложность:  сложности
диффура:  диффурами
часто:  часто
жуткий:  жуткой
значенияй:  значенияи
изучение:  изучения
привести:  привести
узнать:  узнать
очертание:  очертания
нагулять:  нагуляете
весьма:  весьма
весь:  всей
проконтролировать:  проконтролировать
нужный:  нужной
первый:  первого
получаться:  получается
кстати:  кстати
какой:  какие
обмануть:  обмануло
находить:  находим
классическоеопределение:  классическоеопределение
инормаль:  инормаль
статистика:  статистика
корреляция:  корреляции
рассеяние:  рассеяния
записывать:  записывать
биномиальный:  биномиальное
особый:  особые
достоверно:  достоверно
заочник:  заочников
пирамида:  пирамида
провести:  провести
линиюв:  линиюв
самостоятельный:  самостоятельного
закономерно:  закономерно
изменяться:  изменяется
отношение:  отношении
наглядно:  наглядно
повторять:  повторяем
хотеться:  хочется
настать:  настало
сам:  самим
