скобка:  скобками скобки
техника:  технику
совпадение:  совпадения
полезный:  полезен полезная
ограничение:  ограничение
изучение:  изучением изучение
производный:  производные производная производной производную
пытаться:  пытаемся
предел:  предел пределы пределов
слагаемое:  слагаемые слагаемых
небольшой:  небольшой
подкоренной:  подкоренное
менять:  меняя
закомментировать:  закомментирована
числовой:  числовые числовой
производныенеявно:  производныенеявно
значение:  значение значений значениях значения значении
скорее:  скорее
детально:  детально
входить:  входить входит входят
игрек:  игрек игреков
формула:  формулы формула формулах
смотреть:  см смотрят
рассматриваться:  рассматриваются
читатель:  читатель
канонический:  каноническому
два:  две двух
дифференциал:  дифференциалах дифференциала
самый:  самых самая
больший:  наибольшее
многие:  многие
один:  одну одно одна одной одном
любитель:  любители
извлекать:  извлекаем
особенный:  особенного
качественный:  качественнее
сам:  самого сами самих
число:  число числе числами чисел числа
вогнутостья:  вогнутостьи
пропустить:  пропустил
позабыть:  позабыл
строгий:  строгое строже строгие
период:  период
громоздкий:  громоздкой
профессия:  профессию
хедлайнер:  хедлайнером
умножение:  умножения
система:  система системой системе систему системы
группировка:  группировок группировка
условнаясходимость:  условнаясходимость
слово:  словами слову
накладываться:  накладывается
александр:  александр
ось:  ось оси
который:  которые который которое которого которых которой
линейный:  линейные линейная линейных линейной
вниз:  вниз
работа:  работ работы работа
правый:  правой правую
согласие:  согласия
исключаться:  исключаются
знать:  знают знаете знает
дуоперационный:  дуоперационным
урокео:  урокео
базис:  базисах базису базис
отмерять:  отмерять
зависимостьвектор:  зависимостьвекторов
бесконечный:  бесконечные бесконечного
сначала:  сначала
значительный:  значительную
метод:  методы методом методе метод
геометрически:  геометрически
страница:  страницу
терминология:  терминологии
числитель:  числителе
математический:  математическая математического математические математический математической
данные:  данных
тройка:  тройку
интеграл:  интеграл интегралов интегралы интеграла интеграле
урок:  урока урок уроке
разложение:  разложением разложение
икс:  икс
уравнение:  уравнению уравнения уравнение уравнениями уравнений
извлечь:  извлечём
переход:  переход
получиться:  получилось получится получился
обычный:  обычным
существо:  существу
советовать:  советую
целиком:  целиком
практический:  практических практическое
вертикальный:  вертикальными
целесообразно:  целесообразно
малый:  малые наименьших
связь:  связь связи
применение:  применение
множество:  множестве множествах множество множества
сносить:  сносите
надуманный:  надуманные
простой:  простая простых простыми
нормальный:  нормальное
интегральнаятеорема:  интегральнаятеоремы
корнимногочлен:  корнимногочлена
логарифмический:  логарифмическая
решить:  решил решим решить
условие:  условие условия условию
начать:  начнём начать
усвоить:  усвоить
нахождение:  нахождению нахождения нахождение
основной:  основные основной
бернулли:  бернулли
единица:  единицу единицы
полярный:  полярные полярных полярной
положительный:  положительное положителен положительной положительным
рассмотреть:  рассмотрим рассмотренное рассмотрел рассмотрю
средний:  средней средняя
ряд:  ряды ряда ряд рядов
уровень:  уровня
должный:  должны должен должно
посетитель:  посетителям
доверительный:  доверительные
усложняться:  усложняется
среднееквадратический:  среднееквадратическое
коротко:  коротко
неловко:  неловко
момент:  моменте момент моментах
тип:  типа
говориться:  говорится
комбинационный:  комбинационная
обращаться:  обращается
оба:  обе оба
смешанноепроизведение:  смешанноепроизведение
функция:  функции функция функций функциям функцию функциями функциях
дисперсия:  дисперсия дисперсии дисперсию
школьный:  школьный школьной школьного школьных
мы:  нам
упрямый:  упрямая
образ:  образом
непрерывнаяслучайный:  непрерывнаяслучайная
другой:  других другая другие
длина:  длина
материал:  материал материала материалов материалы
немного:  немного
знакопостоянство:  знакопостоянства
интервал:  интервале интервала интервалах интервалы интервал интервалов
градиент:  градиент
логарифм:  логарифмов логарифмом логарифм логарифма
линия:  линия линии линиями
комбинаторика:  комбинаторике
измениться:  изменится изменилась
случайнаявеличина:  случайнаявеличина
отражать:  отражающий
расстреливать:  расстреливаем
бесконечно:  бесконечно
форма:  формы
знание:  знания
статья:  статьи статья статьям статье
методичка:  методичке
каноничный:  каноничнее
каламбур:  каламбур
развернуть:  развернуть
обратный:  обратную обратного обратная
готовый:  готовых
просто:  просто
ещё:  ещё
третий:  третья
знак:  знаками знаком знака знак знаке знаки
очередь:  очередью
быть:  буду будем
тема:  тема тему темы
цель:  цель
обращать:  обращаю обращают
освежить:  освежить
данный:  данного данном данный
непрерывный:  непрерывных непрерывные непрерывная непрерывны
грядущий:  грядущие
перечисленный:  перечисленных
вернуться:  вернуться
производныефункция:  производныефункции
стоить:  стоило
припоминать:  припоминаю
фраза:  фразой
область:  области область
путь:  пути
далеко:  далеко
предположим:  предположим
уместно:  уместно
математик:  математика
синус:  синуса
переменный:  переменных переменной
пример:  пример примера примеров примерам примере примерах примеры
несовместный:  несовместные
независимыеслучайный:  независимыеслучайные
добавить:  добавить
нравиться:  нравится
вверх:  вверх
очевидный:  очевидный очевидным очевидно
следовательно:  следовательно
искать:  ищем
модель:  модель модели
непрерывность:  непрерывность
уполовиниться:  уполовинился
содержать:  содержит содержащая
цепляться:  цепляется
программа:  программы
функциис:  функциис
полный:  полной полных полное
зеркало:  зеркало
значит:  значит
пирсон:  пирсона
некоторый:  некоторую некоторая некоторым некоторых некоторые
вопрос:  вопрос вопросы
аналогичный:  аналогичные аналогичная
межгрупповой:  межгрупповая
ортогональный:  ортогональное
нсв:  нсв
расположить:  расположена
вроде:  вроде
проанализировать:  проанализировать
какой:  какое
упасть:  упал
заголовок:  заголовке
задать:  заданные заданной задайте
отрезка:  отрезке
красный:  красный
тахикардия:  тахикардия
величина:  величина величин величины
одновременно:  одновременно
скинуть:  скинем
запись:  запись
заведомо:  заведомо
неравенство:  неравенстве неравенствами неравенством неравенству неравенств неравенство неравенства
противоположный:  противоположными противоположную противоположный
похожий:  похожая похожих похожи
переносить:  переносить
детерминация:  детерминации
двойной:  двойным двойные двойной двойное двойного
распространить:  распространённая распространённые
следующий:  следующие следующих следующая
тот:  тех те той
отрицательный:  отрицательное отрицателен отрицательным
запомнить:  запомнить
трудный:  трудные
дифференциальныеуравнение:  дифференциальныеуравнения
прямой:  прямая прямой прямые прямую
середина:  середине
постоянный:  постоянных
дождаться:  дождаться
стокс:  стокса
схема:  схема
степень:  степень степени
дробовик:  дробовик
получить:  получен полученное получи
математика:  математике математики
векторный:  векторное векторного
вероятностия:  вероятностии
кубический:  кубической
скалярный:  скалярное
значимость:  значимости
слеш:  слеша
изображаться:  изображается
дать:  дана данные данной
обделить:  обделёнными
анализ:  анализа анализ
её:  её
частный:  частное частные
парный:  парной
встретиться:  встретятся
найти:  найдём найти найденная найдут
сборник:  сборники
параметрический:  параметрическом параметрической
часто:  часто
получаться:  получается
решение:  решение решением решения решений
координатный:  координатная
форум:  форум форуме
книга:  книги книга
интуитивно:  интуитивно
чётный:  чётную чётной
вынести:  вынести
задание:  задание задания
вектор:  векторы векторов
автоматный:  автоматной
наподобие:  наподобие
вращение:  вращения
неотрицательный:  неотрицательным неотрицательно
копирование:  копирование
давать:  давайте
дальнейший:  дальнейшим
разрыв:  разрыва разрывы
выражение:  выражения выражение
парабола:  параболы параболу парабола
значок:  значок
грубо:  грубо
отблагодарить:  отблагодарить
являться:  являются является
уходить:  уходят
байес:  байеса
выступать:  выступают
решать:  решать
точность:  точности
теория:  теория теории
настоящий:  настоящих
отсутствовать:  отсутствует
схематический:  схематический
дополнительно:  дополнительно
обсуждение:  обсуждение
асимптота:  асимптотами асимптоты
константа:  константе константы
умножить:  умножить умножим
двумерный:  двумерная
друг:  друг
тело:  тела
циркуляция:  циркуляция
плоскость:  плоскости плоскость
общий:  общим общая общие общем
определителяй:  определителяи
согласно:  согласно
закон:  законы
дробь:  дроби дробь дробей
справа:  справа
завершать:  завершающий
графический:  графическое
качество:  качестве
корень:  корня корнем корнями корни корень корней
выколоть:  выколоты
догадываться:  догадываются
ситуация:  ситуацию ситуация
вероятность:  вероятностей вероятность вероятности
любой:  любое любого любых любом
уравненийв:  уравненийв
конструкция:  конструкция
множитель:  множитель множители множителем
приятный:  приятные
остаться:  остался останутся
отрезок:  отрезок
количество:  количества
грин:  грина
эйлер:  эйлера
объединение:  объединения объединению объединение
геометрический:  геометрический геометрическая геометрическим геометрическое
вычесть:  вычтем
годиться:  годится
каждый:  каждого каждому каждой
дискретный:  дискретный
знакочередоваться:  знакочередующиеся
масштаб:  масштаб масштабу
войти:  войдут
камень:  камень
отпадать:  отпадает
пожалуй:  пожалуй
практически:  практически
произвольный:  произвольных
сложный:  сложной сложна сложные сложных сложными
фурье:  фурье
поле:  поля
гипотеза:  гипотез гипотеза гипотезы
свойство:  свойства свойству
исследование:  исследование исследованиях
горячий:  горячие
рассуждение:  рассуждений
точка:  точки точках точка точками точке
вариация:  вариации вариацию
добиться:  добиться
основа:  основы
логический:  логическое
студент:  студент студентам
заштриховать:  заштрихованном
кош:  коши
параграф:  параграфа
выше:  выше
арксинус:  арксинусы арксинус арксинусами
начертить:  начертите
соответствующий:  соответствующих
чайник:  чайников чайникам
смена:  сменой
раздел:  раздел раздела
вычисленияс:  вычисленияс
модуль:  модуля
разобрать:  разобраны разобрать разберём
матричный:  матричные матричных матричный
заметить:  заметили заметьте
навык:  навыки
перенести:  перенести перенесём
однородный:  однородные однородным
вычислить:  вычислить
вложить:  вложена
очень:  очень
матрица:  матрицу матрицы матрицами
испытанияй:  испытанияи
интегралыть:  интегралыв
промежуток:  промежутков промежутке
квадратный:  квадратным квадратное квадратных квадратный
перегруппировка:  перегруппировка
логика:  логика логики
помощь:  помощью
вариационный:  вариационный
элементарный:  элементарных элементарными элементарные
арккосинус:  арккосинус арккосинусами арккосинусом
дружка:  дружку
пустой:  пустой пустого
исключение:  исключением
блог:  блог
высокий:  высших высшей высшая
школа:  школы школа
вывод:  выводу
единственный:  единственной единственное единственная
пространство:  пространстве
котангенс:  котангенс котангенсом котангенсами
удобный:  удобный удобнее
курс:  курс курса
подбирать:  подбираю
координата:  координаты координат координатах
сообщить:  сообщите
нечётный:  нечётными
главный:  главном главную
аналитический:  аналитическая аналитическое аналитическую аналитической
понижение:  понижение понижением
левый:  левой
центр:  центр
ножницы:  ножницы
помнить:  помнят
экспонент:  экспоненты
терпеть:  терпит
ветка:  ветки
примитивный:  примитивный примитивными
быстрый:  быстрее
одинарный:  одинарным
сторона:  сторону
преобразование:  преобразованием преобразования преобразование преобразований
интерес:  интересы
оккупировать:  оккупировал
построение:  построение
линейнойкорреляционный:  линейнойкорреляционной
синий:  синяя
действие:  действия
жареный:  жареные
особо:  особо
распределениякритерия:  распределениякритерий
квадратичный:  квадратичной квадратичные
читаться:  читается
нехороший:  нехорошей
начаться:  началось
несобственный:  несобственные
выполнять:  выполнять
зарисовка:  зарисовки
взять:  взяты взяли взять
полностью:  полностью
касательная:  касательная
ответ:  ответ ответы
задачис:  задачис
запоминаться:  запоминаются
правило:  правила правилу правило
функциия:  функциии
степенной:  степенного степенные
функцийдвуха:  функцийдвух
выборка:  выборке
функцийнесколький:  функцийнескольких
накопиться:  накопится
чисто:  чисто
налево:  налево
положительно:  положительно
множественнойлинейный:  множественнойлинейной
потребоваться:  потребуются
согласоваться:  согласуется
распределение:  распределение распределения
задачка:  задачками
график:  графиках график
задачипо:  задачипо
востребовать:  востребованную
приблизить:  приближенные
бумага:  бумага бумаге
хотеться:  хотелось
примечание:  примечание
выкладка:  выкладки
зависимый:  зависимые
приравнять:  приравняем
отклонение:  отклонение
таблица:  таблицы
произведение:  произведение
вполне:  вполне
кто:  кому
случайный:  случайных случайные
дуга:  дуги
частность:  частности
отрезкать:  отрезкав
дивергенция:  дивергенция
пометка:  пометки
чертёж:  чертежа чертежи чертёж
перефразировать:  перефразировать
сайт:  сайт сайты сайта
наш:  наш нашего наша
графика:  графики графика
целый:  целых
расположиться:  расположился
идти:  идёт
причина:  причине
возрастание:  возрастание
эмпирический:  эмпирические
найтись:  нашлось
хромать:  хромать
иррациональный:  иррациональных
повод:  поводу
активный:  активное
определение:  определению определения
квадратичнуюформ:  квадратичнуюформу
карта:  карта
несложный:  несложный
гипербола:  гипербола
важный:  важное
равно:  равно
образец:  образце образца
сменить:  сменить
заострять:  заострять
они:  ними
закономерный:  закономерный
спирмена:  спирмена
вид:  виду виды виде вида
оказаться:  оказалось
возникать:  возникает
равносильный:  равносильны
направить:  направлены
заключительный:  заключительный
рассказывать:  рассказывать
заточить:  заточить
заключить:  заключить
св:  св
избавиться:  избавимся
второй:  второго второму второй вторую
иметь:  имеет
достаточно:  достаточно
попытаться:  попытаемся
показательный:  показательное
соответствовать:  соответствует соответствующий
универсальный:  универсальным
диффура:  диффурами
весьма:  весьма
косинус:  косинуса
аргумент:  аргумент
вычисление:  вычисление
представлять:  представляет
статистика:  статистика
биномиальный:  биномиальное
редкий:  реже редким редкие
линиюв:  линиюв
рабочий:  рабочим
история:  история
самостоятельный:  самостоятельного
справедливый:  справедливы
отношение:  отношении
штриховка:  штриховка штриховкой
исследовать:  исследуя исследовать
смысл:  смысл
трёхчлен:  трёхчлен трёхчленов
дуприближённо:  дуприближённо
событие:  события
повторный:  повторные
вышесказанный:  вышесказанного вышесказанным
фнп:  фнп
действительный:  действительные действительных
простейшее:  простейшие
знаменатель:  знаменателя знаменатель знаменателе
иной:  иными
конец:  конце конца
часть:  частям часть части
знакомый:  знакомые
пролёт:  пролёте
несобство:  несобств
запутать:  запутает
нелинейный:  нелинейная
рисовать:  рисовать
преобразованиеквадратичный:  преобразованиеквадратичной
напрашиваться:  напрашивается
функциональный:  функциональные
азов:  азов
абсолютный:  абсолютная
жизненный:  жизненном
встречаться:  встречаются встречается
сложенияй:  сложенияи
повторяться:  повторяться
регрессия:  регрессии регрессия
вычитание:  вычитание
расстояние:  расстояние
исчисление:  исчисления
двойка:  двойку
гораздо:  гораздо
локальный:  локальная
ожидание:  ожидание
лаплас:  лапласа
такой:  таким такие такое такого такая
перегиб:  перегиба
содержательный:  содержательные
сходимость:  сходимости сходимость
ход:  ходу
задача:  задачи задачах
ду:  ду
далее:  далее
делать:  делать
полуинтервал:  полуинтервал полуинтервале
коэффициент:  коэффициент
неопределённый:  неопределенный неопределенном
удовлетворять:  удовлетворять удовлетворяет удовлетворяют
приходить:  приходим
собственный:  собственные
признак:  признак признаки
аудитория:  аудитории
поэтому:  поэтому
разумеется:  разумеется
увидеть:  увидите
принцип:  принципе
решаться:  решаются
асимметрия:  асимметрия
шаг:  шаге
скажем:  скажем
сводиться:  сводящиеся
замена:  замены
записать:  запишем записать
маленький:  меньше
составить:  составим
результат:  результате
например:  например
решенияопределённый:  решенияопределенных
задаваться:  задаётся
хотя:  хотя
многочлен:  многочленов
тангенс:  тангенса тангенсы тангенс тангенсами
коэффициентковариация:  коэффициентковариации
обозначать:  обозначает
первый:  первой первых первом первого
делить:  делить
абсцисса:  абсцисс
случай:  случаев случае случаях
лопиталя:  лопиталя
матана:  матана
недопонимание:  недопонимание
поляформула:  поляформула
фехнера:  фехнера
подавно:  подавно
эффективный:  эффективные
переставить:  переставив
исключить:  исключим
условный:  условные условный
эллипс:  эллипс
ноль:  ноль
поговорить:  поговорим
задействовать:  задействована
даламбер:  даламбера
теорема:  теоремы
повторнойя:  повторнойи
комплексный:  комплексные комплексного комплексный комплексными
дело:  делах
ранг:  ранг
кривая:  кривой
тяжестиплоска:  тяжестиплоской
сжаться:  сожмётся
относительно:  относительно
зато:  зато
двучлен:  двучлен
допустить:  допустим
проверка:  проверка
нуль:  нули нулю нулях
касаться:  касается
эквивалентный:  эквивалентной
построить:  построить
внимание:  внимание
повторить:  повторить
лейбниц:  лейбница
интересный:  интересна
поток:  поток
предыдущий:  предыдущего
медиана:  медиана
направлениюй:  направлениюи
использовать:  использовать используйте
гостевой:  гостевая
стать:  станет
кроме:  кроме
основание:  основание
говорить:  говорить говоря
понятно:  понятно
закрепление:  закрепления
плохой:  плохие
внутригрупповаяй:  внутригрупповаяи
пара:  пару
алгебра:  алгебры
сумма:  сумму сумма
станция:  станция
существовать:  существует существовать существуют
намного:  намного
остановиться:  остановлюсь
прямоугольник:  прямоугольников
эксцессэмпирический:  эксцессэмпирического
типовой:  типовое типовая
указать:  указан
оценка:  оценка оценки
криволинейный:  криволинейные
различный:  различных
смочь:  сможете
библиотека:  библиотека
разрешимый:  разрешимо
трудность:  трудностей
нога:  ноги
наименьшеезначение:  наименьшеезначения
сила:  силы
системылинейный:  системылинейных
нужно:  нужно
смело:  смело
определить:  определена определены
зависимость:  зависимость
информация:  информация информацию
состоять:  состоящего
замкнутый:  замкнутому
равносильно:  равносильно
бесконечность:  бесконечность
цэ:  цэ
желать:  желаю
насторожиться:  насторожиться
погорячиться:  погорячился
показатель:  показатели
поступать:  поступать
сильно:  сильно
площадьс:  площадьс
большинство:  большинстве
присутствовать:  присутствует
убыванией:  убываниеи
повышенный:  повышенной
статистический:  статистическая статистические
также:  также
интегрирование:  интегрирование
легко:  легко
круглый:  круглыми
рациональный:  рациональные
использование:  использование
натуральный:  натуральный
интервальный:  интервальный
выполняться:  выполняться
привычный:  привычном
итак:  итак
соблюсти:  соблюдены
вообще:  вообще
заморочить:  заморочена
понятный:  понятны
проставить:  проставлены
оценкия:  оценкии
неявный:  неявной
несобственныхинтеграл:  несобственныхинтегралов
вероятностибиномиальный:  вероятностибиномиального
род:  рода
гаусс:  гаусса
экстремальный:  экстремальные
разрешить:  разрешить
весь:  вся весь всей
нормаль:  нормали
путешествие:  путешествия
определитель:  определитель
выпуклость:  выпуклость
элемент:  элементы
менее:  менее
принципиально:  принципиально
сложность:  сложности
значенияй:  значенияи
справедливо:  справедливо
нужный:  нужной нужное
кстати:  кстати
солидный:  солидные
классическоеопределение:  классическоеопределение
инормаль:  инормаль
тетрадь:  тетради
вновь:  вновь
пирамида:  пирамида
путать:  путайте
автор:  автор автора
видеть:  видят видите
считалка:  считалку
счёт:  счёт
дифференциальный:  дифференциальные
уравненияс:  уравненияс
онлайн:  онлайн
геометрия:  геометрии геометрия
новый:  новому
произвольныйтройный:  произвольныйтройной
ниже:  ниже
известный:  известным известные
разложить:  разложить
дизайн:  дизайна
это:  это
прощать:  прощаю
подставить:  подставьте
поляй:  поляи
находиться:  находится
опечатка:  опечатку
продолжать:  продолжаем
речь:  речь
стараться:  стараюсь
продолжиться:  продолжилось
методомоперационный:  методомоперационного
базовый:  базовых
бесповторный:  бесповторной
наверняка:  наверняка
ошибка:  ошибку
л:  л
обойтись:  обойтись
муравей:  муравьёв
вещь:  вещь вещи
касательный:  касательных
рассматривать:  рассматриваемые
большой:  большой
типовыхзадача:  типовыхзадач
взгляд:  взгляд
ранговойкорреляция:  ранговойкорреляции
жизнь:  жизни
расположение:  расположение расположения
посвятить:  посвящен
детский:  детскую
обратиться:  обратится
концерт:  концерта
нетрудно:  нетрудно
порядок:  порядке порядка порядков
поверхность:  поверхности
дискриминант:  дискриминант
пересекать:  пересекает
линейныйкоэффициент:  линейныйкоэффициент
несобственныйинтеграл:  несобственныйинтеграл
доступно:  доступно
объяснение:  объяснения
понятие:  понятия
причём:  причём
вершина:  вершина
учиться:  учимся учащимся
задавать:  задаваемые
ветвь:  ветви
ипример:  ипримеры
особый:  особое
поверхностный:  поверхностные
фигура:  фигуры
пуассон:  пуассона
подобный:  подобные
успех:  успехов
однако:  однако
нубова:  нубов
таки:  таки
устный:  устное
отрицательно:  отрицательно
математическоеожидание:  математическоеожидание
итог:  итоге
напомнить:  напомню
неоднородный:  неоднородные
необходимо:  необходимо
экспонента:  экспонентой
сбросить:  сбросить
технический:  техническом
содержание:  содержания
кратное:  кратные
системудифференциальный:  системудифференциальных
ненулевой:  ненулевым
попадаться:  попадается
иллюзорный:  иллюзорен
абзац:  абзацев
последовательность:  последовательностей
показаться:  покажутся
объём:  объем
предполагаться:  предполагается
проверить:  проверить
поскольку:  поскольку
гипергеометрическоераспределение:  гипергеометрическоераспределение
раз:  раза
обратить:  обратите
подробно:  подробно
равномерный:  равномерная равномерное
треугольный:  треугольная
палец:  палец
необходимость:  необходимость
клеточка:  клеточкам
царство:  царстве
пожалуйста:  пожалуйста
следовать:  следует
усложнить:  усложним
обстоять:  обстоит
случайность:  случайности
себя:  собой
квадрат:  квадратов
пересечение:  пересечение
сразу:  сразу
функциюкомплексный:  функциюкомплексной
напоминать:  напоминаю
мода:  мода
свойстваэлементарный:  свойстваэлементарных
калькулятор:  калькулятор
научиться:  научиться
демонстрироваться:  демонстрировалось
похоже:  похоже
раскрытие:  раскрытия
определённый:  определенный определенного
действительно:  действительно
экстремум:  экстремумы
постараться:  постараюсь
горнера:  горнера
отмечаться:  отмечалось
лениться:  лениться
функцийв:  функцийв
каштан:  каштаны
размерность:  размерность
чертить:  чертить
три:  трёх
дискретнойслучайный:  дискретнойслучайной
визуальный:  визуальную
останавливаться:  останавливаться
прекрасно:  прекрасно
соответствие:  соответствии
крамер:  крамера
правда:  правда
строго:  строго
повторимый:  повторим
запретить:  запрещено
функциидвуха:  функциидвух
емелин:  емелин
мёртвый:  мёртвые
вычисленияопределенный:  вычисленияопределенных
конечный:  конечная
задачин:  задачина
замечательный:  замечательные
системый:  системыи
удовлетворяетлить:  удовлетворяетли
ужесточаться:  ужесточается
лицо:  лица
тригонометрический:  тригонометрических
участок:  участке
аналитически:  аналитически
заданав:  заданав
масштабировать:  масштабировать
что:  чём
всё:  всё
клетчатый:  клетчатой
претендовать:  претендует
изобразить:  изобразим
тройной:  тройные
деление:  деления
выполнить:  выполнено
контуруформула:  контуруформула
энциклопедичность:  энциклопедичность
ка:  ка
участиться:  участились
либо:  либо
рекомендовать:  рекомендую
примерно:  примерно
независимый:  независимые
привести:  привести
фигурный:  фигурные
способ:  способ
корреляция:  корреляции
прежде:  прежде
убиваться:  убиваться
продолжить:  продолжить
реалистичный:  реалистичные
заочник:  заочников
повторять:  повторяем
миниатюра:  миниатюра
