вектор:  векторы векторов
посетитель:  посетителям
ссылка:  ссылке ссылки
знакомство:  знакомстве
вращение:  вращения
химия:  химия
дифференциальный:  дифференциальные дифференциальными дифференциального
уравненияс:  уравненияс
наряду:  наряду
именно:  именно
онлайн:  онлайн
привет:  привет
геометрия:  геометрии геометрия
копирование:  копирование
александров:  александрова
решить:  решить
разрыв:  разрыва
работа:  работа работ работы
выражение:  выражения выражение
сумма:  сумма сумму
отделение:  отделения
производный:  производные производным производная производной производную
прямой:  прямой прямую прямая
дуприближённо:  дуприближённо
математический:  математических математические математическая математической
новый:  новому
предел:  предел пределы пределов
здоровье:  здоровье
произвольныйтройный:  произвольныйтройной
модель:  модели модель
информация:  информации
асимптота:  асимптоты
час:  часов
больший:  наибольшее
это:  это этим
предусмотреть:  предусмотрена
событие:  события
отблагодарить:  отблагодарить
повторный:  повторные
байес:  байеса
расправляться:  расправляемся
числовой:  числовые
простой:  проще прост простых простым
дисперсия:  дисперсию дисперсия дисперсии
зачёт:  зачете
решать:  решать
производныенеявно:  производныенеявно
дисциплина:  дисциплиной
интерес:  интереса
решение:  решений решением решение решения
поляй:  поляи
интеграл:  интегралы интеграла интеграл интеграле интегралов
опечатка:  опечатку
источник:  источниках
общий:  общим общая общий
контрольный:  контрольных контрольной
живой:  живой
плавать:  плавали
теория:  теория теории
сегодняшний:  сегодняшние
носить:  носить
ресурс:  ресурсы
изложить:  изложенная
предлагаться:  предлагается
панель:  панель
формула:  формулы формулам формула формулой формулу формуле
данный:  данном
задание:  заданий задания заданиями задание
забавно:  забавно
моделирование:  моделирования
наплакать:  наплакал
полезный:  полезен
фнп:  фнп
разбираться:  разбираться
читатель:  читателей
министр:  министром
экран:  экрана
учебный:  учебное учебной
отчётный:  отчётные
канонический:  каноническому
удобный:  удобнее удобный
простейшее:  простейшие
любимый:  любимого
гипотеза:  гипотезы гипотез гипотеза
дифференциал:  дифференциалах дифференциала
двумерный:  двумерная
методомоперационный:  методомоперационного
задать:  заданной заданном задайте
многие:  многие
масса:  массу
часть:  частям часть части
помочь:  помогло помог
тело:  тела
циркуляция:  циркуляция
бесповторный:  бесповторной
выложить:  выложено
наверняка:  наверняка
двойной:  двойные двойной
предназначить:  предназначена
ошибка:  ошибку
освоить:  освоить
плоскость:  плоскости плоскость
автор:  автора автор
несобство:  несобств
экзамен:  экзамене
л:  л
практический:  практических
специальность:  специальности
развернуть:  развернём
написать:  напишите написать написаны
нелинейный:  нелинейная
пётр:  пётр
книга:  книга книги
сам:  саму самом
изучение:  изучение
преобразованиеквадратичный:  преобразованиеквадратичной
определителяй:  определителяи
степень:  степенями
вогнутостья:  вогнутостьи
важно:  важно
блокнот:  блокноте
посему:  посему
вид:  виде виды виду
примета:  примете
закон:  законы
обратиться:  обратиться
функциональный:  функциональные
секрет:  секрет секретом
касательный:  касательных
адрес:  адресу
характерный:  характерно
доллар:  долларов
тот:  тех
получаться:  получается
геометрический:  геометрическая геометрическое
абсолютный:  абсолютная
графика:  графика графики
типовыхзадача:  типовыхзадач
переносный:  переносном
насколько:  насколько
удобно:  удобно
создание:  создания
умножение:  умножения
предмет:  предмет предмета
вероятность:  вероятностей вероятность вероятности
встречаться:  встречаются встречалось
развивать:  развивать
ранговойкорреляция:  ранговойкорреляции
система:  система систему системе системы
частный:  частным частной частные частных частном частную частное
функция:  функций функцию функции функциями функция
непрерывный:  непрерывная непрерывных
группировка:  группировок группировка
условнаясходимость:  условнаясходимость
сложенияй:  сложенияи
доступный:  доступен
уравненийв:  уравненийв
образ:  образом
припомнить:  припомню
регрессия:  регрессии регрессия
величина:  величин величина величины
офлайн:  оффлайн
александр:  александр
найти:  найти найденного найденную найдём найдем
свой:  свой своя
ценный:  ценное
откроить:  открою
уровень:  уровня
крупный:  крупных крупного
осмелиться:  осмелюсь
рассказать:  рассказать
почувствовать:  почувствуйте
типовой:  типовых типовая
грин:  грина
полный:  полное полных полного полной
который:  которые которых который которой которая
исчисление:  исчисления
линейный:  линейные линейная линейных линейной
пропустить:  пропустить
прилежный:  прилежные
эйлер:  эйлера
шаблон:  шаблону
квалификация:  квалификации
искать:  ищите
учёба:  учебу
заходить:  заходит
согласие:  согласия
локальный:  локальная
методичка:  методичек
ожидание:  ожидание
смешной:  смешные
математика:  математики математике
лаплас:  лапласа
перегиб:  перегиба
сходимость:  сходимости сходимость
дуоперационный:  дуоперационным
исследовать:  исследовать
сформулировать:  сформулирую
благодарность:  благодарность
дискретный:  дискретный
базис:  базисах базис базису
никто:  никого
поверхность:  поверхности
бохан:  бохана
знакочередоваться:  знакочередующиеся
задача:  задачи задачу задаче задача
авторский:  авторском
базылевый:  базылев
векторный:  векторного векторное
ограниченный:  ограниченный
предположить:  предположить
несколько:  несколько
ду:  ду
методический:  методическому методический
юмор:  юмор
зависимостьвектор:  зависимостьвекторов
линейныйкоэффициент:  линейныйкоэффициент
делать:  делать
математик:  математика
дать:  данные данной дана даны
коэффициент:  коэффициент
неопределённый:  неопределенный неопределенном
лекция:  лекция
история:  история
день:  день дня
тысяча:  тысячам
сначала:  сначала
белый:  белого
метод:  методы методом метод
пример:  примере примером примеры пример примера примеров примерах
дробь:  дроби дробей дробь
поступить:  поступил
собственный:  собственные
расчеткать:  расчетку
страница:  страницу
практически:  практически
несобственныйинтеграл:  несобственныйинтеграл
признак:  признак признаки
произвольный:  произвольных
данные:  данных
сложный:  сложной сложное сложных сложные сложным
рядом:  рядом
доступно:  доступно
работать:  работать работаем
причём:  причём
фурье:  фурье
учиться:  учимся
поле:  поля
владелец:  владелец
разложение:  разложением разложение
задавать:  задаваемые
поэтому:  поэтому
свойство:  свойства
отзыв:  отзыв
способствовать:  способствуют
ответить:  ответить
исследование:  исследование
пожаловать:  пожаловать
весь:  всем
очный:  очных
качественный:  качественнее
ипример:  ипримеры
уравнение:  уравнениями уравнению уравнений уравнения уравнение
точка:  точки точке
знать:  знать
карьера:  карьеры
множество:  множества
оценка:  оценки оценка
проблема:  проблем
переход:  переход
вариация:  вариации
мочь:  могут
сайт:  сайта сайты сайт
асимметрия:  асимметрия
комплексный:  комплексными комплексные комплексная комплексного комплексной комплексный
никакой:  никакого никаких
основа:  основы
поверхностный:  поверхностные
студент:  студента студентов
интервал:  интервалы
эконометрика:  эконометрика
кош:  коши
координата:  координат координаты координатах
фигура:  фигуры
статья:  статье статьи
пуассон:  пуассона
составлять:  составляем
сводиться:  сводящиеся
упоминаться:  упоминалось
чайник:  чайников чайника
преобразование:  преобразований преобразования
замена:  замены
большинство:  большинстве
вычисленияс:  вычисленияс
однако:  однако
малый:  малые наименьших
мир:  мира
связь:  связь
таки:  таки
понижение:  понижением понижение
матричный:  матричные матричных матричный
наука:  наука
результат:  результат результате
стоящий:  стоящий
олигарх:  олигарха
сотня:  сотни
заметить:  заметили
внушительный:  внушительный
ответ:  ответе ответ ответы
математическоеожидание:  математическоеожидание
дороговатый:  дороговат
внешне:  внешне
поприкалываться:  поприкалываться
однородный:  однородные однородным
решенияопределённый:  решенияопределенных
учитель:  учителя
помощь:  помощи помощью
вычислить:  вычислить
плохо:  плохо
борис:  борис
нормальный:  нормальное
доступ:  доступа
очень:  очень
отвести:  отведена
интегральнаятеорема:  интегральнаятеоремы
корнимногочлен:  корнимногочлена
логарифмический:  логарифмическая
курс:  курс
матрица:  матрицу матрицы матрицами
направленность:  направленность
испытанияй:  испытанияи
интегралыть:  интегралыв
самопохвала:  самопохвала
неоднородный:  неоднородные
необходимо:  необходимо
перегруппировка:  перегруппировка перегруппировки перегруппировку
заочный:  заочного
правило:  правило правила правилу
понятный:  понятен
основной:  основные
около:  ок
нужный:  нужной
бернулли:  бернулли
полярный:  полярные полярной полярных
коэффициентковариация:  коэффициентковариации
другой:  другие другая
развитие:  развитие
ряд:  ряд ряды ряда рядов
вариационный:  вариационный
один:  одну
обратный:  обратной обратном обратная обратную
подписываться:  подписывайтесь
думать:  думал
вопрос:  вопросы вопрос
кратное:  кратные
свободный:  свободных
серьёзно:  серьёзно
системудифференциальный:  системудифференциальных
оставаться:  остаётся
веб:  веб
блог:  блог
доверительный:  доверительные
выкладывать:  выкладывать
выражать:  выражающая
смысл:  смысла
высокий:  высших высшей высшая
купить:  купил
благополучный:  благополучной
план:  плане
форма:  формы
экономика:  экономика экономикой
помимо:  помимо
год:  годы
критиковать:  критикуют
среднееквадратический:  среднееквадратическое
представиться:  представился
также:  также
мера:  мере
строгий:  строгую
пространство:  пространстве
случай:  случая случаев
мероприятие:  мероприятия
лопиталя:  лопиталя
говориться:  говорится
условие:  условии условием условиями условие условия условиям условий условию
последовательность:  последовательностей
комбинационный:  комбинационная
рассмотреть:  рассмотреть рассмотрены рассмотрим рассмотренных
квадратичный:  квадратичные
быть:  будут
кончить:  кончили
такой:  таким такое такая такими
смешанноепроизведение:  смешанноепроизведение
распространить:  распространенную распространенные
пожелание:  пожеланиям
объём:  объем
целый:  целые
проверить:  проверить
поляформула:  поляформула
чёрный:  чёрной чёрную
сообщить:  сообщите
линия:  линиями линии линия
фехнера:  фехнера
аналитический:  аналитическая аналитической
вычислительный:  вычислительными
таблица:  таблицы
проект:  проекта
школьный:  школьный школьному
эффективный:  эффективные
независимо:  независимо
центр:  центр
гугл:  гугл
появляться:  появляется
обзор:  обзор
гипергеометрическоераспределение:  гипергеометрическоераспределение
интернет:  интернете
условный:  условные
непрерывнаяслучайный:  непрерывнаяслучайная
навигационный:  навигационному
составляться:  составляется
эллипс:  эллипс
прямо:  прямо
длина:  длина
любой:  любого
статистика:  статистика
немного:  немного
знакопостоянство:  знакопостоянства
подробно:  подробно
равномерный:  равномерная равномерное
треугольный:  треугольная
градиент:  градиент
количество:  количества
профессиональный:  профессиональный
научить:  научу
определение:  определения определению
необходимость:  необходимости
счастие:  счастья
использовать:  использовал используйте используя используем
пожалуйста:  пожалуйста
даламбер:  даламбера
фирма:  фирм
сторона:  стороны
теорема:  теоремы
факт:  факт
бесплатно:  бесплатно
комбинаторика:  комбинаторике
своевременный:  своевременную
случайнаявеличина:  случайнаявеличина
повторнойя:  повторнойи
число:  числами числа
кот:  котами котов кота
построение:  построение
следовать:  следует
мой:  моей
бесконечно:  бесконечно
грех:  грех
линейнойкорреляционный:  линейнойкорреляционной
действие:  действий действие действия
время:  время времени
деятельность:  деятельности
квадрат:  квадратов квадратами
ранг:  ранг
требоваться:  требуется требовалось
кривая:  кривой
излагать:  излагаемого
сфера:  сферах
тяжестиплоска:  тяжестиплоской
сразу:  сразу
почему:  почему
распределениякритерия:  распределениякритерий
функциюкомплексный:  функциюкомплексной
репетитор:  репетитору
область:  область области
проверка:  проверки проверку проверка
преподаватель:  преподаватель преподавателя
баба:  баб
завтра:  завтра
фотоальбом:  фотоальбомом
построить:  построить
готовый:  готовых готово
закончить:  закончено
несобственный:  несобственные
просто:  просто
единственный:  единственное
мода:  мода
абрамович:  абрамович
свойстваэлементарный:  свойстваэлементарных
ещё:  ещё
карточка:  карточкой
впритык:  впритык
коллега:  коллеге
внимание:  внимание
калькулятор:  калькулятор
лейбниц:  лейбница
избыточный:  избыточным
научиться:  научиться
лениться:  ленитесь
культурология:  культурологию
толстой:  толстого
неравенство:  неравенства
наш:  наш нашей
поток:  поток
фихтенголец:  фихтенгольца
полностью:  полностью
занятие:  занятия
поделиться:  поделюсь
касательная:  касательная
задачис:  задачис
ботан:  ботана
разобраться:  разобрались
медиана:  медиана
замечание:  замечанию
функциия:  функциии
краткий:  кратким
техника:  техника
частый:  чаще
степенной:  степенного степенные
аспирантура:  аспирантура
возможно:  возможно
функцийдвуха:  функцийдвух
направлениюй:  направлениюи
определённый:  определенный определенного
выборка:  выборке
дневный:  дневных
гостевой:  гостевая
скоро:  скоро
грамотно:  грамотно
мысль:  мысль
разработка:  разработку
действительно:  действительно
распределение:  распределения распределение
кроме:  кроме
экстремум:  экстремумы
добрый:  добрая
горнера:  горнера
производныефункция:  производныефункции
средний:  средняя
факультет:  факультета
функцийнесколький:  функцийнескольких
мастер:  мастеров
подготовка:  подготовка подготовки
попасть:  попало
главное:  главное
внутригрупповаяй:  внутригрупповаяи
алгебра:  алгебры
естественный:  естественное
звать:  зовут
функцийв:  функцийв
переменный:  переменных переменная переменной
любить:  любите
очки:  очками
др:  др
ознакомиться:  ознакомиться
несовместный:  несовместные
независимыеслучайный:  независимыеслучайные
множественнойлинейный:  множественнойлинейной
емелин:  емелин
добавить:  добавить
уважение:  уважением
наоборот:  наоборот
учебник:  учебник учебнике
минимум:  минимума минимум
заказать:  заказать
довольно:  довольно
сессия:  сессии
анализ:  анализ анализа
радость:  радости
тема:  темы
прямоугольник:  прямоугольников
непрерывность:  непрерывность
эксцессэмпирический:  эксцессэмпирического
подковать:  подкованных
список:  списка
десятка:  десяток десятки
функциис:  функциис
востребовать:  востребованную
зеркало:  зеркало
различный:  различных
криволинейный:  криволинейные
богатый:  богаты
пирсон:  пирсона
семья:  семье
репетиторство:  репетиторством
деньга:  деньги
вышка:  вышке
библиотека:  библиотека
три:  трёх
выраженный:  выраженное
оттенок:  оттенок
традиция:  традициях
межгрупповой:  межгрупповая
каждый:  каждого
ортогональный:  ортогональное
глубокий:  глубокого
дискретнойслучайный:  дискретнойслучайной
известный:  известны известной известна известном
привести:  привести
задачипо:  задачипо
пропуск:  пропусков
добро:  добро
способность:  способностей
наименьшеезначение:  наименьшеезначения
нсв:  нсв
стараться:  старайтесь
сила:  силы
приблизить:  приближенные
стать:  стало
сборник:  сборники
гуманитарный:  гуманитарным гуманитарных
изюминка:  изюминка
представлять:  представляет
системылинейный:  системылинейных
вконтакте:  вконтакте
вроде:  вроде
прорешана:  прорешаны
самый:  самых самый
кой:  коим
упасть:  упал
изучать:  изучать
прорешать:  прорешали
зависимый:  зависимые
буквально:  буквально
зависимость:  зависимость
жалоба:  жалобы
отклонение:  отклонение
крамер:  крамера
отрезка:  отрезке
материал:  материалы материалов
произведение:  произведение
немало:  немало
оказать:  окажет
кто:  кого
состояться:  состояться состоится
случайный:  случайных случайные
физика:  физики
замкнутый:  замкнутому
паблик:  паблик
пропускать:  пропускать
начало:  начала
дуга:  дуги
официальный:  официальный
отрезкать:  отрезкав
некоммерческий:  некоммерческим
желать:  желаю
дивергенция:  дивергенция
левый:  левой левая левую
правда:  правда
парабола:  парабола
разный:  разной
спасибо:  спасибо
заниматься:  заниматься
благо:  благо
возникнуть:  возникли
форум:  форуме форум
показатель:  показатель показатели показателе
страна:  страну
отвечать:  отвечающая
подчеркнуть:  подчеркну
рамка:  рамках
площадьс:  площадьс
функциидвуха:  функциидвух
запретить:  запрещено
статистический:  статистические статистическая
литература:  литературу литература литературе
низкий:  низкие
какой:  какие
убыванией:  убываниеи
вычисленияопределенный:  вычисленияопределенных
повышенный:  повышенной
возрастание:  возрастание
эмпирический:  эмпирические
детерминация:  детерминации
интегрирование:  интегрировании интегрирование интегрированием
легко:  легко
бесплатный:  бесплатную
решебникнуть:  решебник
задачин:  задачина
замечательный:  замечательные
передавать:  передаю
рациональный:  рациональные
системый:  системыи
начать:  начните начать
удовлетворяетлить:  удовлетворяетли
трудный:  труднее
найтись:  нашлось
вуз:  вузе
дизайн:  дизайна
решебник:  решебника
потребоваться:  потребуются
осваивать:  осваиваем
дифференциальныеуравнение:  дифференциальныеуравнения
каталог:  каталоги
ситуация:  ситуация
плечо:  плечами
иррациональный:  иррациональных
интервальный:  интервальный
сожаление:  сожалению
тригонометрический:  тригонометрических
постоянный:  постоянных
два:  две двум двух
квадратичнуюформ:  квадратичнуюформу
стокс:  стокса
получиться:  получится получилось получиться получился
схема:  схема
карта:  карта
увенчаться:  увенчалось
обращаться:  обращаться
параметрический:  параметрической параметрическом
следить:  следите
выборочно:  выборочно
пятилетка:  пятилетку
гипербола:  гипербола
самостоятельно:  самостоятельно
вообще:  вообще
дробовик:  дробовик
они:  ними
режим:  режиме
оценкия:  оценкии
неявный:  неявной
урок:  урока уроке
несобственныхинтеграл:  несобственныхинтегралов
вероятностибиномиальный:  вероятностибиномиального
экономический:  экономическую
студенчество:  студенчества
советский:  советских
упустить:  упущенное
подготовить:  подготовленных
вероятностия:  вероятностии
логика:  логики
тонкий:  тонкую
род:  рода
заданав:  заданав
скалярный:  скалярное
спирмена:  спирмена
гаусс:  гаусса
совершенно:  совершенно
порядок:  порядке порядка порядков
всё:  всё
оговорка:  оговорок
затруднительно:  затруднительно
значимость:  значимости
технический:  техническим технических
неоценимый:  неоценимую
тип:  типы тип
тройной:  тройные
деление:  деления
дорого:  дорого
являться:  является
контуруформула:  контуруформула
иной:  иными
некоторый:  некоторых некоторое
доходчивый:  доходчивой
экстремальный:  экстремальные
график:  график
отдых:  отдых
дело:  деле дело
её:  её
информатика:  информатику
св:  св
парный:  парной
рябушко:  рябушко
второй:  второй вторым втором второго
биография:  биографию
успешный:  успешного
вечером:  вечером
нормаль:  нормали
ваш:  ваши
определитель:  определитель
поздний:  позже
неустанно:  неустанно
выпуклость:  выпуклость
посещать:  посещает
элемент:  элементы
показательный:  показательное
интересно:  интересно
атанасян:  атанасяну атанасян
гмурман:  гмурмана
пользоваться:  пользуемся
независимый:  независимые
кузнецов:  кузнецова
аркадиевич:  аркадьевич
сложность:  сложностью сложности
дефицит:  дефицит
диффура:  диффурах диффурами
визитный:  визитной
узнать:  узнаем
часто:  часто
значенияй:  значенияи
смочь:  сможете
поиск:  поиск
назад:  назад
весьма:  весьма
сдача:  сдачи
первый:  первый первым первой первом первого
кстати:  кстати
вычисление:  вычисление
справочный:  справочный
стоить:  стоит
классическоеопределение:  классическоеопределение
инормаль:  инормаль
корреляция:  корреляции
прежде:  прежде
глобальный:  глобальный
наверстать:  наверстайте
сдавать:  сдавали
интеллект:  интеллект
специалист:  специалистами специалистом
биномиальный:  биномиальное
получить:  получена получи
солидный:  солидные
заочник:  заочников
пирамида:  пирамида
случаем:  случаем
линиюв:  линиюв
отменять:  отменял
максимально:  максимально
отношение:  отношении
индустрия:  индустрия
повторять:  повторяем
сутки:  суток
разъяснить:  разъяснил
философия:  философии
ярко:  ярко
скачать:  скачать
оказаться:  оказаться оказался
помечать:  помечать
раздел:  разделе
везде:  везде
нарисоваться:  нарисовалось
аббревиатура:  аббревиатур
лода:  лоду
дальнейший:  дальнейшие
справка:  справка
слагаемое:  слагаемое слагаемые слагаемых
характеристический:  характеристическое характеристическим характеристический
правильный:  правильнее
провернуть:  провернём
подобный:  подобные подобный
скорее:  скорее
задачник:  задачников
интересный:  интересные интереснейший
продолжать:  продолжаем
закономерный:  закономерных
константа:  константы константа константой
технически:  технически
старший:  старшим
действительный:  действительной действительную действительная
разок:  разок
увеличиваться:  увеличивается
прийтись:  придётся
структура:  структуру
экспонент:  экспоненты
выразить:  выразим выражено выразить
конец:  конце
куба:  кубе
ехать:  едем
образно:  образно
компания:  компанию
обойтись:  обойтись
брать:  берём
правый:  правая правый правой правую
напрашиваться:  напрашивается
многий:  многих
неизвестный:  неизвестной неизвестная
жирный:  жирные
справа:  справа
навык:  навыки
взять:  взять взят
одинокий:  одинокий одиноких
лишний:  лишние лишней
воздушный:  воздушное
корень:  корнем корень
читать:  читайте
балласт:  балласта
профессия:  профессию
значение:  значение значения значении значению
исходный:  исходная
спешить:  спешите
буква:  буквой
устный:  устные
скомпоновать:  скомпонуем
пункт:  пункт
составить:  составить составим
перепроверить:  перепроверим
табличный:  табличный табличном
выполнимый:  выполним
воспользоваться:  воспользоваться
он:  нему
срабатывать:  срабатывает
киселёв:  киселёв
подбор:  подбора
переписать:  переписать
отыскать:  отыскать
занудно:  занудно
приходить:  приходит
входить:  входит
равенство:  равенств равенства
помин:  помине
годиться:  годится
гораздо:  гораздо
основательный:  основательной
процесс:  процесса
совет:  совет
придерживаться:  придерживаться придерживаемся
удовлетворять:  удовлетворяющую
присутствовать:  присутствуют присутствует
предыдущий:  предыдущим предыдущего
занятый:  занято
начальный:  начальным начальное начальном начального начальному
обычный:  обычном
член:  членов члены
наиболее:  наиболее
принцип:  принципу
далее:  далее
противник:  противник
снова:  снова
соответствовать:  соответствующим
посвятить:  посвящена
подбирать:  подбирать
удивительно:  удивительно
пробежаться:  пробежаться
голова:  голову
начинаться:  начинается
домножение:  домножение
смотреть:  см смотрим
запутаться:  запутаться
возможность:  возможность
окучивать:  окучиваем
взгляд:  взгляд
нижеследующий:  нижеследующую
разделить:  разделить
практика:  практике
разумеется:  разумеется
момент:  момент
заслуженно:  заслуженно
понравиться:  понравилось
синус:  синуса
икс:  икс иксы иксами
кусок:  куски
помогать:  помогать
коль:  коль
шаг:  шаг
переходить:  переходим
разыскиваться:  разыскиваются
главный:  главную
желательно:  желательно
параграф:  параграфа параграфе
выше:  выше
длительность:  длительность
разделять:  разделяя
неоднородность:  неоднородности
собственно:  собственно
версия:  версии
пара:  пара
целесообразно:  целесообразно
маленький:  маленьком
вкладка:  вкладке
разминка:  разминки
выглядеть:  выглядит
дополнительный:  дополнительные дополнительный
например:  например
штатный:  штатной
небольшой:  небольшое
школа:  школа
приём:  приёмов
хотя:  хотя
ошибиться:  ошибся
младший:  младший младшему
экспонента:  экспонентой
проверять:  проверяем
лайта:  лайт
обнаруживаться:  обнаруживается
обмануть:  обмануло
товарищ:  товарищей товарищу
завоевать:  завоёванных
штука:  штука штук
сокращать:  сокращаем
содержание:  содержание
оформляться:  оформляется
разношёрстный:  разношёрстные
применение:  применение применения
исключение:  исключением исключение
затесаться:  затесался
финальный:  финальное
очевидный:  очевидно
помешать:  помешает
вывод:  выводу
формирование:  формирования
чтение:  чтения
алгоритм:  алгоритма алгоритм
называться:  называется
удовольствие:  удовольствие
воедино:  воедино
аномальный:  аномальные
должный:  должна
итоговый:  итоговую
макаренко:  макаренко
чудо:  чудеса
вместе:  вместе
очередной:  очередная
мимо:  мимо
столбик:  столбиком
наверное:  наверное
трудность:  трудности
разбивка:  разбивку
прозвонить:  прозвонить
аппарат:  аппарат
поскольку:  поскольку
ибо:  ибо
раз:  разу
вычёркивать:  вычёркивать
поправка:  поправкой
позволить:  позволит
помнить:  помнит
посмотреть:  посмотрим
производная:  производных
иначе:  иначе
неплохо:  неплохо
сокращение:  сокращения
удачно:  удачно
сопрячь:  сопряженную
разрешимый:  разрешим
обозначаться:  обозначается
торопиться:  торопитесь
шанс:  шансы
просьба:  просьбой
приятный:  приятную
стильно:  стильно
ровно:  ровно
называть:  называемого называть
трофей:  трофей
особо:  особо
отметить:  отметить
кадр:  кадр кадром
соответствующий:  соответствующих соответствующие
напоминать:  напоминаю
позабыться:  позабылось
обозначение:  обозначение
четвёртый:  четвёртой четвертую
обладать:  обладают
продолжение:  продолжение
коснуться:  коснулись
непостоянный:  непостоянными
ненулевой:  ненулевое ненулевой ненулевых ненулевые ненулевого
следующий:  следующий
пояснение:  пояснения
провести:  провести провели проведем
считать:  считаю
вернуться:  вернёмся
проходить:  проходит
повышать:  повышать
появиться:  появится появилась
судьба:  судьбы
релаксация:  релаксация
родственный:  родственный
завершать:  завершающем
оба:  обе оба
корректировка:  корректировке
соседний:  соседние
открыться:  открывшемся
свести:  свести
разбить:  разбить
друг:  другом
всяко:  всяко
присмотреться:  присмотримся
группа:  группу
бывать:  бывает
нахождение:  нахождение нахождения
излишний:  излишни
многочлен:  многочлен
понятно:  понятно
недруг:  недругам
прийти:  пришёл
подарок:  подарков подарок
применять:  применяем
подобрать:  подобрал
перегруппировать:  перегруппируем
досада:  досаде
воссоединение:  воссоединению
тематический:  тематической
получать:  получаем
далеко:  далеко
идз:  идз
упрощение:  упрощений
приподнять:  приподнять
ценитель:  ценителей
исходить:  исходя
выдвигать:  выдвигаем
прикладываться:  прикладывается
следовательно:  следовательно
оборот:  оборота
остановиться:  остановимся
ждать:  жду ждать
забывать:  забывайте забываем
красиво:  красиво
среди:  среди
пятый:  пятую пятый пятой
значит:  значит
сойтись:  сошлось
пересекаться:  пересекаются пересекается пересекающиеся пересекающимися пересекаться
третий:  третьем третий
название:  названия
обыкновенный:  обыкновенных обыкновенные
пролетать:  пролетает
сестра:  сестра
горячий:  горячей
сложить:  сложил
нужно:  нужно
смело:  смело
вводный:  вводном
наработать:  наработанной
образец:  образец
быстро:  быстро
примечание:  примечание
выкладка:  выкладки
чистовой:  чистового
разделаться:  разделаться
прочее:  прочего
приравнять:  приравняем
избавиться:  избавиться
очистка:  очистки
устраивать:  устраивает
мы:  нам
эпснуум:  эпснуум
сколько:  сколько
частность:  частности
прилагаться:  прилагаются
похожий:  похожим похожие
строго:  строго
повторимый:  повторим
оформление:  оформления
найдёно:  найдёно
способ:  способа способе способом способ
признаться:  признаюсь
ранее:  ранее
рекомендовать:  рекомендуемый рекомендую
краснов:  краснов
причина:  причине
честной:  честное
строка:  строку строке строкой строки строкам строка строк
подставить:  подставил
этот:  этих эта
выполнить:  выполню выполнить выполнено
выясниться:  выяснилось
громоздкий:  громоздкими
сегодня:  сегодня
отыскание:  отыскании
любовь:  любви
надёжность:  надёжности
допустить:  допустили
подстановка:  подстановку
диффуров:  диффуров
соответственно:  соответственно
итак:  итак
подопечный:  подопечные
неформальный:  неформальное
равно:  равно
первоначальный:  первоначальной
параноидальный:  параноидальная
хлопоты:  хлопот
связанный:  связанные
большой:  большое
оставить:  оставить
автопилот:  автопилоте
честно:  честно
лнд:  лнду
возникать:  возникает
особый:  особое
упомянуть:  упомянул
собрат:  собрат
частное:  частного
понять:  понять
близко:  близко
полка:  полке
верный:  верное
лишь:  лишь
выбрать:  выбрать
эстетика:  эстетики
иметь:  имеет
присест:  присест
приветствовать:  приветствовать
поднять:  поднять
примерный:  примерный
энна:  энной
кандидат:  кандидата
быстрый:  быстрее
совесть:  совестью
достаточно:  достаточно
верно:  верно
выгодный:  выгоднее
купе:  купе
обращать:  обращаю
либо:  либо
огрех:  огрех
эн:  эн
след:  следам
менее:  менее
потерять:  потерять
дифуров:  дифуров
маловероятный:  маловероятно
почленно:  почленно
неправильно:  неправильно
приличный:  приличные
доказываться:  доказываются
упаковать:  упаковать
многочисленный:  многочисленными
находить:  находим
надеяться:  надеюсь
место:  место
изящный:  изящное
подставлять:  подставляем
занятный:  занятные
далёкий:  дальше
неуместный:  неуместную
лечиться:  лечится
соблюсти:  соблюсти
находиться:  находится
расписать:  расписать
самостоятельный:  самостоятельного
рука:  руки
тушеваться:  тушуйтесь
подлежать:  подлежащий
говорить:  говорить говорю говоря
трата:  тратой
разогреться:  разогреется
цель:  целях
специальный:  специальные
экономить:  экономит
применяться:  применяются применяться
усваиваться:  усваивается
сохранять:  сохранять
использоваться:  используется используются
этап:  этапа этапе этап
нуль:  нулю
симпсон:  симпсона
роль:  роль
позволять:  позволяет
пополняться:  пополняются
программка:  программку
экселе:  экселе
файл:  файле
указать:  указанным
минута:  минуты
эквивалентность:  эквивалентностей
параметрически:  параметрически
претендовать:  претендует
тервера:  тервера
речь:  речь
чертёжь:  чертёжи
охватывать:  охватывает
отрезок:  отрезок отрезка отрезком
нередко:  нередко
язык:  языком
систематизировать:  систематизируем
заглядывать:  заглядываю
экзаменатор:  экзаменатора
расчёт:  расчёта расчёты расчёт
перевести:  перевести
неоднократно:  неоднократно
вещь:  вещь
особенность:  особенностью
комментарий:  комментариями
плохой:  хуже
срок:  сроки
улучшаться:  улучшаются
создать:  создана
собрать:  собраны
фигурировать:  фигурировать
лист:  листа
наизусть:  наизусть
автоматический:  автоматическая
сочетание:  сочетаний
размещение:  размещения
содержательный:  содержательным
дополнить:  дополнить
справочник:  справочнике
поехать:  поехали
комплекс:  комплекс
смешанный:  смешанное
видеоролик:  видеоролик
память:  памяти
дробный:  дробными
значительный:  значительная
угол:  углу углы
перестановка:  перестановка
обучение:  обучения
писать:  пишут
широкий:  широкое
представить:  представить представлена
радиан:  радиан радианах
реализовать:  реализуемо
показывать:  показывает
арка:  арки арка
операционный:  операционного
универсальный:  универсальной
монитор:  монитора монитору
тангенс:  тангенса тангенс
логарифм:  логарифмов логарифм
комбинация:  комбинаций
котангенс:  котангенс котангенсом котангенсами
оформить:  оформлю
некорректный:  некорректной
элементарный:  элементарных
разбиение:  разбиения
треугольник:  треугольника треугольников треугольник
снабдить:  снабжённый
значительно:  значительно
видеоурок:  видеоурок
делить:  делить
неточность:  неточность
руководство:  руководство
рекомендация:  рекомендация
графопостроитель:  графопостроителями
крайне:  крайне
минор:  миноры минора минорами минору миноров минор минором
ходовой:  ходовые
сократить:  сократить
макет:  макет
редактироваться:  редактировалось
видеть:  видим
эффективность:  эффективностью
прикладной:  прикладных
сложение:  сложения
складывать:  складываем
переписывать:  переписывать
повторение:  повторения
вычитать:  вычитать
скорость:  скоростью скорость скорости
всеобъемлющий:  всеобъемлющую
законспектировать:  законспектировать
распечатать:  распечатай
себя:  собой
программа:  программы
расчётный:  расчётную
программный:  программный
мгновенно:  мгновенно
знание:  знаний
приведение:  приведение
ньютон:  ньютоном
важный:  важная важна важных
аргумент:  аргументом
принтер:  принтере
полуавтоматический:  полуавтоматическая
преодоление:  преодолению
узколокальный:  узколокальных
сталкиваться:  сталкиваемся
отличаться:  отличается
возводить:  возводить
вышеуказанный:  вышеуказанные вышеуказанной
перевод:  перевода
умножать:  умножаем
просмотреть:  просмотрите
рассчитать:  рассчитать рассчитан
расстояние:  расстояние
перечень:  перечень
градус:  градусов
уникальный:  уникальным
гид:  гид
незаменимый:  незаменимый
выполнение:  выполнение
разместить:  разместить
намного:  намного
матстат:  матстату
сделать:  сделать
трапеция:  трапеция трапецию
содержать:  содержит
максимальный:  максимальное максимальному максимальный
заточить:  заточить
факториал:  факториал факториалами факториала факториалы
заменить:  заменить
мануал:  мануалом
дополнение:  дополнений
идти:  шла идёт
паскаль:  паскаля
глава:  главы
ход:  ходе
собирать:  собираем
параметр:  параметра параметр
основный:  основная
изображение:  изображения изображениям изображение изображений изображением
заглянуть:  загляните
давно:  давно
аналог:  аналог
использование:  использование
бином:  биномом
ввести:  ввести
учёт:  учётом
рабочий:  рабочие
недостаточно:  недостаточно
избежать:  избежать
научный:  научной
обязательно:  обязательно
арксинус:  арксинуса
арктангенс:  арктангенса
пока:  пока
характеристика:  характеристик
держать:  держите
вышмат:  вышмата
многоэтажный:  многоэтажных
дифференцирование:  дифференцированием
квадратный:  квадратным
лично:  лично
оригинал:  оригиналы оригиналам оригинал оригиналом оригиналов
короткий:  короткий
постепенно:  постепенно
играть:  играет
выполнять:  выполняем
секунда:  секунды
сопровождаться:  сопровождается
относиться:  относиться относятся
полнота:  полноту
пособие:  пособие
никуда:  никуда
модуль:  модулю модуля
включительно:  включительно
пустой:  пустого
косинус:  косинуса
вспомогательный:  вспомогательный
обучать:  обучающие
я:  мной
бумага:  бумаге
подсчитать:  подсчитать
отображение:  отображения
автомат:  автоматах автоматы автоматов автомате
редкий:  реже
алгебраический:  алгебраические
наслать:  нашли
самопроверка:  самопроверки
формальный:  формальной
конъюнкция:  конъюнкция конъюнкции конъюнкцию конъюнкцией
обеспечение:  обеспечении
точнее:  точнее
курсовой:  курсовую курсовой
обозначать:  обозначает
поддерживать:  поддерживает
погаснуть:  погаснет
сухо:  сухо
означать:  означает
учить:  учить
становиться:  становится
формулировка:  формулировку
штанга:  штангу штангой
подключение:  подключением
пусть:  пусть
применимый:  применим
познакомиться:  познакомимся
путать:  путать
окружность:  окружность окружности
слово:  словами
прикол:  прикол
высказывательный:  высказывательные высказывательная высказывательной
остаться:  осталось остался
дорогой:  дороже
существование:  существования
выучить:  выучил
ложь:  лжи ложь
вниз:  вниз
улица:  улице
запись:  записи запись
союз:  союз
стандартный:  стандартного стандартен
необходимый:  необходимом необходимы
из:  изо
импликация:  импликации импликацию импликаций импликация
оно:  оно
намеренно:  намеренно
сдать:  сдадут
битый:  битый
современный:  современными
утверждение:  утверждение
петров:  петрова
рассуждение:  рассуждений
условно:  условно
парта:  парте
достаточный:  достаточное
ложность:  ложность
истина:  истины
обоснование:  обоснование
импликационный:  импликационная
истинность:  истинности истинность истинностью
сгореть:  сгоревший
делиться:  делится
транзистор:  транзисторов
тривиальный:  тривиальный
истинный:  истинное
листок:  листок
занести:  занести
дерзать:  дерзайте
класс:  классов
прямоугольный:  прямоугольной
вдумываться:  вдумываемся
единственно:  единственно
проводить:  проводим
доопределить:  доопределить
диск:  диски
полагать:  полагать
вспомнить:  вспомним
наворотить:  наворочено
маша:  маша маши маше
обоюдоострый:  обоюдоострым
делимость:  делимости делимость
значок:  значки
сыро:  сыро
читаемый:  читаем
конкретный:  конкретной конкретный
компьютер:  компьютера
уважаемый:  уважаемый
отрицание:  отрицания отрицание
черепаха:  черепахи черепахами
вы:  вами
бытовой:  бытовых
допуск:  допуска допуск
осмыслить:  осмыслили
предположим:  предположим
герой:  героя
иван:  ивану иван
дождь:  дождь дождя
таков:  таково такова
угодный:  угодно
посылка:  посылок посылки посылка
пугать:  пугать
добраться:  добрались
процессор:  процессор
аптайм:  аптайм
миллион:  миллион
первопричина:  первопричине
одновременно:  одновременно
бп:  бп
утверждать:  утверждать
заведомо:  заведомо
питание:  питании
она:  неё
высота:  высоту высоты
натуральный:  натуральных натуральными натуральные
дизъюнкция:  дизъюнкция дизъюнкцию дизъюнкции
боль:  боли
предполагать:  предполагает
игра:  игры игру
доморощенный:  доморощенной
страшный:  страшные страшного
запугивать:  запугивать
логический:  логическим
выключая:  выключая
последовательный:  последовательные
обосновываться:  обосновывается
штамповать:  штампованных
предчувствовать:  предчувствуете
человек:  человеку человека
никак:  никак
физический:  физические физический
разговор:  разговор
блок:  блока блоков
анализировать:  анализируя
устойчивый:  устойчивые
трактат:  трактат
забыть:  забыть
наподобие:  наподобие
давать:  давайте
знаменитый:  знаменитый
цепь:  цепь
рассматривать:  рассматриваем
снабжаться:  снабжаются
свет:  свете
непосредственно:  непосредственно
указанный:  указанный
лежать:  лежащая лежит
входящий:  входящих
дублироваться:  дублируются
дважды:  дважды
следствие:  следствие
качество:  качестве
поспорить:  поспорить
догадываться:  догадываемся
вопросительный:  вопросительные
порешать:  порешать
соотнести:  соотнести
ладный:  ладно
подобно:  подобно
заключение:  заключение
щиток:  щитке
суть:  сути
скрывать:  скрывать
объект:  объектом
экзаменационный:  экзаменационное
качаться:  качается
курсовик:  курсовика
дисциплинировать:  дисциплинирует
неполный:  неполным
отпадать:  отпадает
пожалуй:  пожалуй
постулироваться:  постулируется
зайти:  зайти
ложный:  ложной ложным ложна ложно ложны
высказывание:  высказываний высказыванием высказывания высказывание
обрабатываться:  обрабатываются
нижний:  нижнего нижний
глаз:  глазами
переформулировать:  переформулировать
обеспечить:  обеспечена
ой:  ой
дружный:  дружен
упряжка:  упряжке
аксиома:  аксиом
летать:  летающую
поменяться:  поменялся поменялось
равняться:  равняется
неопределённость:  неопределённости
перенос:  перенос
казаться:  казалось
одиночный:  одиночной
эквивалент:  эквивалент
операция:  операциями
начинающий:  начинающим
двойка:  двойку
выражаться:  выражаясь выражаться выражаются
формулировать:  формулировать
снег:  снег
вписать:  вписанный вписанного вписан
распространяться:  распространяется
равный:  равна
петя:  пете петя
нелегальный:  нелегальна
единственность:  единственность
град:  град
обстоятельство:  обстоятельство
баня:  баню
доказательство:  доказательство
просматривать:  просматриваем
матлогик:  матлогике матлогику
забавный:  забавный
затем:  затем
соединять:  соединяющая
устанавливать:  устанавливает
достижение:  достижения
читаться:  читается
приветствоваться:  приветствуется
пройти:  пройдёт
зрение:  зрения
обывательский:  обывательского
включить:  включу
своевременно:  своевременно
параллельный:  параллельная параллельна параллелен
финишный:  финишную
достаточность:  достаточности достаточность
таковой:  таковым
выводить:  выводить
напротив:  напротив
луна:  луны
подстанция:  подстанции
перевернуть:  перевернуть
что:  чём
завершить:  завершена
детский:  детскую
жёсткий:  жесткому
арифметический:  арифметической
штамп:  штампы
лампочка:  лампочка лампочек лампочки
неверно:  неверно
сервер:  сервера
хранить:  хранит
площадь:  площади площадь
расположить:  расположенной расположен расположена расположенная
аналогично:  аналогично
отличный:  отличный отлична
единица:  единицу
база:  базу
насчитывать:  насчитывает
моделировать:  моделирует
совпадение:  совпадения
фраза:  фразу фразой
связка:  связку
вовсе:  вовсе
растаять:  растаять растаял
шар:  шара
раскладываться:  раскладывалась раскладывается
запитываться:  запитывается
равносторонний:  равносторонний равносторонним
ых:  ых
подразумевать:  подразумевают подразумевает
интересовать:  интересуют
эквиваленция:  эквиваленции эквиваленцией эквиваленцию эквиваленция
бэ:  бэ
четыре:  четыре
фундамент:  фундамент
скучно:  скучно
присоединить:  присоединим
пифагор:  пифагора
знакомый:  знакомой
недоказанный:  недоказанная
состоять:  состоять
увлекательный:  увлекательный
петь:  петь
закладывать:  закладывать
хорошенько:  хорошенько
исправный:  исправен
удачный:  удачный
зачастую:  зачастую
сказать:  скажу
неверный:  неверное
квантор:  квантора квантор кванторы кванторами
возбраняться:  возбраняется
побудительный:  побудительные
неслабый:  неслабый
противный:  противном
сверху:  сверху
выключатель:  выключатель
предложение:  предложение
действительность:  действительности
пойти:  пойдет
исключать:  исключающее
диван:  диване
задуматься:  задумался
мегатеорема:  мегатеорему
обычно:  обычно
отвлечься:  отвлечёмся
тягать:  тягает
катет:  катету катета
ноль:  ноль
заключительный:  заключительных
огромный:  огромной
отдельный:  отдельный отдельная
распределить:  распределено распределена
пояснять:  поясняю
стрелка:  стрелки
зато:  зато
всячески:  всячески
сырость:  сырости сырость
отталкиваться:  отталкивается
расклад:  расклады
записать:  записать
окончить:  окончить
пропагандировать:  пропагандируемому
подъезд:  подъезде
посыл:  посылом
принимать:  принимать принимает
опрометчивый:  опрометчивого
пониматься:  понимается
существовать:  существует
танец:  танец
шлёпанец:  шлёпанцы
ворона:  вороной
записываться:  записывается
объединять:  объединяли объединяет
сад:  саду
великое:  великое
пять:  пять
отчитаться:  отчитаться
отличие:  отличие
провод:  провода
парадокс:  парадоксе
черта:  чертах
коньяк:  коньяка
обесточить:  обесточен
требовать:  требует
лояльный:  лояльные
сплошь:  сплошь
пренебречь:  пренебречь
точно:  точно
справедливость:  справедливости
противоположный:  противоположные
связывать:  связывают
пнуть:  пнуть
выключить:  выключили
справедливый:  справедливы справедлива
смеяться:  смеялся
заслужить:  заслужил
опираться:  опирались
вновь:  вновь
конъюнктивный:  конъюнктивное
фундаментальный:  фундаментальном
переживать:  переживайте
выйти:  выйти
столько:  столько
электролиния:  электролиниями
комната:  комнаты
невероятный:  невероятной
базовый:  базовыми базовому
правильно:  правильно
латинский:  латинской латинскими
железка:  железки
строчный:  строчными
измерение:  измерение
прописной:  прописными
запороть:  запорет
опровержение:  опровержения
рубильник:  рубильник
подавлять:  подавляющем
проанализировать:  проанализировать
жизнь:  жизнь
школьник:  школьника
нетрудно:  нетрудно
табличка:  табличку табличкой
преподноситься:  преподносится
электричество:  электричества
понятие:  понятию понятие
успешно:  успешно
безусловный:  безусловным безусловный
танцевать:  танцует
вариант:  варианте
подсказать:  подскажу
гипотенуза:  гипотенузой
оборудование:  оборудования
изначально:  изначально
центральный:  центральную
уметь:  уметь
последний:  последнем
истинно:  истинно
предполагаться:  предполагается
опровергаться:  опровергается
заждаться:  заждались
ставить:  ставим ставят
обратить:  обратите
исключительно:  исключительно
доказать:  доказать
пингвин:  пингвины
герон:  герона
критерий:  критерием критерия
ходить:  ходите
терминология:  терминология
законный:  законна
англ:  англ
строчка:  строчку
предположение:  предположению
дизъюнктивный:  дизъюнктивная
отмечаться:  отмечалось
стол:  стол
начинать:  начинать начинаете
общность:  общности
поверка:  поверку
предостерегать:  предостерегаю
понимать:  понимаю
знак:  знака знак
билет:  билете
обосновать:  обосновать
вести:  ведёт
базироваться:  базируются
путаница:  путаница
валенок:  валенках
электротехника:  электротехнике
символ:  символов
всякий:  всякий
разомкнуться:  разомкнётся
ток:  тока
бабушка:  бабушки
садист:  садисты
ящик:  ящик ящике
завуалированный:  завуалированном
исход:  исхода
описать:  опишем
скопировать:  скопирую
электрический:  электрическому
подход:  подхода
дежурный:  дежурных
налетать:  налетайте
предубеждение:  предубеждения
конструирование:  конструирования
выполняться:  выполняются
здание:  здание
прочитать:  прочитал
посетить:  посетить посетите
нехороший:  нехорошим нехорошие
дом:  дома
посошок:  посошок
опыт:  опыте
недоступный:  недоступный
стиль:  стиль стилю
извлечение:  извлечения
применить:  применить
согласно:  согласно
затруднение:  затруднения
подводить:  подводим
впечатление:  впечатление
расправиться:  расправиться
одинаковый:  одинаковы
записывать:  записывать записываем
ничуть:  ничуть
ознакомить:  ознакомить
освоение:  освоения
редко:  редко
ребёнок:  детей
голос:  голос
упрощаться:  упрощается
папаша:  папашей папаша
дискриминант:  дискриминант
рассмотрение:  рассмотрению
различать:  различать
проскакивать:  проскакивает
вместо:  вместо
успех:  успехов
нарисовать:  нарисовать
упоминать:  упоминал
прогулка:  прогулку
нестандартный:  нестандартном
близкий:  ближайшей
кратный:  кратный
невозмутимо:  невозмутимо
дума:  думу
зависеть:  зависящая зависит
совпасть:  совпасть
коротко:  коротко
лямбда:  лямбда
прокомментировать:  прокомментировал
меняться:  меняются
поменять:  поменять
определить:  определить определите
примитивный:  примитивный
считаться:  считается
догадаться:  догадались догадаться
отсутствовать:  отсутствует
невозбранный:  невозбранно
естественно:  естественно
осуществляться:  осуществляется
допускать:  допускают
кратко:  кратко
мнимый:  мнимой мнимая мнимую
пригодиться:  пригодился
предстоять:  предстоит
популярный:  популярной популярная
сохраняться:  сохраняться
малыш:  малышей
субъективный:  субъективной
похоже:  похоже
освежить:  освежить
смутно:  смутно
предлагать:  предлагаю
постараться:  постараюсь
обещать:  обещанного
придавать:  придаём придавая
государственный:  государственную
альфа:  альфа
закрепление:  закрепления
чисто:  чисто
активно:  активно
аналогичный:  аналогичным
добавляться:  добавляется добавляются
отчётливо:  отчетливо
видно:  видно
подвал:  подвале
хотеться:  хочется
караул:  караул
руководствоваться:  руководствоваться
шестой:  шестое
располагать:  располагают
допустимый:  допустима
вряд:  вряд
нулевой:  нулевые
почленный:  почленного
раскрыть:  раскрыв
хороший:  хорошие
мелочиться:  мелочиться
устать:  устал
беглый:  беглого
автоматически:  автоматически
рассказывать:  рассказывать
отец:  отец
примерно:  примерно
принципиально:  принципиально
наблюдение:  наблюдениям
увидеть:  увидеть
записаться:  запишется
потренироваться:  потренировались
набрать:  набравший
понимание:  понимания понимание
второе:  второе
мишень:  мишень
семь:  семь
монета:  монеты монета
урна:  урны урнах урн
длинный:  длинный
потребовать:  потребовать
сигнализация:  сигнализации
орудие:  орудие
станок:  станка
товар:  товар товара
роспись:  росписью
термин:  термине
выпадение:  выпадения выпадении
пуговица:  пуговицы
наудачу:  наудачу
продажа:  продаж
головоломка:  головоломкой
попадать:  попадает попадают
суммировать:  суммируем
совпадать:  совпадает
очередь:  очередь
умолчанный:  умолчанной
возгорание:  возгорании
появление:  появления
десятичный:  десятичные
несовместность:  несовместности
совместный:  совместна
складываться:  складывалось
технологический:  технологическом
промах:  промаха промах
наступление:  наступления
возможный:  возможной
завезти:  завезли
извлечь:  извлечёт извлекут извлёк
плюс:  плюсом
путь:  путь
пересказать:  перескажу
умножаться:  умножается умножаются
смена:  смену
нравиться:  нравятся
попадание:  попаданий
ускоренный:  ускоренном
осознать:  осознать
хвост:  хвостов
заголовок:  заголовке
датчик:  датчик датчика датчиков
деталь:  деталь
одноцветный:  одноцветные одноцветными
подсобка:  подсобке
обслуживать:  обслуживает
ожидаться:  ожидается
бодрящий:  бодрящих
встретиться:  встретится встретился
независимость:  независимости
настойка:  настойки
разнообразный:  разнообразным
милитаристский:  милитаристского
полениться:  поленюсь
кубик:  кубике кубик кубиков кубика кубики
выстрел:  выстрелов
поджидать:  поджидал
поразить:  поражена
избежание:  избежание
классический:  классическую
тяжёлый:  тяжелые
изящно:  изящно
последовательно:  последовательно
сработать:  сработает
нечётный:  нечетная
запятая:  запятой
обнаружить:  обнаружил
заметно:  заметно
упражнение:  упражнения упражнений
мало:  мало
решка:  решка
выделить:  выделил
лаконично:  лаконично
бш:  бш
предложить:  предложенном
запамятовать:  запамятовал
образовать:  образуют
вникать:  вникаем
красный:  красного красному
орёл:  орлами
обозначить:  обозначен
прописать:  пропишу
безотказный:  безотказное
вспоминать:  вспоминаем
пора:  пор
бросок:  броска
валить:  валить
абзац:  абзац
откуда:  откуда
магазин:  магазины магазина магазин
устройство:  устройств
невозможный:  невозможна
классика:  классика
настоящий:  настоящие
хит:  хит
тонкость:  тонкости
путём:  путём
выбирать:  выбирать
комбинаторный:  комбинаторные
уточнение:  уточнение
шаблонность:  шаблонность
подробный:  подробным
бесконечный:  бесконечные
песня:  песнями
отказать:  отказать
подсчёт:  подсчёта
кость:  кость
раскупить:  раскупят
достаться:  достанется
равноценный:  равноценное
академичный:  академичной
однокурсник:  однокурсники
гибридный:  гибридный
достоверный:  достоверные
б:  б
учитывать:  учитывая
продемонстрировать:  продемонстрировать
везение:  везение
компактный:  компактнее компактном
течение:  течение
расписываться:  расписывается
испытание:  испытания
азов:  азов
упростить:  упростит
ориентир:  ориентир
безразличный:  безразлично
настоятельно:  настоятельно
синий:  синих синие
иметься:  имеются
единый:  единым единый
безусловно:  безусловно
выпасть:  выпавших
снаряд:  снаряд снаряда
захотеться:  захочется
цвет:  цветом цвет
настрогать:  настрогал
пожар:  пожаре
долго:  долго
свежий:  свежими
измышление:  измышления
недопонимание:  недопонимание
вечер:  вечера
впервые:  впервые
вымучивать:  вымучиваем
хватать:  хватает
игральный:  игральных
аналогия:  аналогию аналогий
нудно:  нудно
разминаться:  разминаться
коробка:  коробку
произвести:  произвести
продукция:  продукции
хлеб:  хлеб
поражение:  поражения
исправлять:  исправлять
вычислимый:  вычислим
разница:  разницы
принципиальный:  принципиальное
скверный:  скверное
вдуматься:  вдумайтесь
кажущийся:  кажущееся
промахнуться:  промахнутся промахнётся
уместный:  уместной
вытекать:  вытекает
благоприятствовать:  благоприятствующих
непосредственный:  непосредственное
зрелище:  зрелище
гарантировать:  гарантированной
мечта:  мечта
извлекаться:  извлекается
вышеизложенный:  вышеизложенной
практикум:  практикум
труд:  труда
однозначный:  однозначной
счёт:  счёт
разобрать:  разобрать разобрана разобранного разберу
знакомиться:  знакомиться
касаться:  касается
витиеватый:  витиеватые
переделывать:  переделывать
оптовый:  оптовых
итого:  итого
ничто:  ничем
несмотря:  несмотря
произойти:  произошёл
склад:  складов склада
чёткий:  чёткая
актив:  активе
стрелок:  стрелков
взяться:  взялись взялась
остальной:  остальные остальное
настройка:  настройки
тандем:  тандема
результативность:  результативности
участник:  участникам участников
включать:  включаю
вероятный:  вероятному вероятного вероятные вероятными
римлянин:  римляне
извлекать:  извлекают
поставить:  поставить
расписывание:  расписывания
случайно:  случайно
прикольный:  прикольную
очко:  очков
страшноватый:  страшноваты
альтернативный:  альтернативное
каков:  каковы
пристрелить:  пристрелить
залп:  залп
установить:  установлено установить
немереный:  немереное
оформлять:  оформляем
сыронизировать:  сыронизировал
вэ:  вэ
подарочный:  подарочны
приходиться:  приходится
сей:  сих
подбрасываться:  подбрасываются
стеллаж:  стеллаже
вытянуть:  вытянул вытянет
простота:  простоты
проехать:  проехал
основать:  основано
куча:  кучи
запутать:  запутает
приращение:  приращение приращением приращения приращению приращениями
дифференцировать:  дифференцируем
кусочный:  кусочном
выходить:  выходит выходим
ниже:  ниже
левосторонний:  левосторонний
дух:  духа
указывать:  указываем
устранение:  устранения
выгодно:  выгодно
оттачивать:  оттачивая
гибрид:  гибриде
игрек:  игрек игреки игреками
вышесказанный:  вышесказанного
дельта:  дельта дельту
бесконечность:  бесконечность
слева:  слева
ловкость:  ловкость
том:  томах
сокращённо:  сокращенно
выступать:  выступает
выносить:  выносим
продолжить:  продолжим продолжить
убедиться:  убедиться
выводиться:  выводятся
знаменатель:  знаменатели знаменателем знаменатель
исполнять:  исполнять
раскрывать:  раскрываем
теоретический:  теоретические
ось:  ось оси осям
пошаговый:  пошаговой
отделаться:  отделаться
обрыв:  обрывом
шагать:  шагающий
домножать:  домножать
рассматриваться:  рассматривалась
правосторонний:  правосторонний
геометрически:  геометрически
индейка:  индейка
своеобразие:  своеобразие
вертикальный:  вертикальная
целесообразный:  целесообразнее
динамический:  динамической
волшебство:  волшебством
тревожить:  тревожить
отрицательно:  отрицательно
итог:  итоге
укоротить:  укороченные
наглядность:  наглядности
капуста:  капусте
приводить:  приводим приводить
недифференцируемость:  недифференцируемости
неудобный:  неудобную
уничтожать:  уничтожает уничтожаем
решимость:  решимости
отрывать:  отрывать
абсцисса:  абсцисс
выпотрошить:  выпотрошена
расписывать:  расписывать
стык:  стыка
порадоваться:  порадуемся
принадлежащий:  принадлежащую
заранее:  заранее
приятно:  приятно
разность:  разности
подстрочный:  подстрочные подстрочных подстрочный
коварный:  коварная
статистый:  статиста
тайна:  тайну
числитель:  числителе числителях числителя
скобка:  скобку скобки скобках скобке скобок
конечный:  конечного
закомментировать:  закомментирую
динамика:  динамику
облегчить:  облегчило
эра:  эр
лесенка:  лесенка
реально:  реально
привыкнуть:  привык
формально:  формально
благодаря:  благодаря
котопёс:  котопёс
положить:  положите
познавательный:  познавательный
искусственный:  искусственный
уделить:  уделим
односторонний:  односторонние односторонними
щёлкать:  щёлкаем
положительно:  положительно
минус:  минус
античный:  античная
лёгкий:  лёгким
осуществить:  осуществлён
идея:  идея
определяться:  определяется
упаковка:  упаковку
мошенничество:  мошенничества
арккосинус:  арккосинус
сконструировать:  сконструировать
трудно:  трудно
сухой:  сухой
вполне:  вполне
уравновешиваться:  уравновешивается
численно:  численно
бодро:  бодро
нечётность:  нечётность
упираться:  упираться
немедленно:  немедленно
черновик:  черновике
углублённый:  углублённым
раскрутка:  раскрутка
коридор:  коридоре
век:  века
устраняться:  устраняется
среднее:  среднем
устранить:  устранить
индекс:  индекс индексов индексы
дощечка:  дощечки
статуя:  статуй
жаркое:  жаркое
полезно:  полезно
мысленно:  мысленно
книжный:  книжные
умножить:  умноженная
искусственно:  искусственно
набраться:  набраться
существенный:  существенная
породить:  порождена
музей:  музея
повествование:  повествование
причёсывать:  причёсываем
домножить:  домножить
изменяться:  изменяется
делимый:  делим
продифференцировать:  продифференцировать
остаток:  остаток
настать:  настало
настроение:  настроение
предписывать:  предписывают
разложить:  разложить разложена разложим
особенно:  особенно
конспект:  конспект
трёхэтажность:  трёхэтажности
личный:  личной личного
й:  й
боевой:  боевые
теоретически:  теоретически
вкус:  вкусом
свериться:  свериться
счесть:  счесть
открыть:  открыл
точный:  точное точный
предельный:  предельный предельное
слава:  славы
стандартно:  стандартно
стремиться:  стремимся
приближённый:  приближённое
спросить:  спросите
улучшить:  улучшить улучшит
коротенький:  коротенький
ради:  ради
приложение:  приложения
проформа:  проформой
проставлять:  проставлять
сходиться:  сходящимся сходится сходились сходиться
подумать:  подумав
шутка:  шутка
оказываться:  оказывается
маклорена:  маклорена
сократиться:  сократится
тон:  тоном
пройтись:  пройдёмся
порадовать:  порадовать
начинка:  начинку
тренироваться:  тренируемся
встретить:  встретишь встретить
менять:  меняет
троеточие:  троеточия
избавлять:  избавляю
столбцы:  столбцов столбцы
транспонировать:  транспонируем
качественно:  качественно
переварить:  переварить
крокодил:  крокодилы
выбор:  выбор
традиционный:  традиционный
десерт:  десерт
отрицательный:  отрицательные отрицательному отрицательными
обратно:  обратно
известно:  известно
десять:  десяти
земноводный:  земноводное
закинуть:  закинуть
немногий:  немногих
сменить:  сменив
запоминать:  запоминать
обусловить:  обусловлен
вынесение:  вынесение
поубавиться:  поубавится
придумать:  придумать
понижать:  понижает
выжимать:  выжимаем
столбец:  столбец
различие:  различие
вносить:  вносим
багаж:  багажа
гонщик:  гонщиков
понижаться:  понижается
обильно:  обильно
наперёд:  наперёд
привлекательный:  привлекательнее
редкость:  редкость
оптимальный:  оптимальным
попытаться:  попытайтесь
компланарность:  компланарность компланарности
понизить:  пониженном
увеличивать:  увеличивает
разнообразие:  разнообразия
ясно:  ясно
измениться:  изменились изменился
понизиться:  понизился
удобство:  удобства
диагональ:  диагонали
прибавить:  прибавили
завернуть:  завернуть
картинка:  картинку
заготовить:  заготовленный
воевать:  воевать
попробовать:  попробуйте
вверх:  вверх
транспонирование:  транспонирования транспонировании
гуляш:  гуляш
внесение:  внесение
равноправный:  равноправно равноправны
неудобство:  неудобство
перец:  перца
короче:  короче
раскрой:  раскроем
закономерность:  закономерности
контролировать:  контролировать
слабо:  слабо
нагулять:  нагуляете
пропорциональный:  пропорциональны пропорциональные
сидеть:  сидеть
изменить:  изменить изменим
годзилла:  годзилла
рационально:  рационально
устно:  устно
вынести:  вынести
реальный:  реальных реальной
ступенчатый:  ступенчатой
изменение:  изменении изменение изменения
слабый:  слабое
сок:  сока
помеха:  помех
апельсиновый:  апельсинового
множитель:  множители множителей
направо:  направо
баранка:  баранки
лаконичный:  лаконичной
отправить:  отправить
любительский:  любительским
сыграть:  сыграл
слишком:  слишком
древний:  древних
столкнуться:  столкнуться столкнулось
замечать:  замечаем
пропорциональность:  пропорциональности пропорциональность
страничка:  странички
линейно:  линейно
компланарный:  компланарных
вникнуть:  вник
жаба:  жаба жаб
насчитываться:  насчитывается
монстр:  монстрами
неизменный:  неизменным
комплексовать:  комплексуйте
наказуемый:  наказуем
простецкий:  простецкая
налево:  налево
новогодний:  новогодний
помещать:  помещаем
ум:  ума уме
дотошный:  дотошные
одинаково:  одинаково
аппетит:  аппетит
услышать:  услышать
располагаться:  располагаться располагается располагалась
специально:  специально
беда:  беда
повторить:  повторил
долгожданный:  долгожданной
прибавлять:  прибавляем
потратить:  потратить
посидеть:  посидеть
кнопка:  кнопкам
ориентироваться:  ориентироваться
подходить:  подходит
вложить:  вложить
круг:  круг
спасти:  спасёт
вкусно:  вкусно
влечь:  влечёт
дублировать:  дублирует
скажем:  скажем
представимый:  представим
оплошность:  оплошности
возвращаться:  возвращаемся возвращаюсь
вверху:  вверху
перечисленный:  перечисленные
спичка:  спичках
матана:  матану
отработать:  отработали
выход:  выход
организовать:  организовать
игнорироваться:  игнорируются
бойня:  бойня
тьма:  тьма
многовато:  многовато
встречать:  встречаете
обед:  обеда
стакан:  стакан
животное:  животных
мощный:  мощная
протяжение:  протяжении
внести:  внести
суп:  суп
энтузиазм:  энтузиазмом
сильно:  сильно
старый:  старые
собираться:  собираются
достигнуть:  достигнута
меню:  меню
путешествие:  путешествие
успеть:  успели успело
справедливо:  справедливо
родить:  рождённых
распоряжение:  распоряжении
лягушонок:  лягушонка
зеркальный:  зеркальная зеркальную
явный:  явную
стучать:  стучать
толк:  толк
татуировка:  татуировками
снизу:  снизу
коллинеарный:  коллинеарного коллинеарных
внизу:  внизу
несложно:  несложно
реверанс:  реверанс
наблюдаться:  наблюдается
неутомимый:  неутомимые
переставлять:  переставлять
бой:  бой
покой:  покое
район:  районе
фактически:  фактически
лапка:  лапки
резюмировать:  резюмируя
набить:  набили
удлинить:  удлинит
впереди:  впереди
заядлый:  заядлых
распотрошить:  распотрошим
золотой:  золотое
подрасти:  подросшее
порубить:  порубим
демонстрироваться:  демонстрировалось
покрыть:  покрыл
ерунда:  ерунды ерунда
переставить:  переставить
зацикливаться:  зацикливаться
рядышком:  рядышком
прекрасно:  прекрасно
раздавить:  раздавим
к:  ко
довести:  довести
минуть:  минуло
уверенно:  уверенно
щёлкаться:  щелкаться
концовка:  концовку
кирпич:  кирпич
пациент:  пациента
раскладывать:  раскладываем
разумный:  разумные
отмечать:  отмечал
приближение:  приближения приближение
округлять:  округляем
автоматизировать:  автоматизируем
точность:  точности
оценить:  оценить
неудивительный:  неудивительно
округлить:  округлёнными
погрешность:  погрешность погрешностей погрешности
корректный:  корректнее
середина:  середины
равноотрезочный:  равноотрезочного
строить:  строить
сравнить:  сравнить
сравнение:  сравнению
приниматься:  принимается
техникумовский:  техникумовский
цифра:  цифра
актуализировать:  актуализируем
пересекать:  пересекать пересекает
умолчание:  умолчанию
промежуток:  промежутка
модификация:  модификации
соображение:  соображений
повториться:  повторюсь
постановка:  постановка
требование:  требованием
суммарный:  суммарную
удвоенный:  удвоенной
удваивать:  удваиваем
рассчитывать:  рассчитываем
приближённо:  приближённо
браться:  берётся
поплатиться:  поплатиться
озвучить:  озвучу
рунге:  рунге
заштриховать:  заштрихованной
вскользь:  вскользь
вычислять:  вычисляем
медленный:  медленным
демонстрационный:  демонстрационного
перещёлкиваться:  перещёлкивается
ожидать:  ожидает
грубый:  грубых
запас:  запасе
разбитый:  разбиты
небраться:  неберущийся
подынтегральный:  подынтегральной подынтегрального подынтегральная
любознательный:  любознательные
назвать:  назвать
правдивый:  правдивы
хотеть:  хотел
быстренько:  быстренько
прочий:  прочие
ошибочно:  ошибочно
недоставать:  недостающие
безошибочно:  безошибочно
двухэтажный:  двухэтажным
измельчить:  измельчить
видео:  видео
называние:  называние
промежуточный:  промежуточную
изучить:  изучите
гарантированно:  гарантированно
разводить:  разводить
округление:  округление
упрощённый:  упрощенном
пугаться:  пугаемся
затруднить:  затруднена
рисунок:  рисунке
чудовищно:  чудовищно
проводиться:  проводится
чертёж:  чертежа чертёж чертежей
разбивать:  разбиваем
заполнить:  заполним
показаться:  показаться
пометка:  пометки
нюанс:  нюанс
чреватый:  чреват
неточный:  неточным
приплюсовывать:  приплюсовывать
ошибаться:  ошибаться
элементарно:  элементарно
заносить:  заносить
закрыть:  закрыл
почерк:  почерк
пробел:  пробелы
занизить:  занижено
полноценный:  полноценного
тетрадь:  тетради
достоверно:  достоверно
видимо:  видимо
самодеятельность:  самодеятельность
уложиться:  уложится
завышение:  завышение
сверхмелкий:  сверхмелкий
принять:  приняли приняла примет примут
преобразовать:  преобразовать
дополнительно:  дополнительно
разминочный:  разминочные
направление:  направлении
неприятность:  неприятностей
раздача:  раздача
напрасный:  напрасной
графический:  графическое графический
упрощать:  упрощает
приноровиться:  приноровится
палец:  пальцы
применительно:  применительно
чесать:  чешет
близлежащий:  близлежащие
хватить:  хватит
вложение:  вложения
эквивалентный:  эквивалентная эквивалентные
чистый:  чистую
аппетитный:  аппетитные
окончательно:  окончательно
повар:  повар
закрепить:  закрепим
даваться:  даётся
красивый:  красивее
дэ:  дэ
репа:  репы
недавно:  недавно
аккуратно:  аккуратно
студенческий:  студенческой
частичный:  частичных частичного
прилеплять:  прилепляют
соответствие:  соответствии
эф:  эф
внимательно:  внимательно
комбинированный:  комбинированных
хитрость:  хитростей хитростями
опера:  оперы
иррациональность:  иррациональности
объяснять:  объяснять
интуитивно:  интуитивно
бодяга:  бодягу
угловой:  угловыми угловых углового
внимательный:  внимательны
заработать:  заработать
динозавр:  динозавра
контент:  контентом контента
сервис:  сервисом
последователь:  последователей
замучиться:  замучился
казанский:  казанского
заслуживать:  заслуживающих заслуживают
немаловажный:  немаловажный
университет:  университета
мучение:  мучения
вольфрамальф:  вольфрамальфа
разборчивый:  разборчивый
специализировать:  специализированное
многое:  многом
вёрстка:  вёрсткой
вбить:  вбить
постоянно:  постоянно
агрегатор:  агрегаторы
сюда:  сюда
серьёзный:  серьезная серьезный
шлак:  шлака
против:  против
правильность:  правильности
слуга:  слуга
маткада:  маткада
малоизвестный:  малоизвестный
выяснить:  выяснить
выдача:  выдаче выдачи
юзание:  юзание
загрузить:  загрузите загруженный
денежный:  денежных
вводить:  вводим
пачка:  пачки пачек
летний:  летних
мгту:  мгту
запарка:  запарки
процент:  процентах
авторитетный:  авторитетный
вовочка:  вовочка
закачать:  закачать
невозможно:  невозможно
бауман:  баумана
отупеть:  отупеть
мудрость:  мудрость
опасно:  опасно
присылать:  присылают
материально:  материально
типовик:  типовиков
вода:  воду
откровенный:  откровенного
стырить:  стыренным
бездумный:  бездумного бездумное
рунет:  рунета
фонд:  фондов
навалиться:  навалились
тупой:  тупой тупым
поисковик:  поисковика
недостаточный:  недостаточный
пополнить:  пополните
усилие:  усилия
обсудить:  обсудить
медвежий:  медвежья
выдать:  выдам
исчезать:  исчезает
лететь:  летит
коленка:  коленке
расчётки:  расчётки
мусор:  мусор
побывать:  побывали
внутренний:  внутренних
захотеть:  захотите
балл:  балла
вклад:  вклада вкладов
индивидуальный:  индивидуальных
приобрести:  приобретенную
вычурный:  вычурных
забугорный:  забугорный
лажа:  лажи
разжиться:  разжиться
псевдоэнциклопедия:  псевдоэнциклопедий
кнопочка:  кнопочку
жать:  жмём
помощник:  помощник
посчитать:  посчитать
портал:  порталов
препод:  препод
образовательный:  образовательный
домен:  доменах домене
поддомен:  поддоменах поддомене
достоверность:  достоверность
стройный:  стройную
сложно:  сложно
чудесенко:  чудесенко
прислать:  пришли
ага:  ага
дурак:  дурак
мучиться:  мучался
списывать:  списывать
сниматься:  снимается
пережить:  пережили
недостаток:  недостатки
поисковый:  поисковую
приложить:  приложите
архив:  архивом архиве архивы архив архивах
подозрение:  подозрение
реклама:  рекламы
порекомендовать:  порекомендовать
обернуться:  обернётся
проплатить:  проплаченных
раскрутить:  раскрутить
доверять:  доверяйте
приносить:  приносит
формат:  форматах формате
прорешивать:  прорешивая
машинный:  машинных
ниша:  ниши
пакет:  пакета пакет
позитивный:  позитивной
хранилище:  хранилищ
лабораторный:  лабораторной
мгу:  мгу
умение:  умения
банк:  банк
запросто:  запросто
сильный:  сильнее
укладка:  укладка
тяжело:  тяжело
семестр:  семестре
покорный:  покорный
проверяться:  проверяется
эффективно:  эффективно
регистрация:  регистрации
симпатично:  симпатично
неприятный:  неприятным
отключаться:  отключается
скачивание:  скачивание
подробность:  подробности
услуга:  услуги
перечисление:  перечисление
скан:  сканы
файловый:  файловых
студопедия:  студопедии
выдавать:  выдавать
вольный:  вольные
настроиться:  настроиться
неплохой:  неплохие
списывание:  списыванием
вменяемый:  вменяемый
сеть:  сеть
скрип:  скрипом
прокатить:  прокатить
армия:  армии
ценность:  ценность
английский:  английский
авторитетность:  авторитетность
ненадёжность:  ненадёжность
федеральный:  федерального
диковинный:  диковинным
моментально:  моментально
гласить:  гласящее
удаться:  удастся
халява:  халява
рефератник:  рефератники
даром:  даром
забить:  забить
позаимствовать:  позаимствовано
уточнить:  уточним
лад:  ладах
зимний:  зимнего
мозг:  мозг
отнести:  отнести
пробивать:  пробивать
нефть:  нефть
завод:  завода
отражать:  отражать
обуславливать:  обуславливают
фактор:  факторов факторами фактора
очник:  очников
тарифный:  тарифным тарифного тарифные
характеризовать:  характеризующее
копировать:  копирую
безобразие:  безобразия
гуманность:  гуманности
существенность:  существенность существенности
групповой:  групповые
вызывать:  вызывает
средневзвешенный:  средневзвешенное
разбросать:  разбросает
варьироваться:  варьируется
влияние:  влияния
совокупность:  совокупность совокупности
нанимать:  нанимали
несложный:  несложное
взаимосвязь:  взаимосвязь
объединение:  объединения объединению объединение
характеризоваться:  характеризуется
щелчок:  щелчок
относительный:  относительные относительных
внутригрупповой:  внутригрупповую внутригрупповая
развить:  разовьём
поколение:  поколений
существо:  существу
упорядочить:  упорядоченную
объясняться:  объясняется
ролик:  ролики
причинность:  причинности
вставить:  вставить
размножать:  размножаем
эксплуатация:  эксплуатации
компактность:  компактность
перекрёстный:  перекрёстную
гармонично:  гармонично
терпеться:  терпится
группировочный:  группировочного
поговорить:  поговорим
накладываться:  накладывается
относительно:  относительно
разброс:  разброс
оказывать:  оказывает
происходить:  происходит
влиять:  влияет
явно:  явно
вышеприведённый:  вышеприведённого
звучать:  звучит
разряд:  разряды разряда разряд
доля:  доле
немалый:  немалым
ютуба:  ютубе
металлоёмкость:  металлоёмкости металлоёмкость
неслучайный:  неслучайных
частота:  частоты
кошмарить:  кошмарят
пьеса:  пьесы
распределять:  распределяет
математически:  математически
лечь:  лёг
набирать:  набираем
засечь:  засёк
греческий:  греческой
принадлежать:  принадлежит
равнонаполнить:  равнонаполненную
противоречие:  противоречие противоречия противоречием
кропотливый:  кропотливый
квалицировать:  квалицированных
перейти:  перейдем
г:  г
квалифицировать:  квалифицированных
объяснить:  объясню
различаться:  различаются
логично:  логично
разгромить:  разгромим
просуммировать:  просуммировать
занять:  займет
разбирать:  разбирал
рассеяние:  рассеяния
значимый:  значимо
сгруппировать:  сгруппируем
специфика:  специфика
отпускать:  отпускаю
обязать:  обязана
сподвигать:  сподвигает
двор:  дворе
продумать:  продуманный
грубо:  грубо
неудовлетворительный:  неудовлетворительных
заметка:  заметку
шприц:  шприц
связный:  связный
закончиться:  закончится
неявно:  неявно
обстоятельный:  обстоятельной
воспоминание:  воспоминания
ругательство:  ругательства
душа:  душа
сбивать:  сбивать
зря:  зря
ранний:  раньше
перепутать:  перепутать
холодное:  холодные
аба:  абы
поп:  попе
творчество:  творчество
перечитать:  перечитать
объёмный:  объемное
неожиданно:  неожиданно
непринуждённость:  непринуждённости
испугаться:  испугались
задачка:  задачки
невкусный:  невкусным
тщательный:  тщательным
познакомить:  познакомлю
разгар:  разгаре
формулироваться:  формулируется
рот:  рот
чувствовать:  чувствую
сподручный:  сподручнее
артподготовка:  артподготовки
навеять:  навеяли
рождаться:  рождаются
надолго:  надолго
взрослый:  взрослых
перемена:  перемены
наукообразный:  наукообразной
намекнуть:  намекнул
шлифовать:  шлифуете
дфуд:  дфуду
стареть:  старею
наставление:  наставление
добросовестно:  добросовестно
обойти:  обойденную
изложение:  изложения изложение
лёгкость:  лёгкости
прояснять:  прояснять
неспроста:  неспроста
мерещиться:  мерещится
взрослеть:  взрослели
слушать:  слушаешь
ностальгический:  ностальгические
избавить:  избавит
симметрия:  симметрии
отрабатывать:  отрабатываем
широко:  широко
перепроверка:  перепроверка
методически:  методически
апрель:  апреля
солнечный:  солнечное
желание:  желание
разинуть:  разинув
нечто:  нечто
ужасный:  ужасный
текст:  тексту
зет:  зет зеты
таракан:  тараканы
детство:  детства
денёк:  деньки
объяснение:  объяснения
превосходящий:  превосходящие
столетие:  столетию
пытаться:  пытаемся
нуждаться:  нуждается
одномерный:  одномерным одномерной
грань:  граней грани
издание:  издание
напрямую:  напрямую
расплатиться:  расплатиться
игреков:  игрековых
вводиться:  вводятся
пересечение:  пересечения пересечении
констатироваться:  констатируется
отдельно:  отдельно
загораться:  загораются
птичка:  птичку
учесть:  учесть
игровой:  игровых игрового игровые
иксовыя:  иксовый
хаос:  хаоса хаосов хаос
копипаста:  копипаст
некий:  некий
порождаться:  порождается
обвести:  обвести
иже:  иже
возвести:  возвести
составной:  составная
образовывать:  образовывать
суммирование:  суммирования
забивать:  забиваем
верхний:  верхнего верхний
подчёркивать:  подчеркиваю
суммироваться:  суммируются
ячейка:  ячейку
компонент:  компоненты
бросать:  бросать
драконовский:  драконовское
парадоксальный:  парадоксально
матожидание:  матожидание матожиданием матожидания матожиданий
запрещать:  запрещает
строгость:  строгости
игрековый:  игрековые
эксклюзивный:  эксклюзивными
основное:  основном
приглашать:  приглашаю
совершать:  совершая
заодно:  заодно
представление:  представление
искомый:  искомую искомая
отдельность:  отдельности
переиздаваться:  переиздаётся
подбрасывание:  подбрасывании
осветить:  освещен
уверенность:  уверенности
ограничение:  ограничение
констатировать:  констатирует
уместно:  уместно
убеждаться:  убеждаемся
отграничить:  отграничена
шесть:  шестью
вычесть:  вычесть
повлиять:  повлиявшими
большемерный:  большемерные
наложить:  наложено
ты:  тебе
психиатрия:  психиатрия
зажечься:  зажглась
кухня:  кухня
предварительно:  предварительно
ковариация:  ковариация ковариацию ковариации
перебрать:  перебрать
ассоциировать:  ассоциировать
вычисляться:  вычисляется
иксовый:  иксовым
энтузиаст:  энтузиасты
чётвереть:  чётвёртое
подбрасывать:  подбрасывать
торжественный:  торжественный
эталонный:  эталонного эталонным
прыжок:  прыжки
возведение:  возведение
пронумеровать:  пронумерованные
аналитически:  аналитически
присматриваться:  присматриваюсь
дедушка:  дедушка
палата:  палате
горизонталь:  горизонтали
проконтролировать:  проконтролируем
пригодный:  пригодна
плотность:  плотности
осознанно:  осознанно
показать:  показан
фактический:  фактического
обманчивый:  обманчиво
встреча:  встреч
нежелательный:  нежелательна
радиус:  радиуса
грустный:  грустных
ввиду:  ввиду
навевать:  навевает
уходить:  уходим
метр:  метры
разрез:  разреза
лирический:  лирическое
целое:  целое
погрузка:  погрузка погрузки погрузку
покупка:  покупки
участок:  участка
заманивать:  заманивающий
полтора:  полутора полтора
бесхитростный:  бесхитростнее
прощение:  прощения
временной:  временные
привычный:  привычный
разучивать:  разучивать
ограничиться:  ограничиться
печалиться:  печалиться
оля:  олей оля
малиновый:  малиновые малиновыми малиновый
кожный:  кожные
ветвь:  ветвь ветви
листва:  листва
координатный:  координатным координатная координатной координатные
фирменный:  фирменная
улучшиться:  улучшился
утром:  утром
заключаться:  заключается
соскучиться:  соскучились
вершина:  вершину вершинах
смежный:  смежных
романтичный:  романтичный
занимать:  занимает
подойти:  подошёл
рецепт:  рецептом
край:  краям
голодный:  голодные
грузовой:  грузовые
отрезать:  отрежь
разрезать:  разрезает
благополучно:  благополучно
зуб:  зубов
импульсивность:  импульсивность
обрадовать:  обрадую
внеучебный:  внеучебными
интегрировать:  интегрируем
кушать:  кушает
неудачно:  неудачно
масштаб:  масштабе
равновозможный:  равновозможных
бросить:  брошена брошенная брошенной
метровый:  метровую
неприменимый:  неприменимо
автомобиль:  автомобили автомобиля автомобилей
эпизод:  эпизод
окончание:  окончание
доза:  дозах
сокращаться:  сокращаются
своеобразный:  своеобразный
порция:  порция
коля:  коля
буря:  бури
лента:  ленты
откладывать:  откладывать
смотреться:  смотреться
ставиться:  ставятся
километр:  километры
размер:  размеров
бросаться:  бросается
жёлтый:  желтая жёлтым
сантиметр:  сантиметрах сантиметры
ножницы:  ножницы
хандрить:  хандрящих
сезонный:  сезонное
падать:  падает
неподготовленный:  неподготовленного
покров:  покровы
машина:  машин
действенный:  действенно
справиться:  справится
повысить:  повысить
освещать:  освещаю
размерность:  размерности размерность
оглядка:  оглядкой
живительный:  живительный
полупериметр:  полупериметр
усыплять:  усыпляет
бодрить:  бодрит
небрежность:  небрежности
загадать:  загаданных
википедия:  википедии
согласный:  согласны
выяснять:  выясняем
обрезка:  обрезка
организм:  организма
телефонный:  телефонный
обстоятельно:  обстоятельно
плодотворный:  плодотворную
осенний:  осенние
немножко:  немножко
зелёный:  зелёному зелёным
представляться:  представляется
повод:  поводу
окно:  окном
произвольно:  произвольно
подходящий:  подходящие
методика:  методике
длиться:  длится
спектр:  спектр
изобразить:  изобразить
дерево:  деревья деревом
тонус:  тонусе
испортить:  испорченные
манёвр:  манёвр
полупроизведение:  полупроизведению
позиция:  позиций
внутри:  внутри
депрессия:  депрессии
загадываться:  загадываются
ненужный:  ненужных
пересечься:  пересекутся
столовая:  столовую
безразмерный:  безразмерным
присущий:  присущий
сколь:  сколь
чередоваться:  чередующихся
графомания:  графомания
микроскопический:  микроскопической
безудержный:  безудержных
избавляться:  избавляемся
револьвер:  револьвер
неожиданный:  неожиданном
схожий:  схожи
отметка:  отметка
ленивый:  ленивые
пригласить:  пригласим
неделя:  недели
расходиться:  расходящимся расходится расходиться расходились
личность:  личности
экстравагантный:  экстравагантные
плавно:  плавно
знакочередование:  знакочередование
затрагивать:  затрагивает
виноватый:  виноваты
панк:  панки
попросту:  попросту
рассчитываться:  рассчитывается
флудёр:  флудером
чудовище:  чудовище
дрожжи:  дрожжах
сердце:  сердцем
сообщество:  сообщества
спать:  спят
соперник:  соперника
чистосердечный:  чистосердечного
мигалка:  мигалку мигалки
дискретность:  дискретности
посвящёный:  посвящёна
присвоить:  присвоить
уменьшать:  уменьшать
инцидент:  инцидент
ясность:  ясности
убывать:  убывающего убывают убывать
надёжный:  надёжных
свойственный:  свойственны
окрестность:  окрестность окрестности
сущность:  сущности
совладать:  совладали
знатный:  знатной
ободряюще:  ободряюще
энный:  энное
проиллюстрировать:  проиллюстрировано
водопой:  водопою
поезд:  поезде
признание:  признания
незаслуженно:  незаслуженно
странно:  странно
эстет:  эстеты
счётчик:  счётчика
заменимый:  заменим
коррекционный:  коррекционной
волшебный:  волшебный
ладонь:  ладони
здравый:  здравом
прыгать:  прыгают прыгать
вглубь:  вглубь
необыкновенно:  необыкновенно
прогрессия:  прогрессия
чётный:  чётной
инженерный:  инженерных
существенно:  существенно
разоблачение:  разоблачения
уверенный:  уверен
беспокоиться:  беспокойтесь
зайчик:  зайчик
конкуренция:  конкуренцию
погулять:  погулять
рост:  росту роста ростом рост
изолировать:  изолированные
шестёрка:  шестерки
скрипка:  скрипка
микрокалькулятор:  микрокалькулятор
ограничить:  ограничено ограничена
порядковый:  порядковый
зажимать:  зажимает
пощада:  пощады
номер:  номером
патрон:  патроны
определять:  определяемое
рекуррентный:  рекуррентной
клавиатура:  клавиатуре
прокатывать:  прокатывает
просить:  прошу
заурядный:  заурядные
тройка:  тройки
продвигаться:  продвигаемся
бывало:  бывало
зазорно:  зазорно
квадратность:  квадратностью
основание:  основании
тропа:  тропе
чат:  чата
общество:  обществе
повторяться:  повторяется
увеличение:  увеличении
создавать:  создаёт
копирка:  копирку
прадедушка:  прадедушку
стягивать:  стягивая
постучаться:  постучался
решаться:  решаются
убрать:  убрать
задаваться:  задаётся
частенько:  частенько
четырёхэтажность:  четырёхэтажности
ограниченность:  ограниченность ограниченностью
достать:  достать
пронестись:  пронесёмся
мелкий:  мелкие
продвинуться:  продвинуться
незамысловатый:  незамысловатых
отдыхать:  отдыхают
обеспечивать:  обеспечивают
положительный:  положительны
абракадабра:  абракадаброй
стильный:  стильный
отнюдь:  отнюдь
направить:  направлены
невероятно:  невероятно
метание:  метаниях
свёрнутый:  свёрнутом
ребро:  рёбрах ребром
приближаться:  приближаться
сохранить:  сохрани
собраться:  собрались
возвращать:  возвращает
хулиган:  хулиганы
единичка:  единичку
заветный:  заветное
осмысление:  осмысление
арккотангенс:  арккотангенс
впрямь:  впрямь
достойный:  достойная
социальный:  социальной
вывести:  выведем
подсказывать:  подсказывает
жаргон:  жаргоне
приступить:  приступить
рано:  рано
вечный:  вечной
повезти:  повезло
подтолкнуть:  подтолкнуло
граффити:  граффити
вокруг:  вокруг
поздно:  поздно
подруга:  подругой
жизненный:  жизненном
подметить:  подметить
приключение:  приключений
забвение:  забвении
малопригодный:  малопригодным
расписаться:  расписаться
прояснить:  проясним
прерывный:  прерывна
сочинять:  сочинять
расти:  растёт
попадаться:  попадаются
подбираться:  подбираются
непрерывно:  непрерывно
пятёрка:  пятёрки
однозначно:  однозначно
исправить:  исправленная исправленное
злостный:  злостным
весёлый:  веселее
жутко:  жутко
слон:  слонов
четвёрка:  четверку
круглый:  круглых
банально:  банально
галопом:  галопом
ломать:  ломал
симметричный:  симметрична
двулик:  двулики
озарить:  озарила
вне:  вне
флуда:  флуда
паника:  паники
стук:  стуком
непонимание:  непонимании
зажать:  зажмите
заряжать:  заряжаем
повсеместно:  повсеместно
дойти:  дойти
осторожный:  осторожнее
прах:  прах
колебание:  колебания колебаниями колебаниям
увеличиться:  увеличится увеличатся
квадратический:  квадратическое
дть:  демо
подвергаться:  подвергается
сконцентрировать:  сконцентрировать
длительный:  длительным
тайтовыя:  тайтовые
копейка:  копейками
отклониться:  отклонится
форекс:  форексе
эксель:  эксель
перемножать:  перемножаем
ребус:  ребус
вправо:  вправо
любитель:  любителей
агрессор:  агрессор
кучность:  кучности
тихий:  тихой
многоугольник:  многоугольника
пух:  пух
щедрый:  щедра
метко:  метко
склонный:  склонны склонен
целиться:  целится
адреналиновый:  адреналиновые
латынь:  латынь
стрелять:  стреляет стреляют
высокодисперсионный:  высокодисперсионные
ставка:  ставки
рассеять:  рассеяны
банкролл:  банкролл банкроллом
выигрыш:  выигрыша выигрышей
развлекаться:  развлекается
пуля:  пули
оперировать:  оперируют
неутешительный:  неутешительное
фон:  фоне
мерило:  мерилом
средство:  средств
програться:  програться
игрок:  игрок игроком игрока
возрастать:  возрастает
кон:  кону
дисперсионный:  дисперсионной
пускать:  пускаем
количественно:  количественно
прижиться:  прижился
понестись:  понеслась
сложиться:  сложилось
иллюстрировать:  иллюстрируют
великоватый:  великоватым
рулетка:  рулеткой
рисковать:  рисковали рискуем
влево:  влево
отлично:  отлично
сигма:  сигма
потребность:  потребностей
символический:  символическую
сорвать:  сорвать
рубль:  рублей
наблюдать:  наблюдать
дурдом:  дурдоме
осторожничать:  осторожничать
поддержка:  поддержку
проявлять:  проявлять
право:  правом
незамедлительно:  незамедлительно
снайперский:  снайперское
взаимоуничтожаться:  взаимоуничтожаться
готовенький:  готовеньких
выжать:  выжать
увеличить:  увеличить
трястись:  трястись
агрессивный:  агрессивный
авантюрный:  авантюрный
зафиксировать:  зафиксировать
стрельба:  стрельбы
покер:  покере
переводиться:  переводится
тяга:  тяги
биржа:  биржах
мартингейл:  мартингейл
плaтy:  плaтy
натянутый:  натянутой
часовой:  часовой
путаться:  путаемся
движение:  движением
река:  реки
ладь:  ладей
критичный:  критична
свестись:  сведётся
прозрачный:  прозрачно
поздравлять:  поздравляю
недочёт:  недочётом
экзотический:  экзотические
спроецировать:  спроецировать
нечего:  нечего
занимательный:  занимательной
лопата:  лопату
материальный:  материальной
остриё:  острия
ротор:  ротор
торчать:  торчащей
тэ:  тэ
тупо:  тупо
сечение:  сечение
интерпретировать:  интерпретировать
плоский:  плоской плоская
гидродинамический:  гидродинамический гидродинамическом
соленоидальный:  соленоидальные соленоидальным
полноценно:  полноценно
гармония:  гармония
перемещение:  перемещения
зетовый:  зетовом
завораживать:  завораживающая
роторный:  роторном роторную
добить:  добью
косой:  косым
властвовать:  властвуй
стрелочка:  стрелочка
циркулировать:  циркулировать циркулирует
обходиться:  обходится обхожусь
цилиндр:  цилиндра цилиндр
проинтегрировать:  проинтегрировал
направлять:  направляющего направляющие направляющий направляющими направляющих направляющим направляющему
обязательный:  обязательным
контур:  контуру
упрощённо:  упрощённо
описываться:  описывается
вручить:  вручить
аддитивность:  аддитивности
ровный:  ровный ровному ровных ровного ровная
вставать:  встаёт
прорисовываться:  прорисовывается
пространственный:  пространственную пространственное
взглянуть:  взгляните
буковка:  буковку
обнулить:  обнулить
флотилия:  флотилия
преимущественно:  преимущественно
замкнутость:  замкнутости
скомпенсировать:  скомпенсировано
единичный:  единичной единичного
объёдинять:  объёдиняет
плыть:  плывёт
обход:  обхода обход
жидкость:  жидкости жидкостью
отработка:  отработку
сакраментальный:  сакраментальный
декартов:  декартову
пропорция:  пропорциям
полуось:  полуосью полуосями
упускать:  упускаем
осуществлять:  осуществлять
сослаться:  сослаться
разнонаправить:  разнонаправлено
риск:  риск
силовой:  силовых
потенциальный:  потенциальное
воздух:  воздух
скарб:  скарб
беспроблемный:  беспроблемно
исторически:  исторически
уменьшить:  уменьшить
проекция:  проекцией проекция проекциям
лояльно:  лояльно
полноводный:  полноводная
противоположно:  противоположно
потенциально:  потенциально
выписать:  выпишем
труба:  труб
гидродинамика:  гидродинамики
проецироваться:  проецируются
величественно:  величественно
ассоциация:  ассоциации
минимизировать:  минимизировать
пометить:  помечена
малое:  малого
гармонический:  гармонического гармоническим
обширный:  обширной
ассоциироваться:  ассоциируется
палка:  палка
кусочек:  кусочка кусочков кусочки
вдоль:  вдоль
проциркулировать:  проциркулирует
флакон:  флаконе
прохождение:  прохождением
видный:  видны
смениться:  сменится
трудозатрата:  трудозатраты
распространиться:  распространилось
скрупулёзный:  скрупулезное
бурный:  бурные
перемещаться:  перемещаемся
оттуда:  оттуда
двигаться:  двигаться
русло:  русле
задува:  задува
перечислить:  перечислю
напор:  напора
водопроводный:  водопроводный водопроводной
призывать:  призывал
исходящий:  исходящий исходящего
внутрь:  внутрь
смысловой:  смысловому
непростой:  непростой
уличный:  уличным
перекрой:  перекроем
исключить:  исключить
определённость:  определённости
бутылка:  бутылку
уменьшаться:  уменьшаются
ориентировать:  ориентирован
фильм:  фильмов фильмах фильмы
разрулить:  разрулит
небо:  небо
перечислять:  перечислять
вращательный:  вращательного
внешний:  внешнюю внешней
полевой:  полевыми
предпочесть:  предпочел
максимум:  максимуму
несвободный:  несвободные
знаменательный:  знаменательный
равновесие:  равновесие
убыть:  убыла
дуть:  дует дуть
штопор:  штопора
напрасно:  напрасно
открытие:  открытиям
поделать:  поделать
ориентация:  ориентацию ориентации ориентацией
вкручивать:  вкручиваете
протечь:  протекла протекло
призма:  призму призма призмы
вкладывать:  вкладывать
туда:  туда
повестись:  повелось
графически:  графически
сосредоточиться:  сосредоточиться
сквозняк:  сквозняк
течь:  течь
начертить:  начертите начертить
кружочек:  кружочки
призмочка:  призмочке
любопытный:  любопытный
ветер:  ветер
воздержаться:  воздержаться
достигаться:  достигается
проецирование:  проецирование
ручка:  ручку
водоворот:  водоворот
контроль:  контроль
удивительный:  удивительную
характер:  характер
нисколько:  нисколько
утечка:  утечка
ограничивать:  ограничивающая
прочувствовать:  прочувствовать
говорящий:  говорящей
открытый:  открытом
добавлять:  добавлять
сводить:  сводят
октант:  октантах
штиль:  штиль
острый:  острые
уйти:  уйдёт
нежелательно:  нежелательно
поступать:  поступают
фрагмент:  фрагмента фрагмент
каноничный:  каноничный
прошедшее:  прошедшее
вытечь:  вытекло
приводиться:  приводится
абстрагироваться:  абстрагируемся
титаник:  титаник
определиться:  определился
комнатный:  комнатную
поподставлять:  поподставлять
килограмм:  килограммов
обстоять:  обстоит
чёрточка:  черточку
тонна:  тонн тонны
наклон:  наклон
водный:  водного
кран:  кран
тык:  тыка
тяжко:  тяжко
плюсик:  плюсик
счастливый:  счастливые
оптимистичный:  оптимистичны оптимистичного
преспокойно:  преспокойно
войти:  вошёл
убирать:  убираем
наличие:  наличии
квест:  квеста
этаж:  этажа
сон:  снах
советовать:  советовал
проторить:  проторенной
ветка:  ветке
корн:  корне
понт:  понты
заталкивать:  заталкиваем
простенький:  простенькая
актуальность:  актуальность
заслать:  зашли
страшненький:  страшненькой
отловить:  отловили
семейство:  семействе
окова:  оковы
приписать:  приписать
кривовато:  кривовато
беспокойство:  беспокойство
сплошной:  сплошная
удостаиваться:  удостаивается
новость:  новости
заявить:  заявленного
запрашиваться:  запрашивается
надобность:  надобности
стена:  стены
продвижение:  продвижения
привыкать:  привыкать
триллер:  триллер
повыносить:  повыносить
уничтожить:  уничтожить
трёхчлен:  трёхчлен
разделяться:  разделяющимися
великий:  великого
навешивать:  навешиваем навешивать
терять:  теряет
потерянный:  потерянном
опасный:  опасные опасное опасная
гордиться:  гордятся
исчезнуть:  исчезли
попасться:  попасться
разделение:  разделение
сбросить:  сбросить
утренний:  утренний
фатальный:  фатальной
рубеж:  рубежах
неразложимый:  неразложимый
пролететь:  пролетело
делитель:  делителя
неравносильный:  неравносильными
ошибочный:  ошибочный
разделяемость:  разделяемость
устроить:  устроены
сброс:  сброс
китайский:  китайского
замучить:  замучить
выделение:  выделения
касса:  кассы
совершить:  совершило
выделять:  выделяют
чистовик:  чистовике
согласиться:  согласитесь
прилично:  прилично
несоблюдение:  несоблюдение
пронести:  пронесло
проработать:  проработает
однородность:  однородность
накатать:  накатанной накатанная
абсолютно:  абсолютно
переобозначить:  переобозначить переобозначив
потеряшка:  потеряшках
туман:  туман
новинка:  новинка
штрих:  штриха штрихом
мигрировать:  мигрировали
стоп:  стоп
ан:  ан
сбрасывать:  сбрасываем
трогать:  трогать
упаковывать:  упаковываем
корявый:  корявый
поперекидывать:  поперекидывать
безопасный:  безопасен
опасность:  опасность
вовремя:  вовремя
поначалу:  поначалу
колея:  колее
дорога:  дороги дорогу дорога
превратиться:  превратится
освоиться:  освоились
пристальный:  пристальное
штриховой:  штриховому
раскрытие:  раскрытия
модифицированный:  модифицированный модифицированную
времяпровождение:  времяпровождение
пояснить:  поясню
потеря:  потеря
сойти:  сошёл
маньяк:  маньяку
сигнум:  сигнум
половина:  половине
владеть:  владеть
разновидность:  разновидностей
четверть:  четвертях
предложный:  предложен
споловинить:  споловинить
распиливать:  распиливаем
вынестись:  вынеслось
сведение:  сведения
дурачок:  дурачком
симметричность:  симметричностью симметричность симметричности
уничтожаться:  уничтожаются
напоминание:  напоминание
наивный:  наивная
важность:  важность
гениальный:  гениальное
удвоить:  удвоить
несчастный:  несчастную
схлопотать:  схлопочете
вероятно:  вероятно
заставить:  заставил
будущее:  будущее
факультатив:  факультатива
прикинуться:  прикинуться
нигде:  нигде
древность:  древности
состариться:  состарился
терпеть:  терпит
чётность:  чётностью чётность чётности
знакомить:  знакомит
аккуратный:  аккуратным
неподалёку:  неподалёку
увы:  увы
устремить:  устремить
полуокружность:  полуокружность
обоснованный:  обоснованный
половинка:  половинку
параноик:  параноики
грамотный:  грамотным
понаслышке:  понаслышке
сектор:  секторами секторе
фишка:  фишка
интерпретация:  интерпретация
проговаривать:  проговаривать
расходимость:  расходимости расходимость
незнание:  незнание
разделываться:  разделываемся
мучить:  мучить
кубический:  кубический
иллюстрация:  иллюстрация
взаимно:  взаимно
полукруг:  полукруг
уничтожиться:  уничтожатся
чешуя:  чешуя
трудоёмкий:  трудоёмкие
первообразный:  первообразных первообразная первообразной первообразную
одноимённый:  одноимённая одноимённый
жвачка:  жвачкой
несуществование:  несуществования
недоразумение:  недоразумения
классифицировать:  классифицированы
пройдить:  пройдённый
опробовать:  опробовать
устранимый:  устранимым устранимый устраним
имхо:  имхо
разрываться:  разрываются
залепить:  залепить
заняться:  заняться
предшествовать:  предшествующего
рисование:  рисования
чрезвычайно:  чрезвычайно
загнать:  загоним
маршрут:  маршрутом
аудитория:  аудитории
есть:  едят
завершение:  завершению
волна:  волны
всюду:  всюду
искусство:  искусства
делаться:  делается
бородатый:  бородатую
углубляться:  углубляясь
разрывный:  разрывных
совокупный:  совокупному
убито:  убито
вплотную:  вплотную
усвоение:  усвоения
проколоть:  проколотое
киль:  килем
неустранимый:  неустранимым неустраним
художественный:  художественной
выпадать:  выпадать
заморозить:  заморожено
многообразие:  многообразие
необычный:  необычного
реализоваться:  реализуется
асимптотический:  асимптотической
извиваться:  извиваться
пропасть:  пропадут
недосказанность:  недосказанности
композиция:  композиции
тест:  тест
фут:  футов
природа:  природой
точечный:  точечными
тесно:  тесно
обнаружение:  обнаружение
лоскут:  лоскутом
переопределить:  переопределить
художник:  художник
первоисточник:  первоисточник
наглухо:  наглухо
наступить:  наступил
одеяло:  одеялом одеяла одеяло
скручиваться:  скручивается
стягиваться:  стягиваться
круговой:  круговой
проблёмка:  проблемку
окинуть:  окинуть
параллельно:  параллельно
курить:  курит
отверстие:  отверстие
разбор:  разбор
разрешиться:  разрешится
пунктир:  пунктиром
подпредельный:  подпредельную
указательный:  указательным
задом:  задом
мирный:  мирную
благоприятный:  благоприятным
связать:  связан
трёхмерный:  трёхмерного
тестировать:  тестируем
брат:  братом
развернуться:  развернётся
затолкать:  затолкать
старое:  старое
аффинный:  аффинного аффинный
симметрично:  симметрично
аварийный:  аварийных
донельзя:  донельзя
расстановка:  расстановке
неколлинеарный:  неколлинеарных
превратить:  превратил превратить
взаимный:  взаимное
подопытный:  подопытной
захлопнуть:  захлопнуть
перебирать:  перебираем
крутить:  крути
ортонормированный:  ортонормированным ортонормированному ортонормированных ортонормированный ортонормированном
непонятный:  непонятными
чувствоваться:  чувствуется
птица:  птицей
вызвать:  вызвавшему
нестарый:  нестарой
поворот:  повороте поворот поворота
революция:  революции
срочно:  срочно
отсчёт:  отсчёта отсчёт
символизировать:  символизирует
расставить:  расставить
вкупе:  вкупе
стесняться:  стесняйтесь
полюбить:  полюбят
эпохальный:  эпохальные
тригонометрия:  тригонометрии
обобщить:  обобщил
рассуждать:  рассуждать
ордината:  ординат
застолбить:  застолбить
власть:  власть власти
просматриваться:  просматривается
эффект:  эффект
вспомниться:  вспомнился
отсчитываться:  отсчитываются
укладывать:  укладывать
осуществление:  осуществления
оранжевый:  оранжевая
подача:  подачи
прибавиться:  прибавилось прибавились
перемещать:  перемещать
левоориентировать:  левоориентированных левоориентированный
отобразить:  отобразит
невырожденный:  невырожденное
слышать:  слышать
пушистый:  пушистые
правоориентировать:  правоориентированный
коричневый:  коричневые коричневых
тузик:  тузика тузиков
легендарный:  легендарный
базисный:  базисные базисных
ненаглядный:  ненаглядным ненаглядный
очевидец:  очевидцами
искажение:  искажение
водиться:  водился
повестка:  повестке
протестировать:  протестируем
пришлый:  пришлой
наклонить:  наклонена
мешать:  мешало
наглядный:  наглядного
подвергнуться:  подвергнется
совместить:  совместите
сохранение:  сохранение
расположиться:  расположился
непременно:  непременно
соотношение:  соотношения
прижать:  прижмите
контекст:  контексте
косых:  косых
пунктирный:  пунктирная
нарушать:  нарушает
осевой:  осевая
подстраиваться:  подстраиваются
отражение:  отражение
соотносить:  соотносит
осложняться:  осложняется
почитать:  почитали
порождать:  порождает порождаемые
положительность:  положительности
симметрический:  симметрическая симметрической
помахать:  помахать
шварценеггер:  шварценеггеру шварценеггера
логически:  логически
пограничный:  пограничные
неположительносить:  неположительнось
перещёлкать:  перещёлкаем
орден:  орден
разрастаться:  разрастаются
актёр:  актёр
украшать:  украшает
баян:  баян
отрицательность:  отрицательности отрицательность
усугубляться:  усугубляется
простыня:  простыня
вырожденный:  вырожденного
перемножить:  перемножить
наталкивать:  наталкивает
знакоопределённость:  знакоопределенность
замысловатый:  замысловатый
запомнить:  запомнить
знакопеременный:  знакопеременна
поделить:  поделить
стоять:  стоять
вписаться:  вписалось
сильвестр:  сильвестра
незамедлительный:  незамедлительной
опциональный:  опционально
восстановить:  восстановить
сигнализировать:  сигнализируют
ст:  ст
отпасть:  отпал
неотрицательность:  неотрицательность неотрицательности
сверяться:  сверяемся
хохлов:  хохлову
гладко:  гладко
прилагательное:  прилагательное
неположительный:  неположительных
непривычный:  непривычном
смущать:  смущать
неотрицательный:  неотрицательны
выявить:  выявленная
нипочём:  нипочём
противоречить:  противоречит
скороговорка:  скороговорка
сергей:  сергею
отправляться:  отправляются
яркий:  яркой
краевой:  краевые
раскрываться:  раскрывается
полосочка:  полосочку
чередование:  чередование
озарение:  озарения
бицепс:  бицепсами
споловиненный:  споловиненные
всеоружие:  всеоружии
некогда:  некогда
упреждать:  упреждаю
назначение:  назначения
знакопеременность:  знакопеременности
видимость:  видимость
усложнение:  усложнении
определимый:  определим
неположительно:  неположительно
разворачивать:  разворачивать
амплуа:  амплуа
сталлоно:  сталлоне
продолжаться:  продолжается
творческий:  творческий
мпг:  мпгу
напомнить:  напомню
усугублять:  усугублять
холст:  холст
картина:  картину
теряться:  теряться
арнольд:  арнольду
приплюсовать:  приплюсовать
неположительность:  неположительности
долгий:  долгим
негативный:  негативную
сообразить:  сообразим
неудобно:  неудобно
детально:  детально
простить:  простите
бублик:  бублик
трудоёмкость:  трудоёмкость
страх:  страха
инициатива:  инициативу
раритет:  раритету
половинный:  половинного
плюшка:  плюшки
отнестись:  отнесёмся
нажить:  нажито
вычитание:  вычитания вычитание
искомое:  искомое
предупредить:  предупредить
насыщенный:  насыщенная
воспалить:  воспалённым
рисовать:  рисовать рисуйте
отличиться:  отличатся
анекдот:  анекдота
одночлен:  одночлен
высказать:  высказать
ножка:  ножках
раскручиваться:  раскручиваться
козлик:  козлика
волос:  волосы
рвать:  рвать
цикл:  цикл
присниться:  приснится
обделить:  обделёнными
напоследок:  напоследок
непосильный:  непосильным
предварительный:  предварительная
сервак:  сервак
дико:  дико
отчёркивание:  отчёркивание отчёркиванием
прикреплять:  прикрепляя
оговориться:  оговорюсь
сознание:  сознание
закусочный:  закусочный
девчонка:  девчонки
окончательный:  окончательную
нумерация:  нумерация нумерацию
заездить:  заезженный
отчёркивать:  отчеркиваем
свирепый:  свирепый
делимое:  делимое
переворачиваться:  переворачиваются
незнакомец:  незнакомец
деться:  деться
пошуршать:  пошуршать
предосудительный:  предосудительного
прописывать:  прописываем
разборка:  разборки
забытый:  забытой
нелепый:  нелепых
сносить:  сносим
открывать:  открываемый
ликвидироваться:  ликвидируются
свидетель:  свидетели
подвернуться:  подвернулись
убеждённый:  убеждён
куб:  кубами
жалко:  жалко
признаваться:  признавайтесь
перехватить:  перехватите
хах:  хах
экземпляр:  экземпляре
иегова:  иеговы
зачистка:  зачистке
набиваться:  набивается
рожок:  рожки
территория:  территории
фантастически:  фантастически
разоблачить:  разоблачить
отобрать:  отобрать
заскок:  заскоков
дочитать:  дочитали
слиться:  сольётся
львиный:  львиной
бок:  боку
распаковать:  распакую
мажорантный:  мажорантным мажорантного мажорантному
радикальный:  радикальный
подвесить:  подвесить
застукать:  застукает
целиком:  целиком
мажорировать:  мажорирует мажорирующий
кисло:  кисло
рад:  рад
охватываться:  охватываются
обещание:  обещания
корректно:  корректно
преодолеть:  преодолев
неабсолютно:  неабсолютно
дебри:  дебри
прихватить:  прихватили
неравномерный:  неравномерная
проявляться:  проявляется
равномерно:  равномерно
мажорироваться:  мажорируется
солнце:  солнца
порвать:  порвали
коллекция:  коллекции
подвисания:  подвисаний
хрестоматийный:  хрестоматийный
подчищать:  подчищаем
типично:  типично
суровый:  суровой
сомневаться:  сомневающихся
явственно:  явственно
машинальный:  машинальную
мотив:  мотивам
обильный:  обильная
рваться:  рвутся
наноскопический:  наноскопический
вылезать:  вылезает
разогреваться:  разогреваемся
закрытый:  закрыта
истончаться:  истончаться
прикасаться:  прикасаться
мужественно:  мужественно
пересчитать:  пересчитать
эпсилон:  эпсилон
заключить:  заключил
человеческий:  человеческий
мажор:  мажор
шеренга:  шеренги
неограниченный:  неограниченным
прижиматься:  прижимается
вейерштрасса:  вейерштрасса
синусоида:  синусоида
согнуть:  согните
рыжий:  рыжих
оправдаться:  оправдаться
посередине:  посередине
подвести:  подвести
выявление:  выявления
прекрасный:  прекрасному
равномерность:  равномерности равномерностью равномерность
удержаться:  удержался
неравномерность:  неравномерность
хитро:  хитро
расхождение:  расхождение
превосходить:  превосходит
застрелиться:  застрелиться
нордический:  нордический
полуинтервал:  полуинтервале полуинтервала
опровергать:  опровергаем
жест:  жест
неловкий:  неловкой
усложнить:  усложним
провидец:  провидцем
малюсенький:  малюсенький
установление:  установления
приблизиться:  приблизится
гигантский:  гигантские
сдержать:  сдержать
взор:  взор
мизерный:  мизерной
прочить:  прочим
поза:  позе
море:  море
обобщённый:  обобщенного
неравномерно:  неравномерно
замалчивать:  замалчивает
вблизи:  вблизи
вкусный:  вкусной
опустить:  опущенного
тренировка:  тренировки
дорожка:  дорожке
канон:  канонам
пареный:  пареной
стойло:  стойло
схематический:  схематическое
надвинуть:  надвинем
ластик:  ластиком
терзать:  терзает
расположение:  расположение
частичка:  частички
приравнивать:  приравниваем
невнимательность:  невнимательности невнимательность
прочерчивать:  прочерчивает
начаться:  началась
жить:  живут
вытащить:  вытащим
неизбежный:  неизбежны
сказка:  сказку
скрещивание:  скрещивания
орт:  ортами орт
наградить:  наградят
жертва:  жертвой
множественный:  множественная
приперчить:  приперчить
снимать:  снимай
параллельность:  параллельности
аппликата:  аппликат аппликатой
тонко:  тонко
наложиться:  наложились
стереть:  стереть
родный:  родными
дёргаться:  дёргаемся
джоконда:  джоконды
резать:  режет
попутно:  попутно
закусить:  закусить
улыбка:  улыбка
непривычно:  непривычно
случайность:  случайность
застраховать:  застрахован
путеводитель:  путеводитель
порассуждать:  порассуждаем
распадаться:  распадается
король:  короли
премия:  премия
разноцветный:  разноцветные
отщипывать:  отщипываем
лоб:  лоб
унылый:  унылы
озадачивать:  озадачивает
ёж:  ежу
глазомер:  глазомер
тормозка:  тормозок
омега:  омега
поперёк:  поперёк
отмерять:  отмерять
карандаш:  карандашом
пэ:  пэ
полупространство:  полупространство полупространства
дарвин:  дарвина
смутный:  смутные
убеждать:  убеждать
клетчатый:  клетчатой
проштудировать:  проштудировать
садик:  садике
голый:  голые голый
демонстрировать:  демонстрирует
фиолетовый:  фиолетовая
пренебрегать:  пренебрегать
морщина:  морщин
муравей:  муравьёв
наглядно:  наглядно
двухшаговый:  двухшаговое
серый:  серой серых серую
эталон:  эталон
перегружать:  перегружать
тысячная:  тысячной тысячную
шрифт:  шрифтом
проделывать:  проделываем
перекликаться:  перекликается
статься:  статься
сотый:  сотой
сравнимый:  сравним
утяжелить:  утяжелён
подразумеваться:  подразумевается
здорово:  здорово
красавец:  красавец
закрывать:  закрываем
выясняться:  выясняется
милость:  милости
типичный:  типичными
тупик:  тупик
хитрый:  хитрой
ключевой:  ключевой
пробовать:  пробуйте
проностальгировать:  проностальгировал
опытный:  опытные
задаться:  зададимся
погода:  погоду
загвоздка:  загвоздка
выгода:  выгода
штриховка:  штриховка штриховкой
промучаться:  промучаетесь
желаемый:  желаемую
приступать:  приступать
невзирая:  невзирая
подводный:  подводных
недетский:  недетская
поведение:  поведения
жанр:  жанра
навешивание:  навешивание
подавно:  подавно
арк:  арк
очертание:  очертания
уклончиво:  уклончиво
полуплоскость:  полуплоскости полуплоскость
правота:  правоте
исследуться:  исследуются
неправота:  неправоте
партизанск:  партизански
экшн:  экшн
уменьшение:  уменьшения уменьшением
отбрасывать:  отбрасывать
установленный:  установленного
кровь:  кровью
легальный:  легальном
непонятка:  непонятки
спрашивать:  спрашивал
вердикт:  вердикт
сомнение:  сомнения сомнений
отобразиться:  отобразится
камень:  камнем
сравнивать:  сравнивать
устанавливаться:  устанавливается
проследить:  проследите
скромно:  скромно
вспоминаться:  вспоминается
профессорский:  профессорский
вуалироваться:  вуалируется
чертить:  чертить
найдить:  найдённые
поймать:  поймал
поддаваться:  поддаются
сторонка:  сторонке
экипаж:  экипажа
период:  период
участвовать:  участвовать
прошивать:  прошивает
периодичный:  периодична
примелькаться:  примелькавшихся
малопонятный:  малопонятный
обвивать:  обвивает
отряд:  отряд
умалчивать:  умалчивает
прикрепить:  прикреплю
поднадоесть:  поднадоели
наказать:  наказать
папка:  папка
проясниться:  прояснилось
растиражировать:  растиражировав
уделять:  уделяем
размножить:  размножьте
припоминать:  припоминаю
ровнёхонький:  ровнёхонько
вглядываться:  вглядываемся
стержень:  стержнем
крайний:  крайним
раздражитель:  раздражителей
предполётный:  предполётные
старт:  старту
окружающий:  окружающем
имя:  имя имён
плющить:  плющило
пила:  пилой
амплитуда:  амплитуд
волнение:  волнением
участие:  участие
обрубка:  обрубки
лапа:  лапы
маскировать:  маскируют
периодический:  периодические периодическим периодических периодическая периодическую
соблюдать:  соблюдайте
заказ:  заказы
надевать:  надеваем
навязчивый:  навязчивых
полупериод:  полупериода полупериодом полупериод
корабль:  корабля
матанализ:  матанализу
умолчать:  умолчу
скафандр:  скафандры
черчение:  черчения
жесть:  жесть
именитый:  именитые
убавить:  убавил
скачок:  скачков скачок
интегрироваться:  интегрируются
прибор:  прибор
подозрительный:  подозрительной
гелевый:  гелевый
откинуться:  откинувшись
пополам:  пополам
сапа:  сапой
простор:  просторах
аккуратность:  аккуратность
выдерживать:  выдерживая
похожесть:  похожести
низ:  низ
впоследствии:  впоследствии
невесомость:  невесомости
коварно:  коварно
изощрённый:  изощрённых
категорически:  категорически
космос:  космос
хомячок:  хомячков
обидно:  обидно
выспаться:  выспавшимися
насущный:  насущного
сто:  сто
аквариумный:  аквариумных
провокационный:  провокационный
дисплей:  дисплее
подведение:  подведения
тягота:  тяготах
космонавт:  космонавтов космонавтом
концентрация:  концентрации концентрация
разложим:  разложима
звёздный:  звёздные
ритм:  ритм ритмом
сверхаккуратность:  сверхаккуратность
трезвый:  трезвыми
теплопроводность:  теплопроводности
готовиться:  готовимся
злополучный:  злополучную
расслабиться:  расслабимся
заключать:  заключают
звено:  звено
тильда:  тильда
пи:  пи
самочувствие:  самочувствие
звёздочка:  звёздочкой
отправиться:  отправиться
приближать:  приближает
рыбка:  рыбок
тренировочный:  тренировочного
богатство:  богатство
полёт:  полётов
нумеровать:  нумеровать
эмоция:  эмоций
настолько:  настолько
зануда:  зануда
эль:  эль
посметь:  посмел
подставляться:  подставляются
космический:  космического
родственник:  родственники
дирихло:  дирихле
загромождённость:  загромождённости
фантазия:  фантазия
искренне:  искренне
отдохнуть:  отдохнуть
сторонний:  сторонних
взаимоуничтожать:  взаимоуничтожаем
стратегический:  стратегических
пилообразный:  пилообразный
бескрайний:  бескрайние
плотно:  плотно
водить:  водить
лукавство:  лукавством
отрешиться:  отрешиться
миллиметр:  миллиметры
медицинский:  медицинского
экспедиция:  экспедицию
периодичность:  периодичности
опустеть:  опустеет
приборный:  приборную
кресло:  креслах
марс:  марс
преамбула:  преамбула
хоровод:  хороводы
созерцать:  созерцая
тиражировать:  тиражируем
верх:  верха
выноситься:  выносится
пристреляться:  пристреляться
сломать:  сломано
возмущаться:  возмущались
срединный:  срединный
преимущество:  преимущество преимуществами
молчок:  молчок
змий:  змий
консервы:  консервы
французский:  французский
идеал:  идеале
миниатюра:  миниатюра
антиквариат:  антиквариат
рулить:  рулит
колобок:  колобок колобка
отвёртка:  отвертками
спокойно:  спокойно
раскопать:  раскопаю
вертолёт:  вертолета
гость:  гость
предок:  предки
краткость:  краткости
лисий:  лисьи
клавиша:  клавиши
шаблонный:  шаблонна
утомиться:  утомился
корпус:  корпус
сбежаться:  сбежались
страждущий:  страждущих
нырять:  ныряйте
съесть:  съел
политехнический:  политехнического
непедагогичный:  непедагогично
транспорт:  транспорт
агрегат:  агрегата
заметный:  заметные
скалькулировать:  скалькулированное
подчистить:  подчищены
хвостик:  хвостиком
проситься:  просится
стереться:  сотрутся
вышеупомянутый:  вышеупомянутом вышеупомянутого
домножения:  домножения
переводить:  переводит
конный:  конная
нудноватый:  нудноватый
освещёный:  освещёны
оправдать:  оправдано
город:  города
повозка:  повозка
нелады:  неладах
заменять:  заменяя
институт:  института
нацело:  нацело
радиолюбитель:  радиолюбители
местный:  местного
дно:  дно
аплодисменты:  аплодисменты
выбросить:  выбросить
физмат:  физмате
глупый:  глупая
подмывать:  подмывало
обобщение:  обобщение
утолстить:  утолщенной утолщённой
жарко:  жарко
балда:  балды
проверочный:  проверочное
примерчик:  примерчик
вычитаемое:  вычитаемое
отмерить:  отмерь
гребёнка:  гребёнкой
детализировать:  детализированный
перечертить:  перечертите
подмножество:  подмножеством
стандарт:  стандарта
отсутствие:  отсутствие
глазок:  глазок
изображаться:  изображается
бог:  боже
циркуль:  циркуль
проделать:  проделать
формульный:  формульный
оставлять:  оставляем
сливаться:  сливался
эх:  эх
измерить:  измерив
перескок:  перескоков
транспортир:  транспортир
браковать:  бракуют
нехитрый:  нехитрые
разбегаться:  разбегаемся
трюк:  трюком
муавр:  муавра
рукопись:  рукописей
грязноватый:  грязновато
линейка:  линейкой
отделить:  отделить
опилка:  опилками
возводиться:  возводится
двучлен:  двучлена двучлен
заглавный:  заглавной
уехать:  уехал
прокрутка:  прокрутки
усвоиться:  усвоятся
ед:  ед
актуальный:  актуальна
строиться:  строится
намертво:  намертво
рубить:  рубить
рецензент:  рецензенты
незачёт:  незачета
напугать:  напугаете
подкоренной:  подкоренное
упасти:  упаси
пёстрый:  пёстрая
перестановочный:  перестановочно
забивание:  забивание
рассмешить:  рассмешу
перебор:  перебора перебор
представительный:  представительна
торт:  торте
колонка:  колонке
огива:  огива огивы
торговый:  торговую торговой
обработать:  обработать
инструкция:  инструкцию
гистограмма:  гистограмму гистограмме
заканчивать:  заканчиваете
ясный:  ясен
последующий:  последующей
обводить:  обводим
накопить:  накопленные
цена:  цены
размах:  размах
вписываться:  вписываются
дичь:  дичь
микрограмм:  микрограммами
ден:  ден
равноинтервальный:  равноинтервальную равноинтервальная
отстоять:  отстоит
навскидку:  навскидку
подсчитываться:  подсчитываются
константин:  константина
импровизированный:  импровизированной
дожить:  дожили
генеральный:  генеральная генеральных генеральное генеральной генеральную генерального
достоинство:  достоинством
черновой:  черновая
чай:  чая
ручной:  ручном
фёдор:  фёдора
предпосылка:  предпосылкой предпосылки предпосылка
партия:  партии
откладываться:  откладываются
экселя:  экселя
сурово:  сурово
вычеркнуть:  вычеркнуты
убийственно:  убийственно
овал:  овал
ширина:  ширине
указание:  указанием
подынтервал:  подынтервалы
массив:  массиву
подсчитывать:  подсчитываем
шкала:  шкала шкалу
замерять:  замерял
взвешивать:  взвешивал
ивр:  ивр
окидывать:  окидываем
бонус:  бонус
сверка:  сверки
пробегать:  пробегает
кумулять:  кумуляте
км:  км
кумулят:  кумулята кумуляты
ботинок:  ботинок
смерть:  смерти
недвижимость:  недвижимость
накопиться:  накопиться
относить:  относят
причислить:  причислить
притаиться:  притаилась
наслаждаться:  наслаждайтесь
разнообразить:  разнообразить
нарочно:  нарочно
тактика:  тактика
помидор:  помидоры
снять:  снять снимем
полигон:  полигон
терминатор:  терминатор
скорый:  скорых
выборочный:  выборочной выборочную выборочное выборочная
рекомендательный:  рекомендательный
молоко:  молока
ломаный:  ломаной ломаную
грамм:  грамм
стерджес:  стерджеса
путко:  путко
искажать:  искажая
свобода:  свобода свободу
критический:  критических
остаточный:  остаточной остаточная остаточную
кремера:  кремер
выброс:  выбросам выбросы
удовлетворительный:  удовлетворительным
судить:  судить
тенденция:  тенденцию
конспективный:  конспективно
отвергать:  отвергать отвергаем
однофакторный:  однофакторная однофакторной
аппроксимировать:  аппроксимирующую аппроксимирующей аппроксимирующая
взаимоуничтожиться:  взаимоуничтожатся
прозанудствовать:  прозанудствую
ннгасу:  ннгасу
факторный:  факторный факторную факторных факторной факторная
хаки:  хаки
иванов:  иванов
удовлетворительно:  удовлетворительно
прогуливать:  прогуливает
успеваемость:  успеваемости успеваемость
статистически:  статистически
отложить:  отложить отложите отложим отложу
чувствительный:  чувствительна
фишер:  фишера
нижегородский:  нижегородская
логичный:  логичным
надёжно:  надёжно
добавочный:  добавочным
неприличие:  неприличия
ключ:  ключ
юный:  юного
нарабатывать:  нарабатываем
соционометрика:  соционометрикой
конкурировать:  конкурирующей
закалить:  закалит
скользкий:  скользкую
причинный:  причинных
любимцев:  любимцева
предъявлять:  предъявляемые
диаграмма:  диаграммы диаграмме диаграмму
аппроксимация:  аппроксимация
польза:  пользу
визуально:  визуально
каки:  каки
необоснованно:  необоснованно
регрессионный:  регрессионные регрессионное регрессионная регрессионной
сопоставление:  сопоставление
синоним:  синонимы
неучтённый:  неучтёнными
сидоров:  сидоров
корреляционный:  корреляционный
попов:  попова
затрудняться:  затрудняюсь
достигать:  достигает
компромисс:  компромисса
чеддок:  чеддока
состав:  состав
прогул:  прогулы прогулов
елисеев:  елисеева
посредственно:  посредственно
рис:  рис
эконометрист:  эконометриста
любимец:  любимцев
теснота:  тесноту тесноты
ворота:  ворота
недавний:  недавний
объяснимый:  объяснимо
среднеожидаемый:  среднеожидаемое
подтвердиться:  подтвердилось
проверочка:  проверочка
дождаться:  дождаться
неудовлетворительно:  неудовлетворительно
реагировать:  реагируют
шапка:  шапке
крутиться:  крутятся
градация:  градация
суслик:  сусликов
диагональный:  диагональная диагональным диагональную диагональной
информативный:  информативная
косвенно:  косвенно
выпуск:  выпуске выпуска выпуском
интерполяция:  интерполяции
хаотично:  хаотично
оглавление:  оглавление
бананчик:  бананчики
выпускать:  выпускают
кг:  кг
монголия:  монголии
прорешанна:  прорешанной
наводить:  наводит
гипотетически:  гипотетически
экспертный:  экспертным
комплект:  комплект
вишенка:  вишенки
доброта:  доброты доброта
регрессивный:  регрессивно
откликаться:  откликается откликаются
детерминациия:  детерминациии
реалия:  реалиям
вяло:  вяло
травматизм:  травматизмом
падение:  падения
закоренелый:  закоренелых
утратить:  утратят
подтверждать:  подтверждает
весомость:  весомость
устремиться:  устремятся
пизанский:  пизанской
предприятие:  предприятии
факультативный:  факультативного
живо:  живо
прибыль:  прибыль прибылью прибыли
о:  обо
башня:  башни
закреплять:  закрепляющего
вертикаль:  вертикали
курица:  куриц
погодный:  погодные
репрезентативный:  репрезентативна
размножение:  размножение
гуманитарий:  гуманитариев
удостоиться:  удостоился
воспитание:  воспитание
отсылать:  отсылаю
руб:  руб
наращивать:  наращивая
гололёд:  гололед
симпатичный:  симпатичная
дтп:  дтп
попсовый:  попсовая
тощий:  тощих
млн:  млн
философский:  философская
дабы:  дабы
дёргать:  дёргаете
адаптировать:  адаптировать
светлый:  светлую
толстый:  толстых
злой:  злых
птицефабрика:  птицефабрике
учитываться:  учитываются
яйцо:  яиц
семёрка:  семерку
демонстрация:  демонстрация
опосредованно:  опосредованно
ассоциативный:  ассоциативные ассоциативным
безымянный:  безымянная
параллелограмм:  параллелограмм параллелограмма
жонглировать:  жонглировать
прилепить:  прилепить
крестик:  крестик
движуха:  движуху
антикоммутативность:  антикоммутативности антикоммутативностью
зазеркалье:  зазеркалья
клуб:  клуб
синь:  синей
почерпнуть:  почерпнуть
абстрактный:  абстрактны
тетраэдр:  тетраэдра
прочертить:  прочертить
пирамидка:  пирамидки
дистрибутивный:  дистрибутивные дистрибутивный
нетленный:  нетленные
совмещаться:  совмещаются
неизбежно:  неизбежно
заклинание:  заклинание
родиться:  родились
вылить:  выльют
ортогональность:  ортогональность
закидывать:  закидываем
выстроиться:  выстроились
понадобиться:  понадобится
паровозик:  паровозиком
лектор:  лектору
придирка:  придирку придирки
шарик:  шарик
невидимый:  невидимые
мизинец:  мизинец
косточка:  косточкам
дрова:  дров
параллелепипед:  параллелепипед
камин:  камина
закручивать:  закручивают
передел:  переделы
коллинеарность:  коллинеарность коллинеарности
уголёк:  угольки
огонь:  огни
борт:  бортом
конструкция:  конструкцию
маломальский:  маломальскую
съедать:  съедает
париться:  париться
распределительный:  распределительные
залезать:  залезаем
последствие:  последствия
нерабочий:  нерабочей
цэ:  цэ
буквоедство:  буквоедством
отсечь:  отсечён
отсюда:  отсюда
доработка:  доработкой
погружаться:  погружаться
разжигать:  разжигаем
буквоед:  буквоедов
отражённый:  отражённый
нижеприведённый:  нижеприведённая
молния:  молниями
подбросить:  подброшена
сверкать:  сверкают
подеваться:  подевалась
безпроблемный:  безпроблемно
некомпланарный:  некомпланарных
наркомания:  наркомания
ловко:  ловко
заново:  заново
номинальный:  номинальная
спрашиваться:  спрашиваться
буратино:  буратино
горизонт:  горизонте
поднести:  поднесите
сочетательный:  сочетательное
веселить:  веселящие
надуманный:  надуманный
горизонтальный:  горизонтальной
забивка:  забивка
оговорить:  оговорённом
вундеркинд:  вундеркиндов
неудачный:  неудачном
мыльный:  мыльная
положение:  положение
преобразоваться:  преобразуются
нормировать:  нормированный
конус:  конус
светить:  светить
инвариант:  инвариантов
торопить:  торопить
интересоваться:  интересующихся
регламентировать:  регламентируют
нормирование:  нормирование
ортогонализовать:  ортогонализовать
приобщиться:  приобщиться
параболический:  параболический параболического
выдерживаться:  выдерживалось
гиперболический:  гиперболическим
приемлемый:  приемлем
повернуть:  повернули
любопытно:  любопытно
конический:  конической
бесчисленный:  бесчисленным
банкет:  банкета
вика:  вики
ёщё:  ёщё
ипостась:  ипостаси
лагранж:  лагранжа
перпендикулярный:  перпендикулярны
поворачивать:  поворачивать
непригодный:  непригодна
ортогонализация:  ортогонализации
предпринять:  предпринятые
попарно:  попарно
нота:  ноте
фи:  фи
эллиптический:  эллиптическим
десятый:  десятый
лотерея:  лотерею лотереи лотерее
приз:  приз
удваиваться:  удваиваются
мальчик:  мальчик
мужчина:  мужчин мужчину
мухомор:  мухоморов
безопасность:  безопасность
интегральный:  интегральных интегральное
предсказать:  предсказать
препятствие:  препятствий
несмещённый:  несмещённые
тяжесть:  тяжести
комфорт:  комфорта
сбор:  сбора
спортсмен:  спортсмен
колода:  колоде колоды колоду
роща:  роще
смертность:  смертности
вырисовываться:  вырисовывается
серия:  серии
лес:  лес лесу
призовой:  призового
обуславливаться:  обуславливается
равновозможность:  равновозможность равновозможности
розыгрыш:  розыгрышей розыгрыши розыгрыше
спорт:  спорта
перестать:  перестанет
рождение:  рождения
европейский:  европейскому
провал:  провалы
блестящий:  блестящие
некраплёный:  некраплёной
девочка:  девочками
регион:  региона
граница:  границах
новорождённый:  новорожденных
обнаруживать:  обнаруживает
нечасто:  нечасто
выиграть:  выиграет
винтовка:  винтовкой
случаться:  случаться
неравновозможность:  неравновозможность
задний:  задней
непредсказуемый:  непредсказуем
посредством:  посредством
поляна:  поляна
женщина:  женщину женщин
заведение:  заведение
планироваться:  планируется
киношный:  киношная
узкий:  узком
психологический:  психологические
гриб:  грибы грибами
мудрый:  мудрый
сущий:  сущая
верхушка:  верхушка
производиться:  производится
подберёзовик:  подберёзовики подберёзовик
перемешать:  перемешанной
покрасить:  покрасить
треф:  трефа
спортивный:  спортивная
проигрываться:  проигрывается
зеро:  зеро
красочный:  красочные
брак:  брака
счастливчик:  счастливчика
упорный:  упорной
оценивать:  оценивать
слить:  сольёт
нестрогий:  нестрогое
телевизионный:  телевизионные
предугадать:  предугадать
продать:  продано
соревнование:  соревнованиями
казино:  казино
устойчивость:  устойчивости
маловозможный:  маловозможные
колебаться:  колеблется
наивероятный:  наивероятнейшего
отдать:  отдадут
стабильный:  стабильной
мелочь:  мелочь
эволюционно:  эволюционно
событияй:  событияи
спасать:  спасает
изготовление:  изготовления изготовление
байка:  байке
зарок:  зарок
каверзный:  каверзная
так:  т
преуменьшать:  преуменьшаю
прицелиться:  прицелился
айсберг:  айсберга
замаскироваться:  замаскировавшиеся
незначительно:  незначительно
грядущий:  грядущие
приблизительно:  приблизительно
сопоставимый:  сопоставимо
орлов:  орлов
профессионал:  профессионал
поубавить:  поубавить
системный:  системной
проведение:  проведения
выпустить:  выпущенных
превращаться:  превращается
пожертвовать:  пожертвовать
признать:  признать
организатор:  организатор
сеанс:  сеанса
масть:  масти
проживать:  проживает
многолетний:  многолетнего
младенец:  младенцев
разведчик:  разведчиков
проиграться:  проиграется
штирлиц:  штирлиц
придать:  придав
неполнота:  неполноты
фокус:  фокус
двухмерный:  двухмерного
ездить:  ездит
упор:  упор
отождествлять:  отождествлять
недра:  недр
гриф:  гриф
восемь:  восьми
яндекс:  яндекса
ребячество:  ребячество
поместить:  поместить
резиновый:  резиновые
прежний:  прежними
гвоздика:  гвоздиками
представитель:  представители
эксцентриситет:  эксцентриситетом эксцентриситета эксцентриситет
сунуть:  сунем
рефлекторно:  рефлекторно
неканонический:  неканоническая
розетка:  розетку
бытие:  бытия
вычерчивание:  вычерчивания
экшен:  экшена
порой:  порой
предвестник:  предвестник
настукать:  настукаем
пытливый:  пытливый
приспособление:  приспособления
маскарад:  маскараде
нитка:  нитка ниткой
привязать:  привязан
перенести:  перенесём
навстречу:  навстречу
изобрести:  изобрело
удалить:  удалили удалим удалив
модифицировать:  модифицировать
приколотить:  приколотите
элипёс:  элипса
напряжение:  напряжения
нести:  несет
вахтер:  вахтёр
воссоединиться:  воссоединились
проработка:  проработки
загадка:  загадок
выталкивать:  выталкивать
врач:  врачу
профиль:  профилю
экспозиция:  экспозиции
человечество:  человечество
шляпка:  шляпки
вооружиться:  вооружиться
эрудит:  эрудиты
девять:  девять
продолговатый:  продолговатый
сдвиг:  сдвиги
ватман:  ватман
загроможденность:  загроможденности
боковой:  боковым
говорильня:  говорильни
бодрый:  бодрое
разъезжаться:  разъезжаться
академический:  академический
нанизать:  нанизанную
упоминание:  упоминания
классификация:  классификация классификацию
уделяться:  уделяется
стресс:  стресса
складно:  складно
справляться:  справляются
развеять:  развеять
общепринятый:  общепринятого
обличие:  обличье
мышь:  мыши
живописный:  живописных
послать:  пошли
осуществимый:  осуществимо
канонически:  канонически
талант:  талантом
нить:  нитью
освежать:  освежая
акцентировать:  акцентирую
мистика:  мистику
галерея:  галерею
элебс:  элебса
встать:  встаньте
исследовательский:  исследовательского
смоделировать:  смоделируем
набросок:  набросок
оттянуть:  оттяните
эллибз:  эллибз
добывать:  добывать
матановский:  матановскому
потихоньку:  потихоньку
соединимый:  соединим
картон:  картона
разгрузка:  разгрузки
гвоздь:  гвоздей
готовить:  готовим
привязывать:  привязывать
экскурсия:  экскурсии
выбираться:  выбирается
реальность:  реальность
пользователь:  пользователей
прожить:  прожить
сосиска:  сосиску
переехать:  переехал
сплющиваться:  сплющиваться
эм:  эм
нажим:  нажим
бомонд:  бомонда
тонуть:  тонет
тождество:  тождество тождестве тождеств тождества
гемор:  гемор
резервировать:  резервируем
накопление:  накопления
будущий:  будущий
ухищрение:  ухищрения
подытоживать:  подытоживая
помучаться:  помучается
вышеперечисленный:  вышеперечисленные
нафаршировать:  нафаршированы
производить:  производим
свободно:  свободно
превращать:  превращаем
взлёт:  взлёт
четырехэтажность:  четырехэтажности
раздобыть:  раздобыть
заострять:  заостряю
избегать:  избегая
прибегать:  прибегать
линейность:  линейности
повышаться:  повышаться
снизиться:  снизятся
прерывать:  прерываем
отщипнуть:  отщипнули
повышение:  повышение
пропадать:  пропадает
дилемма:  дилемма
откусить:  откусить
разочаровать:  разочарую
содержаться:  содержится содержаться
специализироваться:  специализировался
эйфелевый:  эйфелевой
усвоить:  усвоили
телега:  телега
баллистика:  баллистикой
запустить:  запущен
наполеоновский:  наполеоновских
нетерпение:  нетерпением
величество:  величества
честь:  честь
вычурно:  вычурно
войско:  войск
поморочить:  поморочено
высечь:  высечен
несолидно:  несолидно
сентябрь:  сентября
фамилия:  фамилии
пересдавать:  пересдаете
бяка:  бяка
луи:  луи
скрестить:  скрестили
ядро:  ядра
лерон:  лерон
чётко:  чётко
доводить:  доводим
пушечный:  пушечные
бесповоротный:  бесповоротного
лето:  лето
поздравление:  поздравления
огюстен:  огюстен
краска:  красках
предельно:  предельно
штуковина:  штуковины
жан:  жан
устранять:  устраняем
праздник:  праздник праздника
закуска:  закуску
слукавить:  слукавил
халтура:  халтуру
трафаретный:  трафаретны
шпага:  шпаги
турбо:  турбо
ах:  ах
цепочка:  цепочка цепочкой
раскинуть:  раскинуть
хэ:  хэ
жаждать:  жаждали
аккорд:  аккордах
русский:  русский
контрапозиция:  контрапозиции
некорректно:  некорректно
дуб:  дубы дуб дубом
разночтение:  разночтений
перестановочность:  перестановочность
стройность:  стройности
проснуться:  проснуться
пожарный:  пожарный
затейливый:  затейливых
масляный:  масляное
равносильный:  равносильны
договориться:  договоримся
описывать:  описывает
банальный:  банальная
тожество:  тожество
преподнести:  преподнёс
грек:  греков
условиться:  условимся
коммутативность:  коммутативность коммутативностью коммутативности
усилить:  усилить
пренебрежение:  пренебрежение
антикоммутативный:  антикоммутативно
рекурсивный:  рекурсивным
отрицать:  отрицаем
предикат:  предикатов
заполнять:  заполняем
приписывать:  приписывать
муссироваться:  муссировался
фикция:  фикция
забегать:  забегая
оригинальный:  оригинальной
подогнать:  подогнать
формализм:  формализм
частица:  частицы
равносильность:  равносильности
идемпотентность:  идемпотентности
морган:  моргана
проговорить:  проговорите
неразличимый:  неразличимы
восприятие:  восприятие
несправедливый:  несправедливым
элементарность:  элементарности
поглощение:  поглощения
набор:  наборы
вовсю:  вовсю
растение:  растением растения растение
остроумный:  остроумная
общеобразовательный:  общеобразовательного
окраска:  окраску
ассоциативность:  ассоциативность
приоритет:  приоритет
вытрясти:  вытрясут
вперёд:  вперёд
озвучивать:  озвучивать
опускать:  опускать
занумеровать:  занумеровать
крохотный:  крохотным
тождественно:  тождественно
вход:  входе
объять:  объять
вслух:  вслух
пренебрежительно:  пренебрежительно
запасть:  запал
изъян:  изъян
красота:  красоты
силлогизм:  силлогизма
ограниваться:  огранивается
обсуждать:  обсуждали
прослеживаться:  прослеживается
равносильно:  равносильно
тьюринг:  тьюринга
напутствие:  напутствие
тожественный:  тожественно
психика:  психики
столь:  столь
масло:  масла
де:  де
тождественный:  тождественна тождественными
эмоциональный:  эмоциональную
заполнение:  заполнению
доктор:  доктором
погружение:  погружение
выпить:  выпил
здоровый:  здоровой
этический:  этических
скрепить:  скреплена
собственноручно:  собственноручно
некоммутативный:  некоммутативным
галочка:  галочками
дебиторский:  дебиторской дебиторская
самоконтроль:  самоконтроля
бездомный:  бездомные бездомный
грациозный:  грациозных
сортировать:  сортировать сортируем
задолженность:  задолженность задолженности
категория:  категории
невысокий:  невысокого невысокий
тянуть:  тянет
начислить:  начисленные начисленных
джексон:  джексон
ай:  ай
гармоничный:  гармонична
котосумма:  котосумма
сортировка:  сортировка
проблематично:  проблематично
вдумчиво:  вдумчиво
разделиться:  разделилось
котоведение:  котоведение
жи:  жи
нежёсткий:  нежёсткая
выдвинуть:  выдвинуть
домашний:  домашнего
статический:  статические
одинарный:  одинарным
дивиденд:  дивиденды дивидендов дивидендами
особь:  особей
кастрировать:  кастрировать
чужой:  чужих
вес:  веса вес весом
майкл:  майкл
экселевский:  экселевской
оцифровать:  оцифровать
навёрстывать:  навёрстываем
котэ:  котэ
глянуть:  гляньте
лицо:  лице
злиться:  злись
юридический:  юридические
совместно:  совместно
отрасль:  отрасли
стыковой:  стыковых
нежёсткость:  нежёсткость
жилищный:  жилищные
проблемный:  проблемным
убыток:  убытках
отступление:  отступление
желудок:  желудком
структурный:  структурная
выплата:  выплату
подгруппа:  подгруппы
вытаскивать:  вытаскиваем
отходить:  отходя
программирование:  программирования
забывчивость:  забывчивости
отличительный:  отличительных
развиваться:  развивается
идентифицировать:  идентифицирующие
писатель:  писателем
лихорадочно:  лихорадочно
косноязычный:  косноязычно
чебурашка:  чебурашке чебурашка
трансформироваться:  трансформируется
сказочный:  сказочный
скука:  скуки
интуиция:  интуиции
команда:  команда
приходящий:  приходящая
зубрёжка:  зубрёжке зубрёжки
перпендикулярно:  перпендикулярно
эдуард:  эдуардом
помереть:  померли
навсегда:  навсегда
иголка:  иголкой
осьминог:  осьминога
ухо:  ушами
касание:  касания
накладка:  накладки
отразить:  отражено
приобретать:  приобретает
соображаловка:  соображаловка
нормалик:  нормалик
радовать:  радовать
развлекать:  развлекать
допускаться:  допускается
шерсть:  шерстью
отвлечь:  отвлечённых
поправить:  поправить
персонаж:  персонаж
ингредиент:  ингредиенты
нежели:  нежели
осознавать:  осознавая
неточно:  неточно
избыточно:  избыточно
успенский:  успенским
зубрить:  зубрит
картонка:  картонка
однообразный:  однообразные
кривой:  криво
особенный:  особенного
позабыть:  позабыл
хедлайнер:  хедлайнером
исключаться:  исключаются
урокео:  урокео
усложняться:  усложняется
неловко:  неловко
упрямый:  упрямая
расстреливать:  расстреливаем
каламбур:  каламбур
уполовиниться:  уполовинился
цепляться:  цепляться
тахикардия:  тахикардия
скинуть:  скинем
переносить:  переносим
слеш:  слеша
автоматный:  автоматной
обсуждение:  обсуждение
выколоть:  выколотые
добиться:  добиться
дружка:  дружку
оккупировать:  оккупировал
жареный:  жареные
зарисовка:  зарисовки
запоминаться:  запоминаются
согласоваться:  согласуется
перефразировать:  перефразировано
хромать:  хромать
активный:  активное
пролёт:  пролёте
задействовать:  задействовать
сжаться:  сожмётся
станция:  станция
нога:  ноги
насторожиться:  насторожиться
погорячиться:  погорячился
заморочить:  заморочит
проставить:  проставил
разрешить:  разрешив
считалка:  считалку
прощать:  прощаю
продолжиться:  продолжилось
концерт:  концерта
нубова:  нубов
иллюзорный:  иллюзорен
клеточка:  клеточкам
царство:  царстве
каштан:  каштаны
визуальный:  визуальное
останавливаться:  останавливаться
мёртвый:  мёртвого
ужесточаться:  ужесточается
масштабировать:  масштабировать
энциклопедичность:  энциклопедичность
ка:  ка
участиться:  участились
фигурный:  фигурные
убиваться:  убиваться
реалистичный:  реалистичную
прелесть:  прелесть
комментировать:  комментировать
уныние:  уныние
подсказка:  подсказка
текущий:  текущего
раздаться:  раздался
поизвращаться:  поизвращаться
музыка:  музыка
мешаться:  мешалась
уверить:  уверены
звонок:  звонок
ночь:  ночи
наверх:  наверх
примениться:  применятся
трёхэтажный:  трехэтажная
последовать:  последовать
повергать:  повергает
перекидывать:  перекидываем
уловка:  уловок
компактно:  компактно
сладкий:  сладкая
палочка:  палочка
зверский:  зверский
вращаться:  вращается
мановение:  мановению
лекционный:  лекционный
дифференцироваться:  дифференцироваться
предвидеть:  предвижу
запомниться:  запомнятся
мгновенный:  мгновенный
листочек:  листочек
вежливый:  вежливый
навесить:  навесив
перерисовать:  перерисуйте
задумываться:  задумываться
развалить:  развалить
игнорировать:  игнорируем
монотонно:  монотонно
принадлежность:  принадлежность
пробить:  пробил
убывание:  убывание убывания убывании
холодно:  холодно
выяснение:  выяснения
составление:  составлении
надоесть:  надоела
повеситься:  повесился
отдышаться:  отдышавшись
временно:  временно
бесследно:  бесследно
отвлекаться:  отвлекаемся
ужас:  ужас ужаса
новизна:  новизна новизны
вознаграждение:  вознаграждения
рассказ:  рассказов
смех:  смех
позади:  позади
жаловать:  жаловать
длиннющий:  длиннющая
значить:  значило
вдаваться:  вдаваясь
покурить:  покурить
выделяться:  выделяется
сходить:  сходить
привлечь:  привлечь
особняком:  особняком
обилие:  обилия
вздыхать:  вздыхайте
наполнять:  наполнять
бояться:  боюсь
остроумно:  остроумно
баранов:  баранов
криминал:  криминала
доводиться:  доводится
молодожён:  молодожёнов
подкрасться:  подкрался
кончаться:  кончается
суметь:  сумеет
жирно:  жирно
нарушить:  нарушено
уныло:  уныло
задумка:  задумка
будничный:  будничную
ворваться:  ворвавшиеся
действовать:  действующим действовать
отличать:  отличать
послабление:  послабление
рвануть:  рванул
семилетний:  семилетней
упад:  упаду
существующий:  существующим
уберечь:  убережёт
поточечный:  поточечное поточечно
детализироваться:  детализируется
прицел:  прицел
оформиться:  оформится
выговорить:  выговорить
сообщать:  сообщает
строй:  строю
оторвать:  оторвать
близнец:  близнец
подряд:  подряд
грусть:  грусть
письмо:  письме письма
фихтенгольц:  фихтенгольц
минимальный:  минимальной минимальная
кирпичик:  кирпичика
ненавистник:  ненавистники
подразделяться:  подразделяются
прыгнуть:  прыгнула
фиксироваться:  фиксируется
добавка:  добавка
фото:  фото
автоматизм:  автоматизма
пошутить:  пошутить
рутинный:  рутинные
склеить:  склеить
повтор:  повтором
бычок:  бычок
прога:  проги
решающий:  решающую
давность:  давности
наказывать:  наказывает
прибегнуть:  прибегнем
поточный:  поточнее
перспектива:  перспективе
выплывать:  выплывает
уловить:  уловили
вразумительный:  вразумительной
ох:  ох
убивать:  убиваем
незаметно:  незаметно
основополагающий:  основополагающих
доска:  доску
прорисовать:  прорисовать
накапливать:  накапливает
затеряться:  затерялось
маньячить:  маньячить
косвенный:  косвенным
наименее:  наименее
реалистично:  реалистично
захватывать:  захватывающая
немедленный:  немедленной
правдоподобность:  правдоподобность
служить:  служат
борьба:  борьбе
смещение:  смещение
правдоподобный:  правдоподобным
дсв:  дсв
оцениваться:  оценивается
примечать:  примечал
удивляться:  удивляйтесь
опорный:  опорную
правдоподобно:  правдоподобно
чертёжом:  чертёжом
подтянуться:  подтянулся
подтверждение:  подтверждением
инструмент:  инструмент
вероятностный:  вероятностная
гуща:  гуще
предчувствие:  предчувствие
иллюзия:  иллюзия
жуткий:  жуткой
закономерно:  закономерно
боксёр:  боксёра
прорисоваться:  прорисовалась
возиться:  возиться
расширяться:  расширяется
неправда:  неправда
зачесть:  зачтено
ныне:  ныне
ничегошеньки:  ничегошеньки
вкратце:  вкратце
амуниция:  амуницией
серьёзность:  серьёзностью
переноситься:  переносятся
любоваться:  любуемся
голубой:  голубой
политика:  политика
воз:  воз
лебедь:  лебедь
жениться:  жениться
перестараться:  перестарался
прозаичный:  прозаичная
сузиться:  сузилась
щука:  щуки
двоечник:  двоечника двоечников
палитра:  палитру
рак:  рак
айса:  айс
сложённый:  сложены
сплошняк:  сплошняком
буквенный:  буквенных
словосочетание:  словосочетание
деваться:  деваться
мыслительный:  мыслительных
неформально:  неформально
луч:  лучи
лакомый:  лакомая
некуда:  некуда
пытка:  пыток
тянутый:  тянут
включая:  включая
штриховать:  штрихуем
гроза:  грозы
восстанавливать:  восстанавливаем
запаковать:  запаковать
хрень:  хрень
отбросить:  отбросим
ускорять:  ускоряет
предпочитать:  предпочитаю
мнение:  мнение
рассортировать:  рассортируем
восстанавливаться:  восстанавливается
держаться:  держитесь
предвещать:  предвещало
приняться:  примемся
варьировать:  варьируем
запугать:  запугать
цветочек:  цветочками
трахча:  трахча
расслабление:  расслабления
благодать:  благодать
предвзятый:  предвзятое
отход:  отходов
свалка:  свалку
мучительный:  мучительно
обнулять:  обнуляем
плавный:  плавного
умный:  умную
аист:  аист
позор:  позора
злоупотреблять:  злоупотреблял
покарать:  покарать
беспорядочный:  беспорядочным
кардать:  кардано
часы:  часы
перпендикуляр:  перпендикуляру
итерация:  итераций итерациями итерации
вшивость:  вшивость
ужесточиться:  ужесточилось
намёк:  намёк
старание:  старания
обеспечиваться:  обеспечивается
отделять:  отделяют
просканировать:  просканировать
проявить:  проявить
разнознаковый:  разнознакового разнознаковый
изолироваться:  изолируется
перетекать:  перетекать
наобум:  наобум
пересечь:  пересекла пересечёт
спасительный:  спасительного
щадить:  щадящая
схематичный:  схематичный
неуклонно:  неуклонно
прозванивать:  прозваниваем
звание:  звание
медленно:  медленно
завершиться:  завершилось
клиент:  клиент
семимильный:  семимильными
радикал:  радикалы
повыситься:  повысилось
парочка:  парочку
завершаться:  завершается
неиллюзорный:  неиллюзорно
шажок:  шажок
ответственный:  ответственный
солнышко:  солнышко
подниматься:  поднимаемся
воочию:  воочию
спустя:  спустя
высекать:  высекающий
склон:  склона склоне склону
биссектриса:  биссектрису биссектрисе биссектрисы
отыскиваться:  отыскиваются
забываться:  забывается
волнистый:  волнистые
ущелие:  ущелье
высмотреть:  высмотреть
крутой:  крутое
местность:  местность
взгрустнуться:  взгрустнулось
сонаправить:  сонаправлены сонаправлен сонаправленными
мутноватый:  мутноватая
нумероваться:  нумеруются
полчаса:  полчаса
призвать:  призвана
эстетический:  эстетическому
квартира:  квартире
подъём:  подъемов подъёма подъёмах подъемом подъёмом подъём
ненадолго:  ненадолго
кошмарный:  кошмарном
молодец:  молодцы
убедительно:  убедительно
без:  безо
пол:  пол
гора:  горами
слой:  слоем
крутизна:  крутизны
описание:  описанию
майский:  майское
экскурс:  экскурса
череда:  черёд
ландшафт:  ландшафт ландшафте
зависнуть:  зависло
покинуть:  покинуть
переключаться:  переключаемся
походить:  походим
спрятаться:  спрятались
спокойствие:  спокойствие
равнина:  равнина
божий:  божий
безмятежно:  безмятежно
гаджет:  гаджетов
сосредоточенно:  сосредоточенно
осмотреться:  осмотритесь
геодезия:  геодезии
взвыть:  взвыть
размяться:  разомнёмся
прозевать:  прозевать
повышеный:  повышеное
умещаться:  умещается
ориентировочный:  ориентировочный
осилить:  осилить
переместиться:  переместитесь
употребление:  употреблению
приободрить:  приободрю
скала:  скала
негоризонтальный:  негоризонтальная
тычок:  тычка
естествоиспытатель:  естествоиспытатели
пригревать:  пригревает
охарактеризовать:  охарактеризовать
изменчивый:  изменчива
душный:  душные
рельеф:  рельеф
инструментарий:  инструментария
наступать:  наступает
температура:  температуры
встроить:  встроил
извращаться:  извращаться
расслабляться:  расслабляться
упущение:  упущением
молчание:  молчание
холм:  холма
недопонять:  недопонятым
традиционно:  традиционно
ответственность:  ответственность
запрашивать:  запрашивать
полог:  полога
чудесный:  чудесным
бета:  бетой
вкладываться:  вкладывается
наклонный:  наклонен
одуванчик:  одуванчик
передвигаться:  передвигались
исконно:  исконно
сверять:  сверять
вредный:  вредно
лазерный:  лазерный лазерную лазерным лазерная лазерной
мелок:  мелком
цилиндрический:  цилиндрической
переносица:  переносицу
деканат:  деканате
добавиться:  добавится
вынужденный:  вынужденным
сканирование:  сканирование
незавидный:  незавиден
брус:  бруса
весомый:  весомым
веник:  веник
обнаружиться:  обнаружатся
сферический:  сферических сферическая
удосужиться:  удосужился
сбоку:  сбоку
трёхгранный:  трёхгранном
замыкать:  замыкает
вырезать:  вырезаю
обернуть:  обернули
передышка:  передышку
словесный:  словесным
утыкаться:  утыкается
осваиваться:  осваивается
кольцо:  кольцо
письменно:  письменно
труп:  труп
очевидность:  очевидность
прочесть:  прочесть
избыточность:  избыточность
опасаться:  опасаться
параболоид:  параболоидом
ракурс:  ракурса
рассекать:  рассекает
чаша:  чаша
фонарик:  фонарик
воронка:  воронку
озаглавить:  озаглавить
обходить:  обходим
молитва:  молитвы
внутренность:  внутренность
склоняться:  склоняетесь
сканировать:  сканируем
начеку:  начеку
штаны:  штаны
приуныть:  приуныли
покойник:  покойник
забраковать:  забракуют
грозить:  грозит
сегмент:  сегментами
бакс:  баксов
полусфера:  полусферу
сахар:  сахар
просвечивать:  просвечиваем
выручать:  выручает
письменный:  письменный письменные
одетый:  одетый
томик:  томик
сжить:  сжил
поучительный:  поучительны
выдержать:  выдержала
ювелирный:  ювелирная
лазер:  лазером лазера
оттяпать:  оттяпает
накрыть:  накроет
выигрышный:  выигрышный
наметить:  наметить
расставлять:  расставлять
указка:  указка указкой указку
дальний:  дальнее
нахал:  нахал
вмещать:  вмещает
вместиться:  вместятся
несведущий:  несведущий
срезать:  срезали
прутик:  прутикам
перспективный:  перспективнее
бодаться:  бодался
изнутри:  изнутри
ограниченно:  ограниченно
коммент:  комментов
малополезный:  малополезная
добротный:  добротный
укрепляться:  укрепляемся
лимит:  лимитов
операторный:  операторное
довесок:  довесок
самовар:  самоваром
распространение:  распространение
прожечь:  прожженному
вогнутость:  вогнутость
продвинуть:  продвинул
небоскрёб:  небоскрёба
угорелый:  угорелых
штабель:  штабелем
поверхностно:  поверхностно
гипергеометрический:  гипергеометрическое
численный:  численным
кликать:  кликаем
фанат:  фанатов
вручать:  вручаю
подраздел:  подразделу
градиентный:  градиентное
однократный:  однократные
заштатный:  заштатными
спускаться:  спускаемся
ласточка:  ласточки
ненавязчивый:  ненавязчиво
пск:  пск
рубикон:  рубикон
примечательный:  примечательного
лифт:  лифте
разгром:  разгром
тельняшка:  тельняшках
тотальный:  тотальный
слу:  слу
мобильный:  мобильной мобильных
песочница:  песочница
дверь:  дверь
воля:  волею
аз:  азы
мегапопулярный:  мегапопулярный
гордость:  гордости
кладовка:  кладовка
вручную:  вручную
технарь:  технарей
вместить:  вместить
организационный:  организационный
каска:  каски
просыпаться:  просыпаться
суточный:  суточная суточной суточную
анатомия:  анатомию
способный:  способны
стоимость:  стоимость стоимости стоимостью
спрогнозировать:  спрогнозировать спрогнозируем
переработка:  переработку переработка переработки
млрд:  млрд
неэффективно:  неэффективно
тыква:  тыква
простаивать:  простаивать
двухфакторный:  двухфакторной
ранговый:  ранговой
вздрагивать:  вздрагивать
насыщать:  насыщаю
непреложный:  непреложным
изображать:  изображать
сырьё:  сырья
центнер:  центнеров
материализоваться:  материализовалась
ц:  ц
несгруппированный:  несгруппированных
вещий:  вещих
маска:  маски
тыс:  тыс
экспоненциальный:  экспоненциальному экспоненциальным
переработать:  переработать
производство:  производство производства производстве
далековато:  далековато
прикинуть:  прикинув
систематически:  систематически
украсть:  украл украла
носиться:  носятся
полугодие:  полугодие полугодии
дозировка:  дозировке
нора:  норах
обкатать:  обкатан
клара:  клара клары
разнородный:  разнородные
некрасиво:  некрасиво
перцентиль:  перцентили
сместить:  смещённую
бишь:  бишь
осмысленно:  осмысленно
отъедаться:  отъедаются
размеренный:  размеренной
заботливо:  заботливо
неоднократный:  неоднократные
стальной:  стальных
круто:  круто
мощность:  мощностями
хомяк:  хомяков хомяки
худощавый:  худощавых
кочка:  кочкой
недалеко:  недалеко
сформировать:  сформированного
упитанный:  упитанных
эксцесс:  эксцесс
квартиль:  квартили
среднемесячный:  среднемесячный
среднеквадратический:  среднеквадратическим
карл:  карл
некого:  некому
терапевтический:  терапевтической
коралл:  кораллы
разбрасываться:  разбрасываться
однотипный:  однотипны
конский:  конской
голодуха:  голодухи
кларнет:  кларнет
закрытие:  закрытия
намекать:  намекает
сбалансированный:  сбалансированном
промышленный:  промышленную
дециль:  децили
тематика:  тематику
домысел:  домыслами
карла:  карла
сбербанк:  сбербанке
критически:  критически
декабрь:  декабря
охотник:  охотником
сдаться:  сдамся
разрешение:  разрешения
красивший:  красивше
сориентировать:  сориентировать
победитель:  победителя
мерзлота:  мерзлоте
упаковывание:  упаковывание
обыденный:  обыденна
цивилизация:  цивилизации
летописец:  летописцы
клинопись:  клинописью
уютный:  уютно
майя:  майя
работёнка:  работёнки
солнцестояние:  солнцестояния
сохраниться:  сохранившийся
расплодить:  распложена
расшифровать:  расшифруют
армагеддон:  армагеддон
партизан:  партизан
откопать:  откопают
календарь:  календарь
глядеть:  глядишь
шаман:  шаманом
находка:  находкой
тибетский:  тибетские
вагон:  вагоне
залечь:  залёг
тишина:  тишину
финиш:  финиш
монах:  монахи
трафарет:  трафарет
безболезненно:  безболезненно
приглянуться:  приглянулась
популярность:  популярность
ощущение:  ощущение
специфический:  специфической
упроститься:  упростился
сознательно:  сознательно
мысленный:  мысленное мысленный
прервать:  прервали
надстрочный:  надстрочную
нормально:  нормально
дружба:  дружба
орех:  орехи
халявный:  халявная
актуально:  актуально
наладить:  налажена
вышерассмотреть:  вышерассмотренный
клетка:  клетки
копироваться:  копируются
вёрд:  вёрд
сосед:  сосед
прослезиться:  прослезился
тетрадный:  тетрадные
профессор:  профессору
заканчиваться:  заканчивается
ступенька:  ступенькой
разорвать:  разорвать
несчётный:  несчётного
клин:  клином
звезда:  звёзды
десяток:  десятка
плясать:  плясать
незадача:  незадача
заготовка:  заготовку
головоломный:  головоломно
крепкий:  крепкие
невнимательно:  невнимательно
ошибочка:  ошибочка
несущественный:  несущественный
изначальный:  изначальная
орешек:  орешки
выжить:  выживших
печальный:  печальную
расплата:  расплата
канитель:  канители
предостаточно:  предостаточно
пыонёр:  пыонеры
страшно:  страшно
запутанный:  запутаннее
выписывать:  выписываем
исправимый:  исправим
заяц:  зайцев
неприступный:  неприступного
выслеживать:  выслеживают
мутный:  мутным
волк:  волк волки
африканский:  африканском
попытка:  попытка
неведомый:  неведомые
вдохновение:  вдохновения
добыча:  добычу
рааба:  раабе
предупреждать:  предупреждал
маскироваться:  маскируется
бесполезность:  бесполезности
вывернуться:  вывернуться
ура:  ура
восклицательный:  восклицательным
абель:  абеля
арсенал:  арсенала
мучаться:  мучаться
навороченность:  навороченности
марать:  марать
легально:  легально
сочный:  сочная
злоключение:  злоключений
зверь:  звери
дикобраз:  дикобразов
прозрачность:  прозрачности
отбрасываться:  отбрасываются
траурный:  траурное
цитата:  цитата
набитый:  набит
врубиться:  врубился
дикий:  диких дикой
сафари:  сафари
картиночка:  картиночки
хрен:  хрена
отбрасывание:  отбрасывание
воспроизводить:  воспроизвожу
немножечко:  немножечко
надежда:  надежд
пылиться:  пылится
тигр:  тиграм тигр
обсуждаться:  обсуждалось
перед:  передо
видоизменить:  видоизменить
затмение:  затмение
упорно:  упорно
гранатомёт:  гранатомёт
верёвка:  верёвку
обитатель:  обитателей
саванна:  саванны
доставлять:  доставляют
отчаяние:  отчаянии
шкура:  шкуру
разведка:  разведку
бинокль:  бинокль
желательный:  желательна
объектив:  объективом
соблазн:  соблазном
эпический:  эпический
происшествие:  происшествия
бесполезно:  бесполезно
обманывать:  обманывать
туго:  туго
неограниченно:  неограниченно
проникнуться:  прониклись
зверушка:  зверушки
устоять:  устоять
намылить:  намыленную
формальность:  формальности
непотопляемый:  непотопляемый
перо:  перьях
пошерстить:  пошерстив
зачётка:  зачётку
доставаться:  достаётся
трёхходовой:  трёхходовое
двухходовый:  двухходовое
виновато:  виновато
тарабарщина:  тарабарщиной
худой:  худой
вынос:  выносом
гулять:  гуляют
увлечение:  увлечением
леопард:  леопард леопарды
стадо:  стадо
мягко:  мягко
народный:  народная
замаячить:  замаячило
покорить:  покорить
забраться:  забрались
осмотр:  осмотр
накручивать:  накручивает
слонёнок:  слонёнок
незабываемый:  незабываемое
нацедить:  нацедили
трофейный:  трофейную
идентичный:  идентичного
немыслимый:  немыслимым
планирование:  планирования
африка:  африку
тамбовский:  тамбовского
размахивать:  размахивающий
уйма:  уйма
хищник:  хищник
психовать:  психуй
затык:  затык
бессильный:  бессилен
бессонный:  бессонные
раскалываться:  раскалываются
антилопа:  антилоп
куст:  кустах
скромный:  скромным
корм:  корм
ходьба:  ходьба
удивиться:  удивился
бармалей:  бармалей
невзначай:  невзначай
отлынивать:  отлынивать
камера:  камеры
стирлинг:  стирлинга
хобот:  хоботом
двухходовка:  двухходовку
фига:  фиг
невыполнение:  невыполнение
фрактал:  фракталах
кочегаров:  кочегаров
хвостатый:  хвостатые
совершенство:  совершенству
усовершенствование:  усовершенствования
двукратный:  двукратного
победный:  победного победный
толика:  толику
оффтоп:  оффтоп
китаец:  китайцев
приветливо:  приветливо
немецкий:  немецкие
квадратик:  квадратики квадратиков
поражаться:  поражаюсь
узловой:  узловых
ловить:  ловите
количественный:  количественное
накапливаться:  накапливаться
спрямить:  спрямить
дифф:  дифф
подъёмный:  подъёмная
посерединка:  посерединке
усовершенствовать:  усовершенствованного усовершенствованный
мотивация:  мотивацию
нанять:  наняли
поправимый:  поправимо
распахнуться:  распахнутся
скучноватый:  скучноватую
подровнять:  подровнял
леонард:  леонарда
прозвучать:  прозвучало
сымитировать:  сымитировать
спрямляемость:  спрямляемость
запрограммировать:  запрограммируете
удаваться:  удаётся
разумно:  разумно
феникс:  феникс
вынудить:  вынужден
оприходовать:  оприходуем
однозначность:  однозначности
искусить:  искушенные
увлекаться:  увлекаться
изменять:  изменять
заесть:  заест
отвращение:  отвращении
удостовериться:  удостовериться
векторыфундаментальный:  векторыфундаментальной
репродукция:  репродукции
коварство:  коварство
кривоватый:  кривоват
выставить:  выставлен
малина:  малина
захлопывать:  захлопывают
назреть:  назрел
солдат:  солдатом
годный:  годен
перекос:  перекоса перекос
неосуществимый:  неосуществимо
отображаться:  отображается
чувство:  чувством
проскочить:  проскочили
воодушевиться:  воодушевился
принудительно:  принудительно
оный:  оная
выявиться:  выявилась
ловкий:  ловкие
притормозить:  притормозим
интуитивный:  интуитивная
наблюдатель:  наблюдатели
эстетичный:  эстетичнее
кратность:  кратность
подобие:  подобия
недобор:  недобор
четырёхмерный:  четырехмерном четырёхмерная четырехмерное четырехмерному
маскхалат:  маскхалатах
возродиться:  возродился
нестандартно:  нестандартно
машинально:  машинально
скупой:  скуп
мытарство:  мытарства
положим:  положим
добиваться:  добиваться
удаление:  удалении
застопориться:  застопорилось
вкурить:  вкурить
корректность:  корректность
недиагональный:  недиагональную
доводка:  доводка
психотерапевтический:  психотерапевтических
авторизация:  авторизации
отключить:  отключите
издать:  издана
аська:  аськи
продаваться:  продаётся
небрежный:  небрежное
заблокировать:  заблокирован
гарантия:  гарантию
сотовый:  сотовый
дежавю:  дежавю
сотрудничество:  сотрудничеством сотрудничество сотрудничества
денья:  денья
благодарный:  благодарен
хостинг:  хостинге
пароль:  пароля
перезагрузить:  перезагрузите
восприниматься:  воспринимаются
исправляться:  исправляются
почта:  почте
обмен:  обмена
совершенствоваться:  совершенствуется
размещать:  размещать
обозримый:  обозримом
плагин:  плагине плагин
троллинг:  троллинг
восполнить:  восполнить
обновляться:  обновляется
обновить:  обновите
сообщение:  сообщениями сообщение
браузер:  браузере браузеров
конвертировать:  конвертируйте
переписка:  переписке
служебный:  служебной
провайдер:  провайдера
обновление:  обновлениями
расцениваться:  расцениваются
обида:  обид
удалённый:  удалён
норма:  норма
перегруженность:  перегруженностью
исправление:  исправления
личка:  личку
общение:  общения общению
заблаговременно:  заблаговременно
аккаунт:  аккаунт
неадекват:  неадекват
перенаправить:  перенаправлены
электронный:  электронном
новичок:  новичок
корзина:  корзину
адресат:  адресатов
отклонить:  отклонил
безразличие:  безразличием
собачка:  собачка
телефон:  телефон
возврат:  возврат
администрирование:  администрирования
сомнительный:  сомнительную
выходной:  выходные
почтовый:  почтовый почтовом
просмотр:  просмотра
праздничный:  праздничные
скайп:  скайпа
адоба:  адоба
зарегистрироваться:  зарегистрируйтесь
спам:  спам
весить:  весит
отвлекать:  отвлекают
платный:  платный
коллектив:  коллективы
нарушение:  нарушение
хостер:  хостера
месяц:  месяца
загрузка:  загрузкой
пост:  пост
дизайнер:  дизайнера
вплоть:  вплоть
скроить:  скрою
задержка:  задержки
шустрый:  шустрее
неэтичный:  неэтичного
грузиться:  грузится
прикидка:  прикидки
умеренный:  умеренная
модальный:  модальными модальный модального модальных модальное
скосить:  скошено
приять:  приятый
скошенность:  скошенности
асимметричный:  асимметрично асимметричен
сие:  сего
идеальный:  идеальный
пологий:  пологим
выразиться:  выразиться
близость:  близости
редактор:  редакторе
томить:  томить
скос:  скос
аналитика:  аналитика
островершинный:  островершинным
периферия:  периферию
крыша:  крыши
вытянутый:  вытянута
отправной:  отправную
разметить:  разметим
тематически:  тематически
подать:  подан
незначительный:  незначительна
медианный:  медианный медианное медианного медианным
удлинённый:  удлинённым
эксекас:  эксекас
замолвить:  замолвим
эксперимент:  эксперимента
пиджак:  пиджаков пиджак пиджаке пиджаки
затрата:  затрат
бухгалтер:  бухгалтер
иксовой:  иксовое
двухпуговичный:  двухпуговичные
тематичный:  тематичная
планка:  планку
переслать:  перешли
разориться:  разорится
усмотреть:  усмотреть
возмущение:  возмущение
общественность:  общественности
описка:  описка
фрейд:  фрейду
зарабатывать:  зарабатывает
заработный:  заработную
диапазон:  диапазона
больница:  больнице
цех:  цеха цехе
плата:  плату
первичный:  первичным первичные первичных
броситься:  бросился
искажённый:  искажённая
квалификационный:  квалификационные
укрупнять:  укрупняем
персонал:  персонал
петровский:  петровского
упороть:  упоротых
любительски:  любительски
забитый:  забиты
среднестатистический:  среднестатистический
мышка:  мышкой
экселевскома:  экселевском
занудничать:  занудничать
отсчитывать:  отсчитывать
додумывать:  додумывать
пускаться:  пускается
переваливать:  переваливает
модный:  модная
фабрика:  фабрику
универмаг:  универмаге
перевалить:  перевалила
цивилизовать:  цивилизованная
кучковаться:  кучкуются
специализированный:  специализированных
депеша:  депеш
директор:  директора
углядеть:  углядят
зоркий:  зоркие
ранжировать:  ранжированного
зарплата:  зарплата
мина:  мин
отуплять:  отупляют
дробить:  дробят
необработанный:  необработанные
руководящий:  руководящий
обработка:  обработка
мыший:  мышью
шляпа:  шляпы
туманность:  туманность
помолодеть:  помолодеет
минковский:  минковского
викторина:  викториной викторины
житейский:  житейский
неподвластный:  неподвластные
необратимый:  необратимо
викторин:  викторину
всевозможный:  всевозможных
фантастический:  фантастические фантастических
прошлое:  прошлое
взбодрить:  взбодрю
непротиворечивый:  непротиворечиво
составитель:  составители
обязанность:  обязанности
тарелка:  тарелку
химический:  химического
гадать:  гадать
термодинамика:  термодинамики
нешуточный:  нешуточный
видеозапись:  видеозаписи
лоренц:  лоренца
пятимерный:  пятимерном пятимерное
кофейный:  кофейной
десятимерный:  десятимерном
походка:  походкой
необратимость:  необратимости
аксиоматика:  аксиоматика
садиться:  садиться
инопланетянин:  инопланетяне инопланетянах
выдумка:  выдумка
управляться:  управляться
нобелевский:  нобелевский нобелевская
домой:  домой
грозный:  грозному
комитет:  комитет
гуманоид:  гуманоидов
поверить:  поверите
нормалёк:  нормалёк
подкрепить:  подкрепленное
сиё:  сиё
царь:  царя
гадалка:  гадалок
троечник:  троечника
выпалить:  выпали
однонаправить:  однонаправлено
эйнштейн:  эйнштейна эйнштейном
прошлый:  прошлом
диплом:  дипломом
лобачевский:  лобачевского
фантастика:  фантастикой
орган:  органы
скомпилировать:  скомпилированная
устрашение:  устрашения
наполовину:  наполовину
чушь:  чушь чушью
компакт:  компакт
полететь:  полетели
расстраиваться:  расстраивайтесь
энтропия:  энтропии
прядка:  прядка
довод:  довод
бред:  бредом
опровергнуть:  опровергла
экстрасенс:  экстрасенсов
естественнонаучный:  естественнонаучного
бассейн:  бассейн
скандал:  скандал
фм:  фм
гиперповерхность:  гиперповерхность гиперповерхности
многомерный:  многомерном
атмосферный:  атмосферное
гуд:  гуд
пуанкара:  пуанкаре
комедия:  комедия
странный:  странный
василиевич:  васильевич
благообразный:  благообразно
землянин:  землян
общаться:  общались
давление:  давление
разум:  разуму
относительность:  относительности
ку:  ку
пиар:  пиар
загрузиться:  загрузился
чайниковский:  чайниковский
заслуга:  заслугу
предсказание:  предсказания
андромеда:  андромеды
открутить:  открутить
абсурд:  абсурд
вселенная:  вселенной
незатейливый:  незатейливо
ползать:  ползал
секущий:  секущая секущей секущую
уяснить:  уяснить
десятиметровый:  десятиметровом
альпинистский:  альпинистское
пьянка:  пьянка
холмистый:  холмистому
молодой:  молодого
повлечь:  повлекло
глагол:  глагол
детальный:  детальной
оттачиваться:  оттачивается
измерительный:  измерительного
горка:  горку горки
дюжина:  дюжина
уклон:  уклон
доставать:  достаёт
преодолевать:  преодолеваем
топографический:  топографической
пология:  пологий
эксплуатироваться:  эксплуатироваться
идеально:  идеально
гранит:  гранита
взмывать:  взмывает
откинуть:  откинем
примерять:  примерять
двигать:  двигаем двигая
оное:  оного
миновать:  минуя
автобан:  автобану
семантика:  семантики
прямолинейный:  прямолинейным
навигатор:  навигатор
снимка:  снимок
реферат:  реферата
низина:  низинах
убыль:  убыль
завести:  завела
прилежащий:  прилежащему
механический:  механический
забираться:  забираемся
отсрочить:  отсрочить
петлять:  петлять
ничтожно:  ничтожно
печалька:  печалька
матан:  матан
одежда:  одежду
происхождение:  происхождение
послание:  послание
магистраль:  магистрали
лягушка:  лягушками
противоход:  противоход
суд:  суда
финн:  финнами
квакать:  квакающими
противолежащий:  противолежащего
достигаемый:  достигаем
засечка:  засечек засечки
животворящий:  животворящий
овраг:  оврага
экстремаленький:  экстремалы
насмотреться:  насмотревшиеся
прагматичный:  прагматичен
истолковывать:  истолковывает
скептик:  скептики
подобраться:  подобрались
шоссе:  шоссе
спуск:  спусках спуск
повременить:  повременить
поглощать:  поглощать
тетрадка:  тетрадку
наткнуться:  наткнуться
дотянуться:  дотянется
чертёжить:  чертёжа
закачиваться:  закачивается
предпочтение:  предпочтения
безоблачный:  безоблачно
нехорошесть:  нехорошести
цельный:  цельный
приложимый:  приложим
насыщение:  насыщение
формализовать:  формализовать
зашифровать:  зашифрованное
ускорение:  ускорение
недурно:  недурно
дифференцируемость:  дифференцируемость дифференцируемости
уместиться:  уместится
двояко:  двояко
отвесный:  отвесным
спутниковый:  спутниковый
опубликовать:  опубликовал
беречь:  берегите
сабж:  сабжу
снаряжение:  снаряжение
потребитель:  потребителей
горнолыжный:  горнолыжный
ознакомление:  ознакомления
парить:  парящими
полоса:  полоса
гроссмейстерский:  гроссмейстерский
каёмочка:  каёмочкой
зю:  зю
обыватель:  обывателя
испытывать:  испытывает испытывают
шахматы:  шахматы
пиво:  пиву
блюдечко:  блюдечке
жёлудь:  желудей
проинтегрироваться:  проинтегрировалось
неловкость:  неловкости
поэтапно:  поэтапно
сверхсложный:  сверхсложного
невозможо:  невозможо
пить:  пил
шоть:  шото
вслепую:  вслепую
каноничность:  каноничность
туговато:  туговато
причудливый:  причудливая
разъяснение:  разъяснения
обнадёжить:  обнадёжу
крепко:  крепко
просветить:  просветить
претензия:  претензией
ощутить:  ощутите
присказка:  присказка
сжатый:  сжатые
наполнить:  наполним
архимед:  архимед
пивной:  пивной
древнегреческий:  древнегреческого
учёный:  учёного
сетка:  сетку
тара:  тару
земля:  землю
загонять:  загоняют
утомлённый:  утомлённом
возрасти:  возрастёт
четвертинка:  четвертинку
навести:  наведём
опора:  опоры
разрядиться:  разрядились
жестяной:  жестяная
загромоздить:  загромождённой
прочтение:  прочтение
первоочередной:  первоочередное
индийский:  индийских
сетовать:  сетовали
терпеливый:  терпелив
удовлетворение:  удовлетворения
пена:  пены
подождать:  подожду
платиновый:  платиновое
серебряный:  серебряное
свежеть:  свежей
прибыть:  прибывшим
физически:  физически
крышка:  крышки
моральный:  морального
шнобелевский:  шнобелевская
мешок:  мешок
бумажка:  бумажка
кошмар:  кошмары
рычаг:  рычага
испариться:  испарилась
эпицентр:  эпицентре
зарезервировать:  зарезервировано
расправа:  расправу
состояние:  состоянии
неважный:  неважное
полагание:  полагание
определённо:  определённо
продовольственный:  продовольственного продовольственные
тьмущий:  тьмущая
выравнивание:  выравнивание
шпионаж:  шпионажа
решиться:  решиться
путёвка:  путёвку
бубен:  бубном
стопроцентно:  стопроцентно
разыскивать:  разыскиваем
активировать:  активируем
сопутствовать:  сопутствующий
коммерческий:  коммерческого
выявляться:  выявляются
критично:  критично
разваливать:  разваливаем
социологический:  социологических
частично:  частично
тренд:  тренда тренду тренд тренде
розыск:  розыска
товарооборот:  товарообороте товарооборот товарооборота
адекватно:  адекватно
претендент:  претендент
прогнозировать:  прогнозировать
минимально:  минимально
годовой:  годовой
сопоставлять:  сопоставляя
экспериментальный:  экспериментальными экспериментальных экспериментальные
биология:  биология
прогноз:  прогнозом прогноз
разрешаться:  разрешается
элитный:  элитный
стационарный:  стационарную
магазинный:  магазинные
свершиться:  свершилось
предметный:  предметной
напечатать:  напечатал
июль:  июль
секретный:  секретным
гастроном:  гастрономами
передумать:  передумал
опция:  опцию
пожелать:  пожелаю
основываться:  основываться
раздать:  раздать
американский:  американский
психология:  психология
гречка:  гречку
розничный:  розничном
социология:  социология
прологарифмировать:  прологарифмируем
видеоматериал:  видеоматериалы
экселевским:  экселевским
безликий:  безликая
видение:  видения
полуобщий:  полуобщем
забористый:  забористые
рецензировать:  рецензировать
неторопливо:  неторопливо
гроб:  гроб
урезанный:  урезанный
усложниться:  усложнится
сведущий:  сведущему
усваивать:  усваиваемый
жужжать:  жужжащий
округлый:  округлой
предъявить:  предъявить
разнокалиберный:  разнокалиберными
транзитный:  транзитные
озадачить:  озадачит
варварство:  варварства
жаркий:  жаркую
пучина:  пучины
довестись:  доведётся
вкладыш:  вкладыши вкладыш вкладышей вкладыша вкладышах
удлиняться:  удлиняются
подшифровать:  подшифровать
шмель:  шмеля шмелях
бюджетный:  бюджетным
спасательный:  спасательный
мохнатый:  мохнатыми
вразнос:  вразнос
ограничиваться:  ограничивается
первоклассник:  первоклассник
невообразимый:  невообразимо
символически:  символически
замешательство:  замешательство
думаться:  думается
попутаться:  попутаетесь
поэкспериментировать:  поэкспериментируйте
причесать:  причесать
колёсико:  колёсиках
придраться:  придраться
безжалостно:  безжалостно
косметика:  косметика
нагромождение:  нагромождения
довольный:  доволен
цвета:  цветами
варварский:  варварском
олимпиадный:  олимпиадным
кулачок:  кулачками
аннотация:  аннотации
стольник:  стольника
разборчиво:  разборчиво
выставлять:  выставлять
преподносить:  преподношу
рада:  рады
подборка:  подборке
лень:  лень
потрясать:  потрясая
седьмой:  седьмой
нищебродский:  нищебродские
канун:  канун
вар:  вар
нос:  носу
расчёткий:  расчётка
сбыться:  сбылась
обладатель:  обладателей
грудь:  грудью
ооо:  ооо
мегараздача:  мегараздачу
спрос:  спрос
энергично:  энергично
увесистый:  увесистый
необъятный:  необъятное
дёшево:  дёшево
открываться:  открывается
бэтмена:  бэтмен
процитировать:  процитировал
конструировать:  конструировать
прорисовывать:  прорисовывают
перевариться:  переварится
раскидывать:  раскидывать
прятаться:  прячется
байконур:  байконур
узнавать:  узнаёте
наглеца:  наглеца
пессимист:  пессимисты
пижонски:  пижонски
протянуть:  протянуть
вели:  вели
сервант:  серванте
выуживание:  выуживанием
бродить:  бродят
воображение:  воображение
стог:  стог
перпендикулярность:  перпендикулярности
кошечка:  кошечку
посматривать:  посматривайте
завуалировать:  завуалировать
тиражироваться:  тиражируется
наштамповать:  наштампует
двухгранный:  двухгранных
покрутить:  покрутить
космодром:  космодрома
дартс:  дартс
дырявый:  дырявого
потренировать:  потренируем
потолок:  потолок
дырочка:  дырочка
нерв:  нервах
мат:  мат
царица:  царица
громкий:  громким
схематически:  схематически
трёхбуквенный:  трёхбуквенные
отсекать:  отсекают
облачко:  облачко
барабан:  барабану
фиксировать:  фиксированная
сено:  сена
дружить:  дружит
стерва:  стерва
умереть:  умереть
стартовать:  стартует
телевизор:  телевизора
томиться:  томиться
вертеться:  вертеться
сердито:  сердито
лаконичность:  лаконичность
обзорный:  обзорный
разгрызть:  разгрызть
бытность:  бытность
неправильный:  неправильная неправильной
каменный:  каменным
тихо:  тихо
институтский:  институтской
загвоздочка:  загвоздочка
экономия:  экономии
красоваться:  красовалось
предпоследний:  предпоследний
подсократить:  подсократил
мож:  мож
выступить:  выступит
телодвижение:  телодвижения
прочь:  прочь
доцент:  доцент
траектория:  траектории
настраиваться:  настраиваемся
минералка:  минералка
расшутиться:  расшутился
снижаться:  снижающейся
водка:  водки
несомненно:  несомненно
приехать:  приехали
облегчение:  облегчением
выговаривать:  выговаривать
улыбаться:  улыбаться
вздохнуть:  вздохнем
гоготать:  гоготать
образоваться:  образуется
кружок:  кружков
миниатюрный:  миниатюрная
ностальгия:  ностальгия
наугад:  наугад
запариваться:  запаривайтесь
ученик:  учеников
курий:  курьих
озёрный:  озёрной
неясно:  неясно
зал:  зала
этюд:  этюд
верблюд:  верблюд
стоптать:  стоптана
сентябрьский:  сентябрьской
ро:  ро
тягаться:  тягаться
шапочка:  шапочку
кликабельный:  кликабельное
любительница:  любительница
перепрыгивать:  перепрыгивают
утаивать:  утаивать
семиклассник:  семиклассники
бессмертный:  бессмертного бессмертному
врасплох:  врасплох
неперпендикулярность:  неперпендикулярности
распутье:  распутье
избушка:  избушка избушки
аксессуар:  аксессуары
застать:  застать
посоветовать:  посоветую
запарить:  запаренный
заглохнуть:  заглохла
разогнать:  разогнать
открутка:  открутка
зачитать:  зачитал
поработать:  поработали
энергетика:  энергетику
заложить:  заложим
путешественник:  путешественников
косяк:  косяк
хором:  хором
указатель:  указателями
подпевать:  подпевает
кащей:  кащея
купаться:  купаться
тридесятый:  тридесятом
кащий:  кащею
смекалка:  смекалку
приговор:  приговор
малоинтересный:  малоинтересен
усталость:  усталость
башмак:  башмаков
словно:  словно
портить:  портить
мякоть:  мякоть
объемё:  объемё
циклоида:  циклоиды
стыдно:  стыдно
пискунов:  пискунова
занудный:  занудное
окраина:  окраине
шаровой:  шаровой шарового шаровая
недоработка:  недоработку
прорисовка:  прорисовки
знающий:  знающие
полюс:  полюса полюсами
нож:  нож
стенка:  стенку
двусмысленный:  двусмысленную
неземной:  неземное
вращать:  вращать
ремарка:  ремарке
кармичёска:  кармически
тор:  тор тора
яблочко:  яблочко
трактовка:  трактовку
неочищенный:  неочищенный
апельсинка:  апельсинку
душераздирающий:  душераздирающее
фрукт:  фрукт
яйцевидный:  яйцевидным
обнажиться:  обнажилась
кристально:  кристально
шаров:  шаровым
кружка:  кружку
ослик:  ослик
креативный:  креативное
мяч:  мяч
серединка:  серединку
апельсин:  апельсин
кардиоида:  кардиоиды кардиоида
горшок:  горшок горшка
больно:  больно
видоизменять:  видоизменять
регби:  регби
конфетка:  конфетка
предъявляться:  предъявляются
углубление:  углублением
остроконечный:  остроконечным
пояс:  пояс пояса поясом
копия:  копий
кожура:  кожура
заморачиваться:  заморачиваются
эллипсоид:  эллипсоида
попросить:  попросят
такси:  такси
диспетчер:  диспетчера
схематично:  схематично
показательно:  показательно
повернуться:  повернулась
передом:  передом
беспощадный:  беспощадная
бессмысленный:  бессмысленная
зажечь:  зажечь
ламповый:  ламповым
облегчаться:  облегчается
перегорание:  перегорания
несуразно:  несуразно
охватить:  охватили
кульминационный:  кульминационной
мощь:  мощь
сводный:  сводном
сосредоточить:  сосредоточена
подделка:  подделка
занижать:  занижать
неизвлекаемый:  неизвлекаемое
поедание:  поедание
ужин:  ужин
зигзаг:  зигзагу
коллоквиум:  коллоквиума
удар:  удар
радоваться:  радоваться
алфавит:  алфавита
ущерб:  ущерб
влёчета:  влёчет
клонировать:  клонировать
рубашка:  рубашке
получение:  получение
набивать:  набиваем
сверх:  сверх
стилистика:  стилистика
практиковаться:  практикуется
перечисляться:  перечисляются
ссылаться:  ссылаемся
ортый:  орто
прибытие:  прибытия
вешалка:  вешалка
господин:  господа
дотошно:  дотошно
извиняться:  извиняюсь
раздевалка:  раздевалки
дама:  дамы
сонаправленность:  сонаправленность
досадный:  досадно
результирующий:  результирующему результирующего
заморочка:  заморочек
небезызвестный:  небезызвестной
мастерская:  мастерскую
переиздание:  переизданий
тратить:  тратить
оговариваться:  оговаривается
поклон:  поклон
сходство:  сходство
пешка:  пешек
страдать:  страдают
нелюбимый:  нелюбимый
указываться:  указываются
затравка:  затравки
сэкономить:  сэкономит
инструментальный:  инструментальных
отправление:  отправления
привычка:  привычки
окупиться:  окупится
второгодник:  второгодникам
оригинальность:  оригинальность
поддатый:  поддатым
шифровать:  шифрую
кипеть:  кипит
неотступно:  неотступно
дурацкий:  дурацкий
рифма:  рифма
переместить:  переместили
детализация:  детализация
застёгивать:  застёгивать
пристроить:  пристроить
недостоверный:  недостоверно
червы:  черв
капитан:  капитан
отклик:  откликах
настроить:  настроить
измеряться:  измеряются
северный:  северные
одновременный:  одновременное
четырёхэтажный:  четырёхэтажных
приберечь:  приберегу
отскочить:  отскочить
убедительный:  убедительным
червовый:  червовой червовую
мм:  мм
сбрасываться:  сбрасывается сбрасываются
извлёкать:  извлёкает
прогнозирование:  прогнозирование
морально:  морально
ростовый:  ростовой
объединить:  объединены
черва:  червы черву
южный:  южные
сбрасывание:  сбрасывание
нехватка:  нехваткой
тесный:  теснее
притянуться:  притянуться
проигнорировать:  проигнорировать
стохастический:  стохастическая
окаймлять:  окаймляющих
повстречаться:  повстречается
разработать:  разработан
юмористический:  юмористическом
раскручивать:  раскручиваем
молодёжный:  молодёжному
ликвидация:  ликвидации
бесполезный:  бесполезен
расширить:  расширенная расширенную расширенной расширим
уложить:  уложить
эпиграф:  эпиграфе
превзойти:  превзойдёт
удалять:  удаляем
шт:  шт
гипотетичный:  гипотетично
ядерный:  ядерные
лестница:  лестницей
блат:  блата
мировой:  мировой
доверить:  доверить
питомец:  питомца
немец:  немец
жёсткость:  жёсткости
боеголовка:  боеголовки
удаляться:  удаляются
приделывать:  приделываем
иерархия:  иерархией
предпочтительный:  предпочтителен
дрессировать:  дрессировать
пятиэтажка:  пятиэтажка
ад:  ад
англичанин:  англичанин
спутник:  спутники
отождествить:  отождествить
тета:  тета
обманываться:  обманываются
электростанция:  электростанции
преувеличение:  преувеличения
вычёркивание:  вычёркиванием
адресовать:  адресован
совместность:  совместность
сток:  стоки
привлекать:  привлекать
ампутация:  ампутацию
втройне:  втройне
свешивать:  свешиваем
должность:  должность
размышление:  размышление
нейтрально:  нейтрально
стрижка:  стрижка
крепость:  крепости
ласковый:  ласковых
каламбурный:  каламбурно
расправить:  расправленное
паркет:  паркет
ниточка:  ниточку
побочный:  побочный
клан:  клана
отойти:  отойти
плита:  плиты
бомба:  бомба
наводящий:  наводящие
наголо:  наголо
спешка:  спешки
отлечь:  отлегло
нечастый:  нечастый
устремляться:  устремляется
мел:  мел
беспрекословно:  беспрекословно
арабский:  арабского
спрямлять:  спрямляема
недоглядывать:  недоглядывают
опознаваться:  опознаётся
дробиться:  дробится
невразумительный:  невразумительное
вправе:  вправе
гранитный:  гранитные
прародитель:  прародителями
снискать:  снискала
избавление:  избавлением
подгонка:  подгонки
бедолага:  бедолагу
немыслимо:  немыслимо
тазик:  тазике
ремонт:  ремонт
косметический:  косметический
представать:  предстаёт
манипуляция:  манипуляций
забетонировать:  забетонировав
превращение:  превращение
краеугольный:  краеугольным
облом:  облом
стопудовый:  стопудово
преждевременный:  преждевременным
рыпаться:  рыпаться
потеряться:  потеряется
закипеть:  закипел
бессмысленно:  бессмысленно
вступление:  вступление
старуха:  старуху
казус:  казус
несомненный:  несомненными
молодость:  молодости
замучаться:  замучаться
недолюбливать:  недолюбливаю
обыденно:  обыденно
быстрота:  быстрота
разбиваться:  разбивается
поход:  похода
снежный:  снежная
сверхбыстрый:  сверхбыстрой
рациональность:  рациональности
подолгу:  подолгу
случиться:  случился
неувязочка:  неувязочка
порнуха:  порнуха
отмахнуться:  отмахнуться
таскать:  таскать
правомерность:  правомерности
метель:  метель
целиковый:  целиковую
прикидывать:  прикидываем
усложнять:  усложняем
фигня:  фигня
здравствуйте:  здравствуйте
нарезать:  нарезаем
уточнять:  уточняем
протянуться:  протянулся
восстановление:  восстановление
каша:  каши
недоделать:  недоделанной недоделанную
поставлять:  поставляем
распутать:  распутать
злодей:  злодеев
мостик:  мостик
залезть:  залезть
взаимоуничтожение:  взаимоуничтожения
хитросплетение:  хитросплетения
форточка:  форточку
нелёгкая:  нелёгкая
разрушать:  разрушать
группировать:  группируем
бедноватый:  бедновата
прям:  прям
ликвидировать:  ликвидируем
гадость:  гадость
выуживать:  выуживать
запаковывать:  запаковываем
клубок:  клубок
пляска:  пляску
