участок:  участка
вектор:  векторы векторов
раздел:  разделе раздела
применяться:  применяются
растиражировать:  растиражировав
вращение:  вращения
дифференциальный:  дифференциальные дифференциального дифференциальное дифференциальных дифференциальным
столбцы:  столбцов
уравненияс:  уравненияс
полениться:  поленюсь
упрощение:  упрощение
онлайн:  онлайн
приблизить:  приблизить приближенных приблизит приближенные
геометрия:  геометрии геометрия
копирование:  копирование
шаг:  шагом шаге шага шаг
давать:  давайте даёт
решить:  решить
рассмотреть:  рассмотрели рассмотрим рассмотренных
разрыв:  разрыва
работа:  работа
выражение:  выражения
сумма:  сумма сумму
неоднократно:  неоднократно
производный:  производные производная производной производную
прямой:  прямой прямое прямую прямая
дуприближённо:  дуприближённо
фрагмент:  фрагмент
новый:  новому новым
предел:  предел пределы пределе пределов
расхождение:  расхождение
произвольныйтройный:  произвольныйтройной
модель:  модели модель
небольшой:  небольшой
левый:  левым левый левых
сопоставимый:  сопоставимо
асимптота:  асимптоты
качественно:  качественно
дизайн:  дизайна
это:  это
положить:  положил
событие:  события
приближение:  приближения приближением приближение
отблагодарить:  отблагодарить
повторный:  повторные
интересный:  интереснейшую
заходить:  заходит
байес:  байеса
числовой:  числовые
экселе:  экселе
дисперсия:  дисперсию дисперсия дисперсии
рассматривать:  рассматриваем
решать:  решать
производныенеявно:  производныенеявно
таблица:  таблицу таблицы
точнее:  точнее
значение:  значение значения
автоматизировать:  автоматизировать
решение:  решений решением решение решения
поляй:  поляи
интеграл:  интегралы интеграла интеграл интеграле интегралов
точность:  точности точностью точность
опечатка:  опечатку
плясать:  плясать
результат:  результат результаты результатам
превосходить:  превосходит
теория:  теория теории
математический:  математические математическая математической математического
состоять:  состоит состоять
незадача:  незадача
обработать:  обработать
формула:  формулы формула формулу формуле
данный:  данном данный
смотреть:  см смотрим
сам:  сами самого самом самим
фрактал:  фракталах
фнп:  фнп
формулировка:  формулировка
прийтись:  придётся
канонический:  каноническому
приходить:  приходят
простейшее:  простейшие
вычислить:  вычисленная вычислить
два:  две
гипотеза:  гипотезы гипотез гипотеза
дифференциал:  дифференциалах дифференциала
двумерный:  двумерная
больший:  наибольшее большего большая большее
который:  которых которые которого который которой которая которое
методомоперационный:  методомоперационного
задать:  заданной задайте
нередко:  нередко
погрешность:  погрешность погрешностей погрешности
часть:  частям частей части частью
известно:  известно
тело:  тела
циркуляция:  циркуляция
бесповторный:  бесповторной
непосредственно:  непосредственно
знакомый:  знакомые
слева:  слева
образно:  образно
правильно:  правильно
фраза:  фраза
двойной:  двойные двойной
миллион:  миллион
ошибка:  ошибку
плоскость:  плоскости плоскость
несобство:  несобств
л:  л
общий:  общим общая
нелинейный:  нелинейная
кочегаров:  кочегаров
преобразованиеквадратичный:  преобразованиеквадратичной
соответствовать:  соответствующим соответствующее соответствует
определителяй:  определителяи
вогнутостья:  вогнутостьи
многий:  многих
вид:  виде виды вида виду
совпасть:  совпадёт
становиться:  становится
параллельный:  параллельны
закон:  законы
функциональный:  функциональные
ломаный:  ломаной ломаную ломаная
слово:  слову
касательный:  касательных касательным
статья:  статья статью
убедиться:  убедиться
приближённый:  приближённого приближённых
звено:  звеньев
разбираться:  разбираемся
улучшиться:  улучшился
замечание:  замечаний
условие:  условии условие условия условию
сравнить:  сравнить
тот:  той та
сравнение:  сравнение сравнению сравнения
безусловный:  безусловным безусловный
истина:  истиной
классический:  классический
применимый:  применимы
геометрический:  геометрическая геометрическое
абсолютный:  абсолютная абсолютные
графика:  графика графики
типовыхзадача:  типовыхзадач
краткий:  краткая
хвостатый:  хвостатые
удобно:  удобно
совершенство:  совершенству
умножение:  умножения умножение
столбец:  столбец
вероятность:  вероятностей вероятность вероятности
ранговойкорреляция:  ранговойкорреляции
система:  система систему системе систем системы
частный:  частные частное
функция:  функций функцию функции функция
качество:  качеством качество
непрерывный:  непрерывная непрерывных
группировка:  группировок группировка
познакомиться:  познакомимся
условнаясходимость:  условнаясходимость
сложенияй:  сложенияи
исследование:  исследования исследованиях исследование
уравненийв:  уравненийв
сложение:  сложение
вычислительный:  вычислительная вычислительными вычислительную
регрессия:  регрессии регрессия
величина:  величин величина величины
александр:  александр
вспомниться:  вспомнился
остаться:  осталось
существование:  существование
отрезок:  отрезок отрезка отрезков отрезки
усовершенствование:  усовершенствования
двукратный:  двукратного
количество:  количества количеством количество
грин:  грина
полный:  полное полных полной
исчисление:  исчисления
линейный:  линейные линейная линейное линейных линейной
подсказывать:  подсказывает
жизнь:  жизни жизнь
эйлер:  эйлера эйлер
метод:  метода методы методов методом метод
объект:  объекта
правый:  правой
иксовыя:  иксовые
согласие:  согласия
зачастую:  зачастую
локальный:  локальная
запятая:  запятой запятых
каждый:  каждого каждое каждом каждой каждый
остальной:  остальные
книга:  книгах книга книги
гарантировать:  гарантируют гарантирует
ожидание:  ожидание
придерживаться:  придерживаться
математика:  математики математику математике
лаплас:  лапласа
перегиб:  перегиба
такой:  таким таком такое такого
удовлетворять:  удовлетворяющее удовлетворяет
сколько:  сколько
сходимость:  сходимости сходимость
дуоперационный:  дуоперационным
исследовать:  исследовать
предыдущий:  предыдущем предыдущего предыдущему
представить:  представить
невозможно:  невозможно
дискретный:  дискретный
нетрудно:  нетрудно
базис:  базисах базис базису
поверхность:  поверхности
знакочередоваться:  знакочередующиеся
задача:  задачи задача
вычисление:  вычислений вычисления вычисление
следующий:  следующая следующее
векторный:  векторного векторное
ду:  ду
наиболее:  наиболее
заметно:  заметно
далее:  далее
зависимостьвектор:  зависимостьвекторов
видеоролик:  видеоролик
линейныйкоэффициент:  линейныйкоэффициент
мысль:  мысль
снова:  снова
тысяча:  тысячи
предложный:  предложен
коэффициент:  коэффициент
неопределённый:  неопределенный неопределенном
победный:  победного победный
промежуток:  промежуток промежутке промежутка
дробь:  дробей
круг:  круг
собственный:  собственные
тема:  теме темы
страница:  страницу
практически:  практически
модификация:  модификации
несобственныйинтеграл:  несобственныйинтеграл
признак:  признак признаки
произвольный:  произвольных
данные:  данных
сложный:  сложной сложных сложные сложным
недостаток:  недостаток недостатком
рядом:  рядом
доступно:  доступно
красный:  красных красные
измельчить:  измельчить
работать:  работает
причём:  причём
фурье:  фурье
учиться:  учимся
поле:  поля
поэтому:  поэтому
разложение:  разложением разложение
задавать:  задаваемые
разделить:  разделить разделим
свойство:  свойства свойство
практика:  практике
точка:  точка точки точку точках точками точкам точек точке
влечь:  влечёт
толика:  толику
постановка:  постановка
смежный:  смежные
округлять:  округлять
икс:  икс
корабль:  корабля
ипример:  ипримеры
уравнение:  уравнению уравнениям уравнений уравнении уравнения уравнение уравнением
множество:  множества множество
найти:  найти
оценка:  оценки оценка
переход:  переход
вариация:  вариации
требоваться:  требуется
асимметрия:  асимметрия
спрятаться:  спрятались
комплексный:  комплексными комплексные комплексного комплексный
добиться:  добиться
основа:  основы основами основу
поверхностный:  поверхностные
слишком:  слишком
вопрос:  вопросом вопросы вопрос
интервал:  интервалы интервалов
достоинство:  достоинством
главный:  главную
кош:  коши
координата:  координат координаты координатах
фигура:  фигуры
представимый:  представим
выше:  выше
оффтоп:  оффтоп
пуассон:  пуассона
составлять:  составляет
сводиться:  сводящиеся
чайник:  чайников
преобразование:  преобразований преобразования
замена:  замены
вычисленияс:  вычисленияс
однако:  однако
целесообразно:  целесообразно
малый:  малые наименьших малую
связь:  связь
понижение:  понижением понижение
задаться:  зададимся
матричный:  матричные матричных матричный
китаец:  китайцев
забивать:  забиваем
дополнительный:  дополнительных
заметить:  заметили заметить
математическоеожидание:  математическоеожидание
например:  например
однородный:  однородные однородным
решенияопределённый:  решенияопределенных
помощь:  помощь помощью
профессия:  профессию
нормальный:  нормальное
важный:  важен
школа:  школа
очень:  очень
интегральнаятеорема:  интегральнаятеоремы
корнимногочлен:  корнимногочлена
логарифмический:  логарифмическая
приветливо:  приветливо
матрица:  матрицу матрицы матрицами
корень:  корнем
испытанияй:  испытанияи
интегралыть:  интегралыв
физический:  физических
близкий:  ближе
неоднородный:  неоднородные
начать:  начнём начать
перегруппировка:  перегруппировка
голова:  голова
правило:  правило правила
основной:  основные
образец:  образцу
постараться:  постараемся
немецкий:  немецкие
бернулли:  бернулли
полярный:  полярные полярной полярных
коэффициентковариация:  коэффициентковариации
ряд:  ряд ряды ряда рядов
квадратик:  квадратики квадратиков
вариационный:  вариационный
средний:  средней средняя
разбиение:  разбиении разбиения разбиение
конец:  концом конца конец
уровень:  уровня
обратный:  обратная обратную
степенной:  степенным степенного степенные
второй:  второй второго
должный:  должны должно
поражаться:  поражаешься
кратное:  кратные
точный:  точный точные точное точного
проблема:  проблема
внешний:  внешней
взглянуть:  взгляните
системудифференциальный:  системудифференциальных
перечисленный:  перечисленные
блог:  блог
доверительный:  доверительные
высокий:  высших высшей высочайшей высокой высшая
рассчитывать:  рассчитываем
узловой:  узловых
усложняться:  усложняется
экселя:  экселя
среднееквадратический:  среднееквадратическое
край:  краях
пространство:  пространстве
пример:  примеры пример
алгоритм:  алгоритм
лопиталя:  лопиталя
открытие:  открытиям
чертёж:  чертежу чертеже
называться:  называется
последовательность:  последовательностей
удобный:  удобный
комбинационный:  комбинационная
следовать:  следуют следует
курс:  курс
ловить:  ловим
путь:  путь
квадратичный:  квадратичные
смешанноепроизведение:  смешанноепроизведение
философский:  философский
количественный:  количественный
гаусс:  гаусс гаусса
шутка:  шуткой
некоторый:  некотором
объём:  объем
предполагаться:  предполагается
стандартный:  стандартными
проверить:  проверить
поляформула:  поляформула
иметь:  иметь имеет
сообщить:  сообщите
сделать:  сделать
читать:  читая
линия:  линиями линии линия линией
фехнера:  фехнера
аналитический:  аналитическая аналитическое аналитической
мощность:  мощностями
поскольку:  поскольку
школьный:  школьный
эффективный:  эффективные
мы:  нам нами
понестись:  понеслось
центр:  центр
образ:  образом
гипергеометрическоераспределение:  гипергеометрическоераспределение
условный:  условные
непрерывнаяслучайный:  непрерывнаяслучайная
другой:  других другое другие другого
страшный:  страшным
эллипс:  эллипс
ибо:  ибо
раз:  раза
ноль:  ноль
обратить:  обратите
построить:  построю построить построим
узнать:  узнаем
длина:  длина
сайт:  сайта сайты сайт
один:  одна одно
мочь:  могут могу
знакопостоянство:  знакопостоянства
быстрый:  быстрый
равномерный:  равномерная равномерное
параграф:  параграфу параграфе
подробно:  подробно
треугольный:  треугольная
хотеть:  хотите хочу
проводить:  проводить
спросить:  спросите
градиент:  градиент
сторона:  стороной
определение:  определения определению
смысл:  смысла
накапливаться:  накапливаться
использовать:  используйте
пожалуйста:  пожалуйста
даламбер:  даламбера
спрямить:  спрямить
теорема:  теоремы
факт:  факт
комбинаторика:  комбинаторике
число:  числе числами числа
начальный:  начальное начального начальному
случайнаявеличина:  случайнаявеличина
повторнойя:  повторнойи
преимущественно:  преимущественно
построение:  построение
естественно:  естественно
улучшить:  улучшить улучшит
проверка:  проверку проверка
обеспечивать:  обеспечивает
бесконечно:  бесконечно
наш:  наша наш нашего
дифф:  дифф
свой:  своего
знак:  знаков знаками знака знак
линейнойкорреляционный:  линейнойкорреляционной
грех:  грех
действие:  действия
себя:  собой
существенно:  существенно
простой:  простого простой простым
квадрат:  квадратов
ранг:  ранг
кривая:  кривой
просматриваться:  просматривается
форма:  формы
провести:  проведены проведём провести
тяжестиплоска:  тяжестиплоской
сразу:  сразу
распределениякритерия:  распределениякритерий
подъёмный:  подъёмная
функциюкомплексный:  функциюкомплексной
исторически:  исторически
область:  область области
реализоваться:  реализуется
известный:  известна известными
готовый:  готовых готовы
несобственный:  несобственные
просто:  просто
указание:  указание
мода:  мода
свойстваэлементарный:  свойстваэлементарных
ещё:  ещё
внимание:  внимание
подход:  подходы
калькулятор:  калькулятор
лейбниц:  лейбница
привести:  приведу привести
научиться:  научиться
случай:  случае
случайность:  случайность
неравенство:  неравенства
поток:  поток
увеличение:  увеличением
касательная:  касательная
задачис:  задачис
посерединка:  посерединке
ответ:  ответ
цель:  цель
разбить:  разбить разбив
современный:  современными
копировать:  копирую
медиана:  медиана
бывать:  бывает
показательный:  показателен показательное
нахождение:  нахождения
функциия:  функциии
свести:  сведу свести
диффура:  диффуры диффур диффурами
возможно:  возможно
равный:  равна
функцийдвуха:  функцийдвух
оказаться:  оказался
направлениюй:  направлениюи
определённый:  определенный определенного
выборка:  выборке
приближать:  приближает
гостевой:  гостевая
вы:  вами
распределение:  распределения распределение
кроме:  кроме
экстремум:  экстремумы
использование:  использовании
уходить:  уходим
горнера:  горнера
отмечаться:  отмечалось
производныефункция:  производныефункции
понятно:  понятно
единица:  единице
функцийнесколький:  функцийнескольких
рассчитать:  рассчитать
внутригрупповаяй:  внутригрупповаяи
нижеследующий:  нижеследующую
пара:  пару пара
алгебра:  алгебры
далеко:  далеко
обычный:  обычной обычное обычного
математик:  математика
функцийв:  функцийв
переменный:  переменных переменной переменные
усовершенствовать:  усовершенствованного усовершенствованный
видеть:  видите
несовместный:  несовместные
независимыеслучайный:  независимыеслучайные
множественнойлинейный:  множественнойлинейной
никакой:  никакого никакими
тиражировать:  тиражируем
невероятно:  невероятно
мотивация:  мотивацию
существовать:  существует
анализ:  анализ анализа
принцип:  принципом
обучение:  обучению
начинать:  начинаем
прямоугольник:  прямоугольников
непрерывность:  непрерывность
эксцессэмпирический:  эксцессэмпирического
наука:  науке
нанять:  нанять
поверка:  поверку
способ:  способами
догадаться:  догадаться
говорить:  говорит говоря
функциис:  функциис
тенденция:  тенденцию
зеркало:  зеркало
различный:  различных
криволинейный:  криволинейные
значит:  значит
верный:  верными верных
поправимый:  поправимо
пирсон:  пирсона
библиотека:  библиотека
три:  трёх
идея:  идея
межгрупповой:  межгрупповая
ортогональный:  ортогональное
заменить:  заменить
дискретнойслучайный:  дискретнойслучайной
предназначить:  предназначены
задачипо:  задачипо
востребовать:  востребованную
наименьшеезначение:  наименьшеезначения
нсв:  нсв
сила:  силы
распахнуться:  распахнутся
вычислимый:  вычислим
промежуточный:  промежуточных
скучноватый:  скучноватую
великое:  великое
походить:  походить
разобрать:  разобрал
системылинейный:  системылинейных
нужно:  нужно
колонка:  колонке
быстро:  быстро
упасть:  упал
зависимый:  зависимые
подровнять:  подровнял
первый:  первая первого
прочитать:  прочитать
зависимость:  зависимость
заголовок:  заголовке заголовок
отклонение:  отклонение
крамер:  крамера
рассчитываться:  рассчитываются
отрезка:  отрезке
материал:  материалы материалов
трудно:  трудно
устоять:  устоять
произведение:  произведение
вполне:  вполне
случайный:  случайных случайные
замкнутый:  замкнутому
соблазн:  соблазном
график:  графику график
изложить:  изложенные
дуга:  дуги
частность:  частности
отрезкать:  отрезкав
округление:  округление
леонард:  леонарда
дивергенция:  дивергенция
парабола:  парабола
спасибо:  спасибо
строго:  строго
проходить:  проходит
форум:  форуме форум
показатель:  показатели
китайский:  китайского
отличие:  отличие
думать:  думал
сильно:  сильно
площадьс:  площадьс
таков:  такова
функциидвуха:  функциидвух
получиться:  получилось
статистический:  статистические статистическая
запретить:  запрещено
задание:  задание
емелин:  емелин
строка:  строка
умножать:  умножаем
совпадать:  совпадает
убыванией:  убываниеи
вычисленияопределенный:  вычисленияопределенных
повышенный:  повышенной
возрастание:  возрастание
эмпирический:  эмпирические
детерминация:  детерминации
обойти:  обошла
интегрирование:  интегрирование интегрирования
дать:  данная данному
легко:  легко
задачин:  задачина
замечательный:  замечательные
рациональный:  рациональные
системый:  системыи
удовлетворяетлить:  удовлетворяетли
остановиться:  остановиться
найтись:  нашлось
разнообразить:  разнообразить
выполнить:  выполнить
разделаться:  разделаюсь
реализовать:  реализуем
сегодня:  сегодня
игрековый:  игрековое
дифференциальныеуравнение:  дифференциальныеуравнения
прозвучать:  прозвучавшей
иррациональный:  иррациональных
интервальный:  интервальный
тригонометрический:  тригонометрических
постоянный:  постоянных
сымитировать:  сымитировать
квадратичнуюформ:  квадратичнуюформу
стокс:  стокса
схема:  схема схеме схемы
карта:  карта
спрямляемость:  спрямляемостью
параметрический:  параметрической параметрическом
гипербола:  гипербола
раскручиваться:  раскручиваемся
уменьшение:  уменьшение уменьшении
дифференцирование:  дифференцирования
космический:  космического
дробовик:  дробовик
они:  ними
составить:  составит
оценкия:  оценкии
неявный:  неявной
объяснимый:  объяснимо
встречаться:  встречается
несобственныхинтеграл:  несобственныхинтегралов
вероятностибиномиальный:  вероятностибиномиального
вероятностия:  вероятностии
логика:  логики
род:  рода
заданав:  заданав
скалярный:  скалярное
спирмена:  спирмена
совершенно:  совершенно
порядок:  порядка порядков
всё:  всё
зелёный:  зелёными зелёным
значимость:  значимости
изобразить:  изобразим
тройной:  тройные
достигнуть:  достичь
деление:  деления
соединять:  соединяющих
являться:  является
позволять:  позволяют
контуруформула:  контуруформула
частное:  частного
иной:  иной
рекуррентный:  рекуррентной
экстремальный:  экстремальные
вовсе:  вовсе
лишь:  лишь
дело:  деле дело
её:  её
св:  св
парный:  парной
самый:  самый
биография:  биографию
выходить:  выходит
нормаль:  нормали
определитель:  определитель
желать:  желающие
выпуклость:  выпуклость
элемент:  элементы
очевидный:  очевидны
сборник:  сборники
небраться:  неберущийся
успеть:  успеть
запрограммировать:  запрограммирована
элементарно:  элементарно
распространить:  распространённой
интересно:  интересно
обосновываться:  обосновывается
рекомендовать:  рекомендую
независимый:  независимые
раскрыть:  раскрыть
фамилия:  фамилии
русло:  русле
удаваться:  удаётся
удаться:  удалось
получить:  получи
принципиально:  принципиально
автор:  автора автор
потерять:  потерять
сложность:  сложности
часто:  часто
значенияй:  значенияи
заносить:  заносить
человек:  человек
этот:  эта
соответствующий:  соответствующие
нужный:  нужной
получаться:  получается
кстати:  кстати
аргумент:  аргумент
находить:  находим
надеяться:  надеюсь
труд:  труда
нуль:  нуля
классическоеопределение:  классическоеопределение
инормаль:  инормаль
нулевой:  нулевое
статистика:  статистика
корреляция:  корреляции
монстр:  монстра
существенный:  существенным
биномиальный:  биномиальное
урок:  уроке
далёкий:  дальше
вновь:  вновь
заочник:  заочников
пирамида:  пирамида
линиюв:  линиюв
расписать:  распишу
разумно:  разумно
отношение:  отношении
повторять:  повторяем
