разница:  разницей разницу
чертёж:  чертежом чертеж чертежа чертёж чертеже
техника:  технику техники
неоднократно:  неоднократно
производный:  производные производная производной производную
предел:  предел пределами пределы пределов пределам
полоса:  полосе
половина:  половина
соблюдать:  соблюдайте
числовой:  числовые
производныенеявно:  производныенеявно
маньячить:  маньячить
гроссмейстерский:  гроссмейстерский
находить:  находить
завершение:  завершению
игрек:  игрек игреки
каёмочка:  каёмочкой
неопределённый:  неопределённые неопределённый неопределенный неопределенном
формула:  формулы формуле формула
прийтись:  придётся
канонический:  каноническому
сталкиваться:  сталкивались сталкиваются
два:  две двумя двух
дифференциал:  дифференциалах дифференциалов дифференциала
больший:  наибольшее наибольшие
нередко:  нередко
многие:  многие
выразить:  выразим выразить
подробный:  подробные подробнее
лазерный:  лазерный лазерную лазерным лазерная лазерной
особенный:  особенного
проводиться:  проводится
бок:  боку
правый:  правая правой правую
стрелка:  стрелка стрелками
число:  число числе числами числа
вогнутостья:  вогнутостьи
плохой:  хуже
профессия:  профессию
условие:  условии условия условию
построение:  построением построения построение
срок:  сроки
умножение:  умножения
выполнимый:  выполним
система:  система системе систему системы
группировка:  группировок группировка
условнаясходимость:  условнаясходимость
окружность:  окружность окружности
заключительный:  заключительная заключительный
александр:  александр
ось:  ось оси
стрелочка:  стрелочки
уровень:  уровень уровня уровне
который:  которые которыми который которая которое которой
линейный:  линейные линейная линейных линейной
метод:  метода методы методом метод
дифференциальный:  дифференциальными дифференциальные
равенство:  равенство равенства
согласие:  согласия
вычисление:  вычислениям вычислению вычислении вычисления вычисление вычислений
присутствовать:  присутствуют
дуоперационный:  дуоперационным
компактный:  компактная компактный
базис:  базисах базису базис
наиболее:  наиболее
зависимостьвектор:  зависимостьвекторов
шаг:  шагу шаге шаг
сначала:  сначала
тема:  теме тему темы
страница:  страницу
смотреть:  смотрим смотрите
математический:  математическая математические математической
данные:  данных
интеграл:  интеграл интегралов интегралами интегралах интегралы интеграла интегралом интеграле интегралам
урок:  урока уроках урок уроке
разложение:  разложением разложение
сводиться:  сводится сводящиеся
икс:  икс иксы
параграф:  параграфом параграф параграфа параграфе
уравнение:  уравнению уравнения уравнение уравнением уравнениями уравнений
зю:  зю
мочь:  можете могут
переход:  переход перехода
получиться:  получилось получится получатся получиться
нетерпение:  нетерпением
закомментировать:  закомментирован
обычный:  обычным обычная обычной обычное обычного обычную обычный
вводный:  вводном
целиком:  целиком
желательно:  желательно
восполнить:  восполнить
ветка:  ветку веток
пара:  пары пару
целесообразно:  целесообразно
малый:  малые малейшей наименьших
связь:  связь
точка:  точку точки точке
тяжесть:  тяжести
полуокружность:  полуокружности полуокружность
дружный:  дружен
сомнение:  сомнения
простой:  простая проще простых простейший проста простой просты
внутренний:  внутренний внутреннего внутренним
уметь:  умеющих уметь
наглядность:  наглядности
нормальный:  нормальное нормальных
интегральнаятеорема:  интегральнаятеоремы
корнимногочлен:  корнимногочлена
логарифмический:  логарифмическая
начать:  начнём начать
основной:  основные
переслать:  перешли
функция:  функцией функции функция функций функциям функцию
бернулли:  бернулли
нужный:  нужен нужная нужной нужную
полярный:  полярные полярных полярной
рассмотреть:  рассмотрим рассмотрены рассмотрел рассмотрю
ряд:  ряды ряда ряд ряде рядов
определённый:  определённого определённых определенных определённые определенный определенного определённый определённым
значительно:  значительно
определение:  определении определению определения
доверительный:  доверительные
наблюдать:  наблюдать
прочитать:  прочитал
среднееквадратический:  среднееквадратическое
момент:  моменте моменты
говориться:  говорится
понятный:  понятное
вышесказанный:  вышесказанное
комбинационный:  комбинационная
следовать:  следуют следует
оба:  обе
смешанноепроизведение:  смешанноепроизведение
сей:  сию
пробел:  пробелы
дисперсия:  дисперсия дисперсии дисперсию
проверка:  проверки проверку проверка
школьный:  школьный
мы:  нам
образ:  образом
непрерывнаяслучайный:  непрерывнаяслучайная
обыватель:  обывателя
длина:  длина
хороший:  хорошая
наблюдаться:  наблюдается
материал:  материал материалов материалы
немного:  немного
заштриховать:  заштрихованной
знакопостоянство:  знакопостоянства
проводить:  проводить проводим
площадь:  площади площадей площадь
фигура:  фигуру фигур фигура фигуры
изменить:  изменить изменим
градиент:  градиент
линия:  линия линии линиями
испытывать:  испытывает испытывают
комбинаторика:  комбинаторике
случайнаявеличина:  случайнаявеличина
бесконечно:  бесконечно
знак:  знаков знак знаки
внимательный:  внимательным
желать:  желающих желаю
шахматы:  шахматы
форма:  формы
задача:  задачу задаче задачей задачи задачах задача
отметить:  отметить
статья:  статьи статье
позабыть:  позабыли
окончательный:  окончательный
любознательный:  любознательные
обратный:  обратную обратная обратные обратной обратным
рассматривать:  рассматривать рассматриваемую
готовый:  готовых
анализировать:  анализируем
просто:  просто
приём:  приём
ещё:  ещё
ограниченный:  ограниченная ограниченной
порядок:  порядком порядок порядке порядка порядков
часть:  частей частям часть части
быть:  буду будут будем
картина:  картину
отличаться:  отличается
обращать:  обращаю
нахождение:  нахождения нахождение нахождении
частый:  чаще
подобный:  подобных
грамотно:  грамотно
непрерывный:  непрерывных непрерывная
распространить:  распространён распространенная
производныефункция:  производныефункции
средний:  средняя
определённость:  определённости
единица:  единице
мастер:  мастер
область:  области область областью
далеко:  далеко
математик:  математика
попробовать:  попробовать попробуете
переменный:  переменных переменной
пример:  пример примеру примеров примере примерах примеры
несовместный:  несовместные
независимыеслучайный:  независимыеслучайные
вверх:  вверх
выполнение:  выполнения
считать:  считаем считать
следовательно:  следовательно
модель:  модель модели
непрерывность:  непрерывность
способ:  способами способе способом способу способ
верхний:  верхняя верхний верхней верхнюю
функциис:  функциис
таков:  таков
полный:  полной полных полное
требовать:  требуемый
зеркало:  зеркало
второй:  втором второго второму второй вторым
читатель:  читатели
значит:  значит
пирсон:  пирсона
свой:  своё своей свои
вопрос:  вопрос вопроса вопросом вопросы
межгрупповой:  межгрупповая
открывать:  открывает
ортогональный:  ортогональное
разборка:  разборки
привести:  приведены привести
ошибка:  ошибки ошибку
нсв:  нсв
плоский:  плоскую плоской плоских плоская
вроде:  вроде
быстро:  быстро
слукавить:  слукавил
упасть:  упал
ход:  ходе ходу
один:  одно одна одной
отрезка:  отрезке
величина:  величина величин величины
важный:  важный важнейший важное
запись:  запись
любопытный:  любопытный
парабола:  параболе параболы параболу парабола параболами
аз:  азы
зелёный:  зелёная зеленая
детерминация:  детерминации
обязательно:  обязательно
следующий:  следующие следующим следующий
выполнить:  выполнить
дифференциальныеуравнение:  дифференциальныеуравнения
прямой:  прямая прямой прямыми прямым прямую
постоянный:  постоянных
стокс:  стокса
схема:  схема
свести:  свести
дробовик:  дробовик
математика:  математике математики
векторный:  векторное векторного
поступать:  поступаем поступать
кратное:  кратных кратные
новость:  новость
вероятностия:  вероятностии
скалярный:  скалярное
значимость:  значимости
систематизировать:  систематизируем
мысленно:  мысленно
нижний:  нижняя нижней нижний
дать:  дана дан дано данные данной
верный:  верное
анализ:  анализа анализ
красный:  красная
её:  её
частный:  частное частные
парный:  парной
звёздочка:  звёздочками звёздочки
пиво:  пиво
выходить:  выходит выходим
указка:  указка указкой указку
примерный:  примерный
несколько:  несколько
банальный:  банальная
сборник:  сборники
параметрический:  параметрическом параметрической
часто:  часто
получаться:  получается
блюдечко:  блюдечке
решение:  решение решением решения решений
форум:  форум форуме
книга:  книги книга
провести:  провести
изменяться:  изменяется
жёлудь:  желудей
допустить:  допустите
задание:  задание
вектор:  векторы векторов
наподобие:  наподобие
вращение:  вращения
именно:  именно
копирование:  копирование
давать:  давайте
разрыв:  разрыва
выражение:  выражения
незамысловатый:  незамысловата
название:  название названием
значок:  значок значки
грубо:  грубо
отблагодарить:  отблагодарить
технический:  технический
являться:  являются является
забывать:  забывайте забываем
построить:  постройте построить
байес:  байеса
решать:  решать
точность:  точности
результат:  результат результата результате
теория:  теория теории
называть:  называют называемым
двумерный:  двумерная
друг:  друг другом
задать:  заданной задайте задан задана
тело:  тела
циркуляция:  циркуляция
непосредственно:  непосредственно
слева:  слева
лежать:  лежат лежит лежащую
плоскость:  плоскости плоскость
общий:  общим общая общем
какой:  каком какую
поздний:  позже
определителяй:  определителяи
согласно:  согласно
закон:  законы
затруднение:  затруднения
справа:  справа
строить:  строим
совладать:  совладали
действие:  действий действия
буква:  буква
насколько:  насколько
пункт:  пункт пункте
обширный:  обширную
вероятность:  вероятностей вероятность вероятности
записывать:  записывают записываем
любой:  любое любую
заключение:  заключение
уравненийв:  уравненийв
найти:  найдены найдена найти
отрезок:  отрезок
грин:  грина
класс:  класс
суть:  сути
входить:  входит входим
эйлер:  эйлера
направо:  направо
геометрический:  геометрический геометрические геометрическая геометрическим геометрическое
расставить:  расставить
орудие:  орудие
придерживаться:  придерживаться
путаться:  путаются
торопиться:  торопитесь
дискретный:  дискретный
знакочередоваться:  знакочередующиеся
проинтегрироваться:  проинтегрировалось
смущать:  смущать
преобразовать:  преобразовали преобразуем
неловкость:  неловкости
практически:  практически
происходить:  происходят
произвольный:  произвольных
сложный:  сложной сложный сложные сложных
фурье:  фурье
поле:  поля
гипотеза:  гипотез гипотеза гипотезы
свойство:  свойства свойство
исследование:  исследование
начинаться:  начинается
объём:  объема объем
вариация:  вариации
основа:  основы
лазер:  лазером лазера
мало:  мало
интервал:  интервалы
замечательный:  замечательно замечательные
кош:  коши
выше:  выше
составлять:  составляет
чайник:  чайников чайникам
вычисленияс:  вычисленияс
некоторый:  некоторым некоторыми
разобрать:  разобраны разберу
матричный:  матричные матричных матричный
аддитивность:  аддитивности
всякий:  всяких
заметить:  заметили
однородный:  однородные однородным
вычислить:  вычислить
очень:  очень
матрица:  матрицу матрицы матрицами
испытанияй:  испытанияи
интегралыть:  интегралыв
перегруппировка:  перегруппировка
зависеть:  зависят зависящие зависит
интересный:  интересная
помощь:  помощью
понять:  поняли поймёте
вариационный:  вариационный
удвоить:  удвоить
поменяться:  поменялся поменялось
элементарный:  элементарных
игреков:  игрековой
исключение:  исключением
блог:  блог
высокий:  высших высшей высшая
единственный:  единственной
пространство:  пространстве
снимать:  снимаем
удобный:  удобный удобное
курс:  курс курсе курса
начинающий:  начинающим
координата:  координаты координат координатах
ордината:  ординат
быстрый:  быструю
сообщить:  сообщите
сделать:  сделать
перейти:  перейдем перейдём перейти
аналитический:  аналитическая аналитической
понижение:  понижение понижением
неравенство:  неравенств неравенства
термин:  терминах
центр:  центр центром центра
поэтапно:  поэтапно
получить:  получено получить полученная полученный получи
помнить:  помнят помните
каждый:  каждому каждом каждой каждую
изобразить:  изобразить изобразим
ждать:  ждут
затем:  затем
возникать:  возникают возникает
луч:  луч лучом
линейнойкорреляционный:  линейнойкорреляционной
время:  время времени
семестр:  семестр семестров
удивиться:  удивитесь
осуществить:  осуществлён
распределениякритерия:  распределениякритерий
отлично:  отлично
уберечь:  убережёт
решить:  решена решить
несобственный:  несобственные
выполнять:  выполнять
откуда:  откуда
процесс:  процесс
касательная:  касательная
ответ:  ответ ответы
задачис:  задачис
разобраться:  разобраться разберёмся разобрались
правило:  правила правило
функциия:  функциии
сверхсложный:  сверхсложного
степенной:  степенного степенные
функцийдвуха:  функцийдвух
выборка:  выборке
невозможо:  невозможо
функцийнесколький:  функцийнескольких
возникнуть:  возникнуть
левый:  левее лево левую
обозначить:  обозначен обозначенные
множественнойлинейный:  множественнойлинейной
распределение:  распределение распределения
четверть:  четвертях
прорисоваться:  прорисовалась
задавать:  задаёт задают задает задаваемые
весь:  всему
пить:  пил
задачипо:  задачипо
востребовать:  востребованную
приблизить:  приближенные
сложить:  сложить
изучить:  изучить
образец:  образец
зависимый:  зависимые
отклонение:  отклонение
таблица:  таблицы
произведение:  произведение
старый:  старая
кто:  кому
случайный:  случайных случайные
дуга:  дуги
численно:  численно
отрезкать:  отрезкав
дивергенция:  дивергенция
сайт:  сайт сайте сайты сайта
наш:  наш наша
графика:  графики графика
оформление:  оформления
корень:  корнями корней
идти:  идёт
шоть:  шото
возрастание:  возрастание
эмпирический:  эмпирические
расстановка:  расстановке
найтись:  нашлось
аналогично:  аналогично
научиться:  научитесь научиться
иррациональный:  иррациональных
отличный:  отличный
квадратичнуюформ:  квадратичнуюформу
карта:  карта
гипербола:  гипербола гиперболами
несложный:  несложная
равно:  равно
сменить:  сменить
они:  ними
право:  право
зачёт:  зачёт
логика:  логики
спирмена:  спирмена
интегрирование:  интегрированием интегрирование интегрирования
вид:  виду виды вид виде
специально:  специально
определять:  определяет
преимущество:  преимуществом
лишь:  лишь
грамотный:  грамотную
обход:  обхода обход
св:  св
сумма:  суммы сумму сумма
предыдущий:  предыдущих
четыре:  четырёх
достаточно:  достаточно
споловинить:  споловинить
показательный:  показательное
преобразование:  преобразования преобразований
вслепую:  вслепую
соответствовать:  соответствует соответствуют
диффура:  диффурами
соответствующий:  соответствующие
этот:  эта
весьма:  весьма
поточечный:  поточечное поточечно
представлять:  представляет
статистика:  статистика
подставлять:  подставляем
биномиальный:  биномиальное
вундеркинд:  вундеркиндов
редкий:  реже
определить:  определили
линиюв:  линиюв
самостоятельный:  самостоятельного
обыкновенный:  обыкновенным
отношение:  отношении
прилагаться:  прилагаться
смысл:  смысл смыслом
дуприближённо:  дуприближённо
асимптота:  асимптоты
каноничность:  каноничность
ветвь:  ветвей ветвь ветви
рулить:  рулит
событие:  события
повторный:  повторные повторных повторным
состоять:  состоит
данный:  данную данном данный
сам:  сами самому
фнп:  фнп
простейшее:  простейшие
конец:  конце
двойной:  двойные двойной двойными двойного
несобство:  несобств
нелинейный:  нелинейная
течение:  течение
преобразованиеквадратичный:  преобразованиеквадратичной
навык:  навыками
функциональный:  функциональные
переходить:  переходить
освоить:  освоить
выяснить:  выясните
абсолютный:  абсолютная
тот:  тому те той ту
сложенияй:  сложенияи
сказать:  сказано
самый:  самые самое
регрессия:  регрессии регрессия
взять:  возьмите взять
ограничить:  ограничена
обладать:  обладать обладают
исчисление:  исчисления
локальный:  локальная
отрицательный:  отрицательным
настоятельно:  настоятельно
ожидание:  ожидание
лаплас:  лапласа
такой:  таким такое такая таких
перегиб:  перегиба
сходимость:  сходимости сходимость
координатный:  координатных
ду:  ду
далее:  далее
делать:  делать
коэффициент:  коэффициент
дробь:  дробей
собственный:  собственные
признак:  признак признаки
поэтому:  поэтому
практика:  практике
разделить:  разделить разделив
вместо:  вместо
малиновый:  малиновая
никакой:  никаких
находиться:  находилась
асимметрия:  асимметрия
главный:  главную
представимый:  представим
собственно:  собственно
замена:  замены
сканировать:  сканировать
тройной:  тройными тройные
одиночный:  одиночные
маленький:  меньше
например:  например
решенияопределённый:  решенияопределенных
выглядеть:  выглядит
задаваться:  задаётся задается
хотя:  хотя
выражать:  выражаем
другой:  другими другие
коэффициентковариация:  коэффициентковариации
абсцисса:  абсцисс
случай:  случаев случае случаях
лопиталя:  лопиталя
коричневый:  коричневая
крайне:  крайне
обычно:  обычно
недопонимание:  недопонимание
поляформула:  поляформула
фехнера:  фехнера
эффективный:  эффективные эффективен
туговато:  туговато
условный:  условные
эллипс:  эллипс
развеять:  развеять
ноль:  ноль
даламбер:  даламбера
теорема:  теоремы
факт:  факт
повторнойя:  повторнойи
естественно:  естественно
комплексный:  комплексные комплексного комплексный комплексными
ранг:  ранг
кривая:  кривой
тяжестиплоска:  тяжестиплоской
относительно:  относительно
причудливый:  причудливая
держать:  держите держим
первый:  первых первом первого первый
внимание:  внимание
непривычно:  непривычно
повторить:  повторить
лейбниц:  лейбница
поток:  поток
ботан:  ботана
недавно:  недавно
медиана:  медиана
потратить:  потратить
бывать:  бывает
записать:  записать
обходить:  обходим
направлениюй:  направлениюи
использовать:  использовать используйте
гостевой:  гостевая
скоро:  скоро
кроме:  кроме
разъяснение:  разъяснения
равный:  равен равна
понятно:  понятно
искомый:  искомой
внутригрупповаяй:  внутригрупповаяи
формулировка:  формулировке
он:  нём
алгебра:  алгебры
рабочий:  рабочая
мешать:  мешает
существовать:  существует
прямоугольник:  прямоугольников
эксцессэмпирический:  эксцессэмпирического
выбрать:  выбрать выберем выбрали
типовой:  типовое
ознакомиться:  ознакомился
оценка:  оценка оценки
криволинейный:  криволинейные
различный:  различных
светить:  светить
библиотека:  библиотека
трудность:  трудностей трудность
наименьшеезначение:  наименьшеезначения
сила:  силы
вычислимый:  вычислим
запросто:  запросто
системылинейный:  системылинейных
нужно:  нужно
чистовой:  чистового
страшно:  страшно
зависимость:  зависимость
похожий:  похожий
замкнутый:  замкнутому
должный:  должен должно
очевидный:  очевидно
немедленно:  немедленно
проходить:  проходит
показатель:  показатели
площадьс:  площадьс
обнадёжить:  обнадёжу
большинство:  большинстве
убыванией:  убываниеи
повышенный:  повышенной
статистический:  статистическая статистические
также:  также
рациональный:  рациональные
обещать:  обещанная
крепко:  крепко
интервальный:  интервальный
итак:  итак
соответственно:  соответственно
среднее:  среднем
рука:  руку
подставить:  подставили подставьте подставить
оценкия:  оценкии
неявный:  неявной
несобственныхинтеграл:  несобственныхинтегралов
вероятностибиномиальный:  вероятностибиномиального
род:  рода
гаусс:  гаусса
честно:  честно
точно:  точно
экстремальный:  экстремальные
играть:  играть
студент:  студентов студенты
нормаль:  нормали
определитель:  определитель
выпуклость:  выпуклость
элемент:  элементы
отсюда:  отсюда
интересно:  интересно
сложность:  сложности
значенияй:  значенияи
глупый:  глупая
занять:  займет
кстати:  кстати
труд:  труда
классическоеопределение:  классическоеопределение
инормаль:  инормаль
радиус:  радиуса
особый:  особого
пирамида:  пирамида
информация:  информацию
автор:  автор автора
ссылка:  ссылки
отмечать:  отмечал
уравненияс:  уравненияс
онлайн:  онлайн
геометрия:  геометрии геометрия
использоваться:  используется
нуль:  нуля
работа:  работа
выбор:  выборе
узнать:  узнаете
новый:  новому
произвольныйтройный:  произвольныйтройной
ниже:  ниже
поставить:  поставлен
дизайн:  дизайна
это:  это
беспокойство:  беспокойство
указать:  указал
поляй:  поляи
опечатка:  опечатку
выгодный:  выгоднее
речь:  речь
странный:  странный
вызывать:  вызывает
методомоперационный:  методомоперационного
бесповторный:  бесповторной
наверняка:  наверняка
правильно:  правильно
л:  л
вещь:  вещь
важно:  важно
график:  графиков график
снизу:  снизу
касательный:  касательных
значение:  значения
разбираться:  разбираемся
запомнить:  запомните
типовыхзадача:  типовыхзадач
ранговойкорреляция:  ранговойкорреляции
исследовать:  исследовать
поверхность:  поверхности
составить:  составить составит
лист:  листьев
линейныйкоэффициент:  линейныйкоэффициент
приступать:  приступаем
исходный:  исходные исходных
несобственныйинтеграл:  несобственныйинтеграл
просветить:  просветить
доступно:  доступно
причём:  причём
логично:  логично
учиться:  учимся
печальный:  печальную
претензия:  претензией
ипример:  ипримеры
множество:  множества
поверхностный:  поверхностные
пуассон:  пуассона
успех:  успехов
однако:  однако
фактически:  фактически
математическоеожидание:  математическоеожидание
школа:  школа
симметричный:  симметричен
браться:  берётся
неоднородный:  неоднородные
необходимо:  необходимо
вычислять:  вычислять
расставлять:  расставлять
запугать:  запугать
системудифференциальный:  системудифференциальных
набить:  набить
изначально:  изначально
голубой:  голубой
алгоритм:  алгоритм
последовательность:  последовательностей
квадратичный:  квадратичные
просканировать:  просканировать
проверить:  проверить
поскольку:  поскольку
гипергеометрическоераспределение:  гипергеометрическоераспределение
раз:  раза
обратить:  обратите
сложно:  сложно
подойти:  подошел
недоразумение:  недоразумения
понятие:  понятие
подробно:  подробно
равномерный:  равномерная равномерное
треугольный:  треугольная
коварный:  коварная
пожалуйста:  пожалуйста
записываться:  записывается
вдоль:  вдоль
себя:  собой
квадрат:  квадратов
наивный:  наивная
сразу:  сразу
функциюкомплексный:  функциюкомплексной
напоминать:  напоминаю
приложение:  приложение
мода:  мода
свойстваэлементарный:  свойстваэлементарных
остановиться:  остановился
калькулятор:  калькулятор
принять:  принять
обозначение:  обозначениях
знакомиться:  знакомиться
действительно:  действительно
чётный:  чётной
экстремум:  экстремумы
постараться:  постараюсь
горнера:  горнера
ошибочно:  ошибочно
получать:  получаем
функцийв:  функцийв
видеть:  видите
довольно:  довольно
интегрировать:  интегрировать
кубический:  кубическую
начинать:  начинаем
чертить:  чертить
ощутить:  ощутите
лёгкий:  легче
три:  трёх
дискретнойслучайный:  дискретнойслучайной
конечный:  конечного
останавливаться:  останавливаться
крамер:  крамера
немало:  немало
освоение:  освоения
начало:  начале
расправляться:  расправляемся
молодой:  молодого
базовый:  базовые
строго:  строго
внешний:  внешний внешнего
пора:  пора
функциидвуха:  функциидвух
запретить:  запрещено
черновик:  черновике
емелин:  емелин
насущный:  насущного
вычисленияопределенный:  вычисленияопределенных
выдать:  выдам
задачин:  задачина
представляться:  представляется
отдельность:  отдельности
системый:  системыи
удовлетворяетлить:  удовлетворяетли
присказка:  присказка
направление:  направления
тригонометрический:  тригонометрических
помочь:  помогут
встречаться:  встречается
конкретный:  конкретный
сжатый:  сжатые
заданав:  заданав
всё:  всё
деление:  деления
контуруформула:  контуруформула
пациент:  пациента
дело:  дела дело
рекомендовать:  рекомендую
независимый:  независимые
первообразный:  первообразную
менять:  меняем
корреляция:  корреляции
заочник:  заочников
подынтегральный:  подынтегральная
максимально:  максимально
говорить:  говоря
повторять:  повторяем
