третий:  третьим третий
основный:  основными
нечётность:  нечётность
часовой:  часовой
справка:  справка
неоднократно:  неоднократно
производный:  производные производная производной производную
предел:  предел пределами пределы пределов
числовой:  числовые
производныенеявно:  производныенеявно
длинный:  длиннее
значение:  значение значения
обозначать:  обозначают обозначает
сосед:  сосед
находить:  находить находим
движение:  движение
формула:  формулы формулой формуле формулам формула формулах формулу
смотреть:  см
сюда:  сюда
отрицательный:  отрицательный отрицательной отрицательного
прийтись:  придётся
канонический:  каноническому
два:  две двум двумя двух
дифференциал:  дифференциалах дифференциала
больший:  наибольшее
известно:  известно
многие:  многие
один:  одну одно одного одна
радиан:  радиан радианах
важный:  важной важный важным
число:  число числами числа
вогнутостья:  вогнутостьи
многий:  многих
курий:  курьих
выяснить:  выяснить выясним
случай:  случай случая случаев случае
плохой:  хуже
профессия:  профессию
условие:  условии условие условия условию
находиться:  находиться
озёрный:  озёрной
неясно:  неясно
удобно:  удобно
умножение:  умножения
совпадать:  совпадающих совпадают совпадать
выполнимый:  выполним
система:  система системе систему системы
группировка:  группировок группировка
условнаясходимость:  условнаясходимость
направлять:  направляющего направляющие направляющий направляющими направляющих направляющим направляющему
слово:  словами
угол:  угол угла углы углов угле углом
александр:  александр
зал:  зал
проходить:  проходящей проходит
лист:  листа
этюд:  этюд
линейный:  линейные линейная линейных линейной
коэффициент:  коэффициентов коэффициентом коэффициент коэффициенты
равенство:  равенство равенством равенства
согласие:  согласия
дуоперационный:  дуоперационным
верблюд:  верблюд
базис:  базисах базису базис
никто:  никто
раздел:  разделу
оговорка:  оговорка оговорку
зависимостьвектор:  зависимостьвекторов
снова:  снова
сначала:  сначала
метод:  методы методом метод
страница:  страницу
творческий:  творческими
математический:  математическая математические математический математической
данные:  данных
умножить:  умножено умножен умножить
ось:  оси
прямой:  прямых прямая прямой прямые прямыми прямую
искать:  искать
интеграл:  интеграл интегралов интегралы интеграла интеграле
урок:  урока урок уроке
разложение:  разложением разложение
типовой:  типовой типовые
стоптать:  стоптана
уравнение:  уравнению уравнения уравнение уравнением уравнениями уравнений
дуга:  дугой дуги
переход:  переход
подойти:  подойти подойдёт
указывать:  указывать указываем
разбор:  разбор
обычный:  обычным
желательно:  желательно
первый:  первое первым первой первому первого первый
препятствие:  препятствий
практический:  практических
малый:  малые наименьших меньший
связь:  связь связи
понятие:  понятием понятие
точка:  точку точки точка точкам точке
лямбда:  лямбда
нормальный:  нормальное нормальный
интегральнаятеорема:  интегральнаятеоремы
корнимногочлен:  корнимногочлена
логарифмический:  логарифмическая
начать:  начнём начать начните
основной:  основные
бернулли:  бернулли
нужный:  нужен нужном нужной
полярный:  полярные полярных полярной
рассмотреть:  рассмотрим рассмотренную рассмотрели рассмотренной
ряд:  ряды ряда ряд рядов
уровень:  уровня
должный:  должны должным должно
значительно:  значительно
доверительный:  доверительные
буква:  буквой
сентябрьский:  сентябрьской
среднееквадратический:  среднееквадратическое
чертёж:  чертежу чертежа чертёж чертеже
комбинационный:  комбинационная
следовать:  следуют следует
обращаться:  обращается
декартов:  декартовой декартовы
смешанноепроизведение:  смешанноепроизведение
заметный:  заметные
функция:  функции функция функций
очередной:  очередной
дисперсия:  дисперсия дисперсии дисперсию
проверка:  проверки проверку проверка
постараться:  постарайтесь
середина:  серединой середины
школьный:  школьный школьной
греческий:  греческой
мы:  нам нами
принадлежащий:  принадлежащую
образ:  образом
непрерывнаяслучайный:  непрерывнаяслучайная
прямо:  прямо
длина:  длина
усмотреть:  усмотреть
немного:  немного
мочь:  могут
знакопостоянство:  знакопостоянства
неплохо:  неплохо
попробовать:  попробуйте
градиент:  градиент
посетить:  посетить посетите
красный:  красного красной
трудность:  трудности
линия:  линия линии линиями
ро:  ро
тягаться:  тягаться
комбинаторика:  комбинаторике
случайнаявеличина:  случайнаявеличина
исследование:  исследовании исследование
бесконечно:  бесконечно
числитель:  числитель
форма:  формы
задача:  задачу задаче задачи задач задачах задача
отметить:  отметить
несовместный:  несовместна несовместные
статья:  статьи статья статью
прокрутка:  прокрутки
обратный:  обратную обратная обратной
рассматривать:  рассматривать рассматривали
клетка:  клетки
шапочка:  шапочку
готовый:  готовых
просто:  просто
ещё:  ещё
вернуться:  вернёмся
наказывать:  наказывает
быть:  буду будут будем
зелёный:  зелёный
посмотреть:  посмотрите
частый:  чаще
калькулятор:  калькулятора калькулятор
данный:  данного данном
непрерывный:  непрерывных непрерывная
сложённый:  сложены
распространить:  распространён
производныефункция:  производныефункции
средний:  средняя
пересечение:  пересечения
знак:  знаком знак знаки
шаг:  шагах шага
область:  области область
полоса:  полоса
кликабельный:  кликабельное
уместно:  уместно
математик:  математика
переменный:  переменных переменной
пример:  пример примера примеры
независимыеслучайный:  независимыеслучайные
научиться:  научились научитесь научиться
никакой:  никакого
следовательно:  следовательно
модель:  модель модели
минус:  минус минусы
непрерывность:  непрерывность
догадаться:  догадаться
способ:  способами способа способом способов способ
программа:  программы
функциис:  функциис
полный:  полной полных полное
зеркало:  зеркало
значит:  значит
пирсон:  пирсона
вопрос:  вопрос вопросы
вода:  воде
геометрический:  геометрических геометрический геометрическая геометрическое
межгрупповой:  межгрупповая
ортогональный:  ортогональное ортогональны
похожий:  похож
нсв:  нсв
схема:  схему схема
здорово:  здорово
любительница:  любительница
вроде:  вроде
рациональный:  рациональный рациональные
быстро:  быстро
упасть:  упал
развернуться:  развернётся
задать:  заданные заданной заданы задайте задана заданными
отрезка:  отрезке
величина:  величина величин величины
запись:  запись
заведомо:  заведомо
оглавление:  оглавление
короче:  короче
прорешать:  прорешать
она:  неё
детерминация:  детерминации
обязательно:  обязательно
следующий:  следующие следующих
выполнить:  выполнить
дифференциальныеуравнение:  дифференциальныеуравнения
параллельный:  параллельной параллельна параллельную параллельны параллельными
постоянный:  постоянных
стокс:  стокса
член:  члена
самостоятельно:  самостоятельно
соотношение:  соотношения
небо:  небо
дробовик:  дробовик
пункт:  пунктам пункт
математика:  математике математики
векторный:  векторное векторного
сделать:  сделана
вероятностия:  вероятностии
скалярный:  скалярное скалярного
совершенно:  совершенно
значимость:  значимости
страшный:  страшного
анализ:  анализа анализ
построение:  построения построение
её:  её
частный:  частное частные
парный:  парной
дойти:  дойти
найти:  найдём найдем найденное найти
несколько:  несколько
сборник:  сборники
параметрический:  параметрическом параметрической
дать:  данному данная данные данной
часто:  часто
выполняться:  выполняются выполнялись
иррациональность:  иррациональности
увлекательный:  увлекательное
получаться:  получается
надеяться:  надеюсь
решение:  решение решением решения решений
форум:  форум форуме
наш:  наши наше наш наша
книга:  книги книга
провести:  провести
цивилизовать:  цивилизованная
ориентировать:  ориентированный ориентированным ориентированном
устно:  устно
задание:  задание
вектор:  векторы вектору вектором векторов вектора векторами вектор
вращение:  вращения
именно:  именно
копирование:  копирование
разрыв:  разрыва
выражение:  выражения
положительный:  положительный положительным
оранжевый:  оранжевый оранжевое
отблагодарить:  отблагодарить
являться:  являются является
байес:  байеса
простой:  проще прост простейшей
решать:  решать решают
перепрыгивать:  перепрыгивают
симметричный:  симметрична симметричную
без:  безо
точность:  точности
результат:  результат результатами
теория:  теория теории
выйти:  выйдет
двумерный:  двумерная
тело:  тела
циркуляция:  циркуляция
непосредственно:  непосредственно
плоскость:  плоскости плоскость
общий:  общим общая общем общими
получиться:  получится получившийся получился получиться
определителяй:  определителяи
неизвестный:  неизвестными неизвестную
закон:  законы
дробь:  дроби дробей
самый:  самым самый самое
качество:  качестве
действие:  действий действия действием
утаивать:  утаивать
вероятность:  вероятностей вероятность вероятности
любой:  любое любой
уравненийв:  уравненийв
узнать:  узнали узнать
иметь:  имеют имеет
семиклассник:  семиклассники
грин:  грина
суть:  сути
эйлер:  эйлера
логический:  логическим
взаимосвязь:  взаимосвязь
каждый:  каждого каждое каждому
остальной:  остальные
придерживаться:  придерживаться
дискретный:  дискретный
бессмертный:  бессмертного бессмертному
знакочередоваться:  знакочередующиеся
камень:  камень
сохранить:  сохраню
произвольный:  произвольных
сложный:  сложной сложные сложных
советовать:  советовал
фурье:  фурье
поле:  поля
гипотеза:  гипотез гипотеза гипотезы
свойство:  свойства
врасплох:  врасплох
неперпендикулярность:  неперпендикулярности
вариация:  вариации
основа:  основы
мало:  мало
интервал:  интервалы
кош:  коши
свободный:  свободных
соответствующий:  соответствующих соответствующие
чайник:  чайников
вычисленияс:  вычисленияс
аналитический:  аналитический аналитическая аналитическим аналитическую аналитической
разобрать:  разобраны
ориентация:  ориентацию ориентации ориентацией
матричный:  матричные матричных матричный
всякий:  всяких всякого всякий
заметить:  заметили
навык:  навыки
ответ:  ответе ответ ответы
однородный:  однородные однородным
вычислить:  вычислить вычисленное
очень:  очень
матрица:  матрицу матрицы матрицами
испытанияй:  испытанияи
интегралыть:  интегралыв
перегруппировка:  перегруппировка
пропорциональность:  пропорциональности пропорциональность
помощь:  помощью
вариационный:  вариационный
распутье:  распутье
конец:  концов конце концу
элементарный:  элементарных
арккосинус:  арккосинус
жесть:  жесть
блог:  блог
избушка:  избушка
очки:  очками
высокий:  высших высшей высшая
произведение:  произведения произведение
вывод:  выводу вывод
единственный:  единственной
пространство:  пространстве
сурово:  сурово
снимать:  снимаем снимает
удобный:  удобный удобного
путь:  путь
курс:  курс
подбирать:  подбираю
координата:  координаты координат координатах
ордината:  ординат
обозначить:  обозначенный обозначу обозначим
сообщить:  сообщите
понижение:  понижение понижением
определить:  определить определён определят
выражаться:  выражается
центр:  центр
сложение:  сложения
применимый:  применима
считаться:  считается
пересекаться:  пересекаются пересекается пересекающиеся пересекающимися пересекаться
затем:  затем
релаксация:  релаксация
линейнойкорреляционный:  линейнойкорреляционной
время:  время
приобрести:  приобретенную
особо:  особо
тупой:  тупой тупым
распределениякритерия:  распределениякритерий
отлично:  отлично
подсказать:  подскажу
использовать:  использован используем использовать используйте
несобственный:  несобственные
откуда:  откуда
касательная:  касательная
задачис:  задачис
разбить:  разбить
правило:  правила правило
дух:  духа
функциия:  функциии
аксессуар:  аксессуары
степенной:  степенного степенные
функцийдвуха:  функцийдвух
выборка:  выборке
сам:  сама сами самих
таковой:  таковым
угловой:  угловых угловой угловые угловым
наработать:  наработать
функцийнесколький:  функцийнескольких
возникнуть:  возникнуть
градус:  градусов градусах
приступить:  приступим
точный:  точное точный
множественнойлинейный:  множественнойлинейной
зависимость:  зависимости зависимость
тема:  темы
оптимальный:  оптимальным
распределение:  распределение распределения
этот:  этому
загадка:  загадок
малиновый:  малиновый
считать:  считанные считать
решить:  решим решить
задачипо:  задачипо
обыкновенный:  обыкновенные обыкновенной
востребовать:  востребованную
приблизить:  приближенные
промежуточный:  промежуточными
микрокалькулятор:  микрокалькулятор
примечание:  примечание
застать:  застать
зависимый:  зависимые
путём:  путём
отклонение:  отклонение
избавиться:  избавиться
таблица:  таблицы
знать:  знаете
вполне:  вполне
случайный:  случайных случайные
частность:  частности
посоветовать:  посоветую
отрезкать:  отрезкав
река:  реки
вид:  видами виду виды виде
дивергенция:  дивергенция
опытный:  опытных
полёт:  полётов
сайт:  сайт сайты сайта
графика:  графики графика
думать:  думал думаю
путешествие:  путешествие
идти:  идёт
причина:  причине
возрастание:  возрастание
эмпирический:  эмпирические
запарить:  запаренный
который:  который которая которым
найтись:  нашлось
арктангенс:  арктангенса
заглохнуть:  заглохла
нулевой:  нулевые нулевая
почленный:  почленного
иррациональный:  иррациональных
определение:  определению определения
квадратичнуюформ:  квадратичнуюформу
ваш:  вашу
карта:  карта
вычисление:  вычисления вычисление вычислениях
гипербола:  гипербола
загвоздка:  загвоздка
равно:  равно
начертить:  начертить
сменить:  сменить
заострять:  заострять
они:  ними
логика:  логики
материал:  материалов материалы
спирмена:  спирмена
пропорциональный:  пропорциональны
разогнать:  разогнать
св:  св
второй:  второго второму второй
этап:  этапов
секунда:  секунды
пара:  пара
достаточно:  достаточно
показательный:  показательное
преобразование:  преобразования преобразований
перпендикулярный:  перпендикулярных перпендикулярной перпендикулярна перпендикулярны перпендикулярные перпендикулярную перпендикулярного
удаться:  удалось
диффура:  диффурами
почленно:  почленно
бодрый:  бодрое
весьма:  весьма
статистика:  статистика
бумага:  бумаге
биномиальный:  биномиальное
линиюв:  линиюв
самостоятельный:  самостоятельного
отношение:  отношении
хотеться:  хочется
второе:  второе
фундамент:  фундамент
смысл:  смысл смысла
дуприближённо:  дуприближённо
подход:  подхода
асимптота:  асимптоты
событие:  события
повторный:  повторные
знакомый:  знакома
б:  б
состоять:  состоит
встречаться:  встречаться
вышесказанный:  вышесказанного
фнп:  фнп
измерить:  измерить
графический:  графический
простейшее:  простейшие
иной:  иными
часть:  частям части
двойной:  двойные двойной
встреча:  встреч
несобство:  несобств
известный:  известны
нелинейный:  нелинейная
применить:  применить
линейка:  линейкой
преобразованиеквадратичный:  преобразованиеквадратичной
функциональный:  функциональные
абсолютный:  абсолютная
коллинеарность:  коллинеарность
сложенияй:  сложенияи
сказать:  сказано
подбор:  подбора
регрессия:  регрессии регрессия
расстояние:  расстояние
исчисление:  исчисления
подходящий:  подходящие
уйти:  уйдёт
локальный:  локальная
ожидание:  ожидание
лаплас:  лапласа
такой:  таким такое такого таких
перегиб:  перегиба
единица:  единицам
сходимость:  сходимости сходимость
ход:  ходу
ду:  ду
делать:  делать
неопределённый:  неопределенный неопределенном
удовлетворять:  удовлетворять удовлетворяет
приходить:  приходим
начаться:  началась
собственный:  собственные
признак:  признак признаки
открутка:  открутка
зачитать:  зачитал
правильный:  правильный
поэтому:  поэтому
поработать:  поработали
асимметрия:  асимметрия
энергетика:  энергетику
главный:  главную
целесообразный:  целесообразнее
сводиться:  сводящиеся
замена:  замены
алгоритм:  алгоритма алгоритм
составить:  составим составленный составить
получить:  полученное получить полученному получи
заложить:  заложим
например:  например
решенияопределённый:  решенияопределенных
выглядеть:  выглядит
хотя:  хотя
коэффициентковариация:  коэффициентковариации
путешественник:  путешественников
косяк:  косяк
красивый:  красивее
вытаскивать:  вытаскиваем
тривиальный:  тривиальна
лопиталя:  лопиталя
неплохой:  неплох
параллельность:  параллельность
поменять:  поменять
поляформула:  поляформула
просить:  прошу
фехнера:  фехнера
эффективный:  эффективные
условный:  условные
эллипс:  эллипс
ноль:  ноль
стрелка:  стрелке стрелкой
пи:  пи
сократить:  сократить
отрезок:  отрезка
вычитать:  вычитать
приближённый:  приближённое
даламбер:  даламбера
теорема:  теоремы
повторнойя:  повторнойи
рассказать:  рассказал
комплексный:  комплексные комплексного комплексный комплексными
выручать:  выручает
пойти:  пойду
ранг:  ранг
кривая:  кривой
тяжестиплоска:  тяжестиплоской
относительно:  относительно
хором:  хором
построить:  построить
внимание:  внимание
лейбниц:  лейбница
неравенство:  неравенства
поток:  поток
недавно:  недавно
медиана:  медиана
перпендикуляр:  перпендикуляру
направлениюй:  направлениюи
гостевой:  гостевая
скоро:  скоро
переписать:  перепишем
кроме:  кроме
аккуратно:  аккуратно
понятно:  понятно
искомый:  искомой
внутригрупповаяй:  внутригрупповаяи
формулировка:  формулировке
алгебра:  алгебры
сумма:  сумму сумма
исходить:  исходя
существовать:  существует существуют
прямоугольник:  прямоугольников
эксцессэмпирический:  эксцессэмпирического
указатель:  указателями
оценка:  оценка оценки
криволинейный:  криволинейные
различный:  различных
подпевать:  подпевает
библиотека:  библиотека
идея:  идея
наименьшеезначение:  наименьшеезначения
сила:  силы
вычислимый:  вычислим
запросто:  запросто
кащей:  кащея
системылинейный:  системылинейных
нужно:  нужно
купаться:  купаться
видеть:  вижу
другой:  другие
море:  море
замкнутый:  замкнутому
очевидный:  очевидно
цэ:  цэ
проверить:  проверим проверить
показатель:  показатели
рамка:  рамках
площадьс:  площадьс
полезный:  полезная
большинство:  большинстве
убыванией:  убываниеи
повышенный:  повышенной
статистический:  статистическая статистические
также:  также
интегрирование:  интегрирование
легко:  легко
предыдущий:  предыдущий
поставить:  поставлю
купить:  купил
интервальный:  интервальный
противоположно:  противоположно
вообще:  вообще
оценкия:  оценкии
неявный:  неявной
несобственныхинтеграл:  несобственныхинтегралов
вероятностибиномиальный:  вероятностибиномиального
подобраться:  подобрались
род:  рода
гаусс:  гаусса
вышка:  вышке
честно:  честно
скорый:  скорых
экстремальный:  экстремальные
нормаль:  нормали
определитель:  определитель
желать:  желающие
выпуклость:  выпуклость
элемент:  элементы
знаменатель:  знаменатель знаменателе
принципиально:  принципиально
сложность:  сложности
перпендикулярность:  перпендикулярности
значенияй:  значенияи
отличаться:  отличаются
справедливо:  справедливо
кстати:  кстати
номер:  номером
классическоеопределение:  классическоеопределение
инормаль:  инормаль
далёкий:  дальше
упростить:  упрощено
пирамида:  пирамида
помнить:  помните
отменять:  отменял
автор:  автор автора
цель:  целях
дифференциальный:  дифференциальные
уравненияс:  уравненияс
онлайн:  онлайн
геометрия:  геометрии геометрия
использоваться:  используется
тридесятый:  тридесятом
работа:  работа
новый:  новому
произвольныйтройный:  произвольныйтройной
дизайн:  дизайна
это:  это
поляй:  поляи
опечатка:  опечатку
кащий:  кащею
продолжать:  продолжаем
неудивительный:  неудивительно
речь:  речь
продолжаться:  продолжается
познакомиться:  познакомились
методомоперационный:  методомоперационного
разработка:  разработка
бесповторный:  бесповторной
ошибка:  ошибку
л:  л
обойтись:  обойтись
помочь:  поможет
коллинеарный:  коллинеарны коллинеарных
ед:  ед
взять:  взять возьму
касательный:  касательных
запомнить:  запомните
тот:  той
типовыхзадача:  типовыхзадач
ранговойкорреляция:  ранговойкорреляции
подсказывать:  подсказывает
расположение:  расположение
смекалка:  смекалку
исследовать:  исследовать
нетрудно:  нетрудно
порядок:  порядке порядка порядков
поверхность:  поверхности
незнание:  незнание
последний:  последним
линейныйкоэффициент:  линейныйкоэффициент
нахождение:  нахождении
несобственныйинтеграл:  несобственныйинтеграл
доступно:  доступно
причём:  причём
учиться:  учимся
задавать:  задаваемые
ничто:  ничем
напоминать:  напоминает
ипример:  ипримеры
множество:  множества
позволять:  позволяющий
поверхностный:  поверхностные
фигура:  фигуры
пуассон:  пуассона
однако:  однако
приговор:  приговор
отрицательно:  отрицательно
математическоеожидание:  математическоеожидание
школа:  школа
неоднородный:  неоднородные
основать:  основано
проверять:  проверяем
пристальный:  пристальное
вычесть:  вычтено
оформить:  оформить
обратить:  обратим
кратное:  кратные
системудифференциальный:  системудифференциальных
изначально:  изначально
развернуть:  развернём
масштаб:  масштабе
традиционно:  традиционно
рабочий:  рабочие
последовательность:  последовательностей
квадратичный:  квадратичные
объём:  объем
направление:  направление
поскольку:  поскольку
гипергеометрическоераспределение:  гипергеометрическоераспределение
подробно:  подробно
равномерный:  равномерная равномерное
треугольный:  треугольная
царство:  царстве
пожалуйста:  пожалуйста
принимать:  принимать
записываться:  записывается
квадрат:  квадратов
сразу:  сразу
функциюкомплексный:  функциюкомплексной
малоинтересный:  малоинтересен
продолжение:  продолжением
мода:  мода
свойстваэлементарный:  свойстваэлементарных
дэ:  дэ
усталость:  усталость
оба:  оба
башмак:  башмаков
определённый:  определенный определенного
взаимный:  взаимное
предлагать:  предлагаю предлагать
действительно:  действительно
экстремум:  экстремумы
приниматься:  принимается
горнера:  горнера
функцийв:  функцийв
негативный:  негативную
упаковка:  упаковка
место:  местами
лишний:  лишним
подставить:  подставить
три:  трёх
дискретнойслучайный:  дискретнойслучайной
фокус:  фокус
короткий:  короткий
словно:  словно
иллюстрация:  иллюстрация
типичный:  типична
буквально:  буквально
крамер:  крамера
маршрут:  маршрутом
ножка:  ножках
парабола:  парабола
запретить:  запрещено
к:  ко
функциидвуха:  функциидвух
рисунок:  рисунке
емелин:  емелин
широко:  широко
вычисленияопределенный:  вычисленияопределенных
краткий:  кратчайшим
задачин:  задачина
замечательный:  замечательные
удовлетворяетлить:  удовлетворяетли
системый:  системыи
сегодня:  сегодня
тригонометрический:  тригонометрических
конкретный:  конкретный
заданав:  заданав
всё:  всё
клетчатый:  клетчатой
тройной:  тройные
кирпич:  кирпич
деление:  деления
автоматически:  автоматически
контуруформула:  контуруформула
некоторый:  некоторые
график:  график
дело:  дела дело
тетрадный:  тетрадного
эм:  эм
незатейливый:  незатейливо
транспортир:  транспортир
либо:  либо
рекомендовать:  рекомендую
независимый:  независимые
привести:  привести
корреляция:  корреляции
заочник:  заочников
говорить:  говоря
повторять:  повторяем
