чертёж:  чертежом чертежи чертёж чертеже
техника:  технику
поставить:  поставлена
ребро:  рёбрах ребром
производный:  производные производная производной производную
слагаемое:  слагаемое слагаемые
предел:  предел пределы пределов
небольшой:  небольшой
ввиду:  ввиду
тонус:  тонусе
выбор:  выбор
числовой:  числовые
производныенеявно:  производныенеявно
значение:  значение
обозначать:  обозначают
находить:  находить находим
найтись:  нашлись нашлось
игрек:  игрек
формула:  формулы формулам формула формулу
смотреть:  см смотрим
обеспечить:  обеспечена
канонический:  каноническому
два:  две двум двумя
отрезок:  отрезках
дифференциал:  дифференциалах дифференциала
больший:  наибольшее
многие:  многие
подробный:  подробные
наполнить:  наполним
число:  число числом числами числа
вогнутостья:  вогнутостьи
становиться:  становится
математический:  математическую математическая математические математической
случай:  случай случаи случае
профессия:  профессию
удобно:  удобно
умножение:  умножения
выполнимый:  выполним
система:  система системе систему системы
группировка:  группировок группировка
познакомиться:  познакомимся
поверхность:  поверхностями поверхностью поверхности
условнаясходимость:  условнаясходимость
александр:  александр
остаться:  осталось оставшееся остаться оставшийся
традиционный:  традиционный
редко:  редко
линейный:  линейные линейная линейных линейной
ограничить:  ограничено ограничена
объём:  объём объёму объема объёма объёме объем
улица:  улице
согласие:  согласия
решать:  решаем решать
дуоперационный:  дуоперационным
базис:  базисах базису базис
цилиндрический:  цилиндрической цилиндрическую
предположить:  предположить
плотность:  плотность плотностью плотности
наиболее:  наиболее
зависимостьвектор:  зависимостьвекторов
снова:  снова
оно:  оно
сначала:  сначала
метод:  методы методом метод
страница:  страницу страницы
данные:  данных
архимед:  архимед
интеграл:  интеграл интегралу интегралов интегралами интегралах интегралы интеграла интеграле интегралам
урок:  урока
разложение:  разложением разложение
частный:  частную частное частные частных
икс:  икс
уравнение:  уравнению уравнения уравнение уравнений
мочь:  можете могут могу мог могли
переход:  переход переходе
внутрь:  внутрь
симметрия:  симметрии
обычный:  обычным
пивной:  пивной
советовать:  советую
существо:  существу
целесообразно:  целесообразно
малый:  малые наименьших
связь:  связь
точка:  точку точки точка точке
древнегреческий:  древнегреческого
подстановка:  подстановок подстановке подстановках подстановки
тяжесть:  тяжести
простой:  простая проще простейшую простейший простое простые попроще
нормальный:  нормальное
интегральнаятеорема:  интегральнаятеоремы
построить:  построенного построить
корнимногочлен:  корнимногочлена
логарифмический:  логарифмическая
основной:  основные
бернулли:  бернулли
единица:  единицу
полярный:  полярные полярных полярной
оказаться:  окажетесь
рассмотреть:  рассмотрим рассмотрели
ряд:  ряды ряда ряд рядов
уровень:  уровня уровнем
должный:  должны должно
посетитель:  посетителям
пользоваться:  пользоваться пользуясь
доверительный:  доверительные
буква:  буквой буквы буква
среднееквадратический:  среднееквадратическое
приложение:  приложениями приложения
говориться:  говорится
комбинационный:  комбинационная
учёный:  учёного
смешанноепроизведение:  смешанноепроизведение
функция:  функции функция функций функцию
сетка:  сетку
дисперсия:  дисперсия дисперсии дисперсию
проверка:  проверки проверку проверка
рассчитываться:  рассчитывается
решаться:  решалась решается
школьный:  школьный
треугольник:  треугольника треугольник
прямоугольный:  прямоугольный прямоугольного
принадлежащий:  принадлежащую
образ:  образом
непрерывнаяслучайный:  непрерывнаяслучайная
другой:  других другие
длина:  длина
тара:  тару
немного:  немного
знакопостоянство:  знакопостоянства
градиент:  градиент
равный:  равных равен равна
удачно:  удачно
линия:  линия линии линию линиями
внимание:  внимания внимание
просить:  просил
комбинаторика:  комбинаторике
случайнаявеличина:  случайнаявеличина
бесконечно:  бесконечно
форма:  формы
земля:  землю
задача:  задачу задачей задачи задач задачах задача
отметить:  отметить
статья:  статьи статье
загонять:  загоняют
обратный:  обратную обратная
дополнительный:  дополнительные дополнительного
читаемый:  читаем
готовый:  готовых готовая
три:  тремя трёх
просто:  просто
ещё:  ещё
тело:  тело тела телу
порядок:  порядком порядок порядка порядков
соответствовать:  соответствующую
нахождение:  нахождения нахождении
единый:  единым
очевидный:  очевидна очевидны очевиден
данный:  данного данном
непрерывный:  непрерывных непрерывная непрерывна
производныефункция:  производныефункции
средний:  средняя
интегрировать:  интегрировали интегрируем интегрировать
иксовыя:  иксовый
пересечение:  пересечения
попасть:  попали попала
заменить:  замените
область:  области область областей областью
поверхностный:  поверхностных поверхностные
плюс:  плюс
далеко:  далеко
математик:  математика
попробовать:  попробовать
переменный:  переменных переменным переменной переменные переменная
пример:  пример примеров примере примерах примеры
несовместный:  несовместные
независимыеслучайный:  независимыеслучайные
координатный:  координатными координатных координатной
модель:  модель модели
непрерывность:  непрерывность
функциис:  функциис
право:  правом
полный:  полной полных полное полная
зеркало:  зеркало
читатель:  читатели
значит:  значит
исходный:  исходная
пирсон:  пирсона
вопрос:  вопрос вопросы
утомлённый:  утомлённом
межгрупповой:  межгрупповая
ортогональный:  ортогональное
возрасти:  возрастёт
нсв:  нсв
отмечать:  отмечаем
стиль:  стиле
простыня:  простыня
положение:  положение положении
тетраэдр:  тетраэдра
рациональный:  рациональный рациональнее рациональные
упасть:  упал
дойти:  дошли
отрезка:  отрезке
величина:  величина величин величины
решение:  решению решение решением решения решений
запись:  запись
один:  одним одной
высота:  высоту
порадовать:  порадовать
детерминация:  детерминации
сторона:  стороны
обязательно:  обязательно
следующий:  следующие следующее следующего следующая следующему следующий
тот:  тех тому
начать:  начать
выполнить:  выполнить
энтузиаст:  энтузиасты
дифференциальныеуравнение:  дифференциальныеуравнения
четвертинка:  четвертинку
прямой:  прямая прямой прямую
постоянный:  постоянных постоянна
стокс:  стокса
схема:  схема
исключить:  исключён
боль:  боли
однородный:  однородно однородные однородным однородного
ручной:  ручной
самостоятельно:  самостоятельно
дробовик:  дробовик
математика:  математике математики
векторный:  векторное векторного
сам:  самом само
вероятностия:  вероятностии
скалярный:  скалярное
наш:  нашем наш
навести:  наведём
понятный:  понятен
значимость:  значимости
физический:  физическая физическими физические
мысленно:  мысленно
опора:  опоры
анализ:  анализа анализ
построение:  построения построение
её:  её
парный:  парной
сбоку:  сбоку
вычисление:  вычислении вычисления вычисление вычислений
примерный:  примерный
найти:  найдём найденную найти найдите
несколько:  несколько
сборник:  сборники
параметрический:  параметрическом параметрической
раскрыть:  раскрыть
молодец:  молодцы
часто:  часто
пояснять:  поясняю
промежуточный:  промежуточная промежуточные
получаться:  получается
хороший:  хороший хорошим
способ:  способа способом способов способ
грамм:  грамм
разрядиться:  разрядились
форум:  форум форуме
записывать:  записывать записываем
книга:  книги книга
наводить:  наводит
провести:  провести
вынести:  вынести
задание:  задание
вектор:  векторы векторов
вращение:  вращения
именно:  именно
копирование:  копирование
разрыв:  разрыва
выражение:  выражения выражение
отблагодарить:  отблагодарить
байес:  байеса
оценить:  оценить
результат:  результат результате
теория:  теория теории
отсутствовать:  отсутствует
счесть:  счесть
равновесие:  равновесие
двумерный:  двумерная
срезать:  срезает
выбрать:  выбрал выбрать выберем
задать:  заданной задайте
циркуляция:  циркуляция
тройной:  тройной тройному тройного тройных тройными тройные
плоскость:  плоскости плоскостью плоскостями плоскостей плоскость
отношение:  отношение отношении
общий:  общим общая общем
оставить:  оставить
определителяй:  определителяи
голова:  головой
жестяной:  жестяная
дважды:  дважды
закон:  законы
справа:  справа
качество:  качестве
последовательно:  последовательно
вероятность:  вероятностей вероятность вероятности
загромоздить:  загромождённой
уравненийв:  уравненийв
подобно:  подобно
множитель:  множитель
грин:  грина
неоднородный:  неоднородной неоднородное неоднородного неоднородные
эйлер:  эйлера
эллиптический:  эллиптическим
известный:  известной известна
придерживаться:  придерживаться
дискретный:  дискретный
знакочередоваться:  знакочередующиеся
масса:  массы массу масса
рассказать:  рассказать
принцип:  принцип
практически:  практически
произвольный:  произвольных произвольную
сложный:  сложной сложные сложных сложен
фурье:  фурье
поле:  поля
гипотеза:  гипотез гипотеза гипотезы
заранее:  заранее
прочтение:  прочтение
свойство:  свойства свойством свойство
момент:  момент
длинный:  длинной
исследование:  исследование
весь:  всем
плоский:  плоской
ошибочный:  ошибочный
вариация:  вариации
основа:  основы основах
интервал:  интервалы
кош:  коши
чайник:  чайников
вычисленияс:  вычисленияс
матричный:  матричные матричных матричный
последний:  последний
заметить:  заметили
первоочередной:  первоочередное
вычислить:  вычислить
очень:  очень
матрица:  матрицу матрицы матрицами
испытанияй:  испытанияи
интегралыть:  интегралыв
перегруппировка:  перегруппировка
пространственный:  пространственный
помощь:  помощью
начало:  начало
вариационный:  вариационный
оформляться:  оформляется
конец:  концов конце
стандартно:  стандартно
индийский:  индийских
отложить:  отложить
блог:  блог
высокий:  высших высшей высшая
пойти:  пойти
коробка:  коробку
пространство:  пространстве пространства
забыть:  забыли
находиться:  находящуюся
условие:  условиях условия
удобный:  удобный
путь:  путь путями
курс:  курс
полукруг:  полукруг
координата:  координаты координата координат координатах
сообщить:  сообщите
сетовать:  сетовали
главный:  главном главную
аналитический:  аналитическая аналитическим аналитической
понижение:  понижение понижением
центр:  центр центром центра
перескок:  перескоков
терпеливый:  терпелив
получить:  получено получена получи
любой:  любой любую любом
интегрироваться:  интегрируется
производная:  производных
считаться:  считается считаются считался
пересекаться:  пересекаются
затем:  затем
константа:  константами константой константы константу
осуществляться:  осуществляется осуществляются
линейнойкорреляционный:  линейнойкорреляционной
действие:  действия
пора:  пор
распределениякритерия:  распределениякритерий
мешать:  мешало
аргумент:  аргумента
несобственный:  несобственные
выполнять:  выполнять выполняем
аналогия:  аналогия
встать:  встаньте
представлять:  представлять представляет
случайность:  случайность
касательная:  касательная
ответ:  ответ ответы
задачис:  задачис
разобраться:  разобраться
правило:  правила правило
функциия:  функциии
возможно:  возможно
степенной:  степенного степенные
функцийдвуха:  функцийдвух
выборка:  выборке
трофей:  трофей
функцийнесколький:  функцийнескольких
подготовка:  подготовки
налево:  налево
множественнойлинейный:  множественнойлинейной
распределение:  распределение распределения
аналогичный:  аналогичным аналогичная аналогичное
параболоид:  параболоид параболоидом
простота:  простоту
задачипо:  задачипо
востребовать:  востребованную
приблизить:  приближенные
верхний:  верхний
вариант:  вариант
остальной:  остальным
тяжело:  тяжело
образец:  образец
спроецировать:  спроецировать
пункт:  пункта
примечание:  примечание
выкладка:  выкладки
зависимый:  зависимые
путём:  путём
походить:  походим
отклонение:  отклонение
таблица:  таблицы
произведение:  произведение
старый:  старая
вполне:  вполне
случайный:  случайных случайные
предварительно:  предварительно
воздух:  воздух
дуга:  дуги
удовлетворение:  удовлетворения
отрезкать:  отрезкав
труд:  трудов
дивергенция:  дивергенция
пена:  пены
одинаково:  одинаково
подождать:  подожду
сайт:  сайт сайты сайта
графика:  графики графика
оформление:  оформления
встречать:  встречающая
идти:  идёт
площадь:  площадь
возрастание:  возрастание
эмпирический:  эмпирические
который:  который которая которую которых которой
ничто:  ничто
иррациональный:  иррациональных
определение:  определению определения
квадратичнуюформ:  квадратичнуюформу
конус:  конус
карта:  карта
гипербола:  гипербола
равно:  равно
они:  ними
октант:  октант
обозначение:  обозначение
платиновый:  платиновое
логика:  логики
новизна:  новизны
материал:  материалов материалы
спирмена:  спирмена
обратить:  обратили
вид:  виду виды виде
параллелепипед:  параллелепипеда параллелепипед
заключительный:  заключительный заключительной
серебряный:  серебряное
вовсе:  вовсе
уточнить:  уточним
обход:  обхода обход
свежеть:  свежей
св:  св
второй:  второго
встретить:  встретит
показательный:  показательное
преобразование:  преобразования преобразованиями преобразований
создать:  создать
диффура:  диффурами
прибыть:  прибывшим
этот:  эта
ось:  осей
перейти:  перейдём
узнать:  узнать
быть:  будем
зетовый:  зетовом
использовать:  используем используя использовать используйте
статистика:  статистика
подставлять:  подставляем
биномиальный:  биномиальное
физически:  физически
потренироваться:  потренироваться
линиюв:  линиюв
масштаб:  масштаба
история:  история
самостоятельный:  самостоятельного
справедливый:  справедливы
хотеться:  хочется
второе:  второе
двойной:  двойному двойные двойной двойного
иксовый:  иксовая
смысл:  смысл
сохранять:  сохранять
окно:  окно
решить:  решить
дуприближённо:  дуприближённо
определённый:  определённой определенный определенного
асимптота:  асимптоты
событие:  события
повторный:  повторные повторным
постоянно:  постоянно
цилиндр:  цилиндром цилиндр
фнп:  фнп
простейшее:  простейшие
криволинейный:  криволинейных криволинейные
пятёрка:  пятёркой
размяться:  разомнёмся
часть:  частям часть части
большинство:  большинства
приступать:  приступать
проецирование:  проецирование
несобство:  несобств
нелинейный:  нелинейная
преобразованиеквадратичный:  преобразованиеквадратичной
функциональный:  функциональные
классический:  классический
геометрический:  геометрическая геометрическое
абсолютный:  абсолютная
встречаться:  встречаются
сложенияй:  сложенияи
куб:  куб
регрессия:  регрессии регрессия
свой:  свой
окружность:  окружности
упрощать:  упрощает
исчисление:  исчисления
подведение:  подведения
премия:  премия
чистовик:  чистовике
проводиться:  проводилось
локальный:  локальная
ожидание:  ожидание
лаплас:  лапласа
такой:  таким такие такое такого такими
перегиб:  перегиба
сходимость:  сходимости сходимость
понизить:  пониженном
плохой:  плохой
объяснить:  объяснил
ду:  ду
делать:  делать
обладать:  обладает
мысль:  мысль
возбраняться:  возбраняется
коэффициент:  коэффициент
неопределённый:  неопределенный неопределенном
дробь:  дробей
собственный:  собственные
упрощаться:  упрощаются
признак:  признак признаки
запутаться:  запутаться
важный:  важным
поэтому:  поэтому
практика:  практике
вместо:  вместо
менять:  меняет
хватить:  хватит
пакет:  пакета пакет
знакомый:  знакомый
асимметрия:  асимметрия
ограниченный:  ограниченное ограниченного
сверху:  сверху
сводиться:  сводящиеся
дать:  дать данная данной
замена:  замены
маленький:  меньше
немаловажный:  немаловажный
например:  например
решенияопределённый:  решенияопределенных
выглядеть:  выглядит
действительность:  действительности
хотя:  хотя
крышка:  крышка
порешать:  порешать
коэффициентковариация:  коэффициентковариации
проекция:  проекцией проекции проекцию проекция
рассуждение:  рассуждения
помешать:  помешает
моральный:  морального
сферический:  сферических сферическая
лопиталя:  лопиталя
элементарный:  элементарное элементарны
отработать:  отработаем
крайне:  крайне
ставить:  ставим
мимо:  мимо
столбик:  столбиком
поляформула:  поляформула
наверное:  наверное
фехнера:  фехнера
эффективный:  эффективные
шнобелевский:  шнобелевская
условный:  условные условный
эллипс:  эллипс
ноль:  ноль
шар:  шара
мешок:  мешок
самочувствие:  самочувствие
даламбер:  даламбера
теорема:  теоремы
факт:  факт
повторнойя:  повторнойи
естественно:  естественно
комплексный:  комплексные комплексного комплексный комплексными
нижний:  нижний
скобка:  скобки
подвесить:  подвесить
ранг:  ранг
расписывать:  расписывать
кривая:  кривой
тяжестиплоска:  тяжестиплоской
относительно:  относительно
зато:  зато
бумажка:  бумажка
исчезнуть:  исчезла
глубокий:  глубокого
повторить:  повторить
лейбниц:  лейбница
неравенство:  неравенства
поток:  поток
тематический:  тематических
мусор:  мусором
выбросить:  выбросить
конкретный:  конкретным
медиана:  медиана
отдохнуть:  отдохнуть
правдоподобно:  правдоподобно
записать:  записать
направлениюй:  направлениюи
гостевой:  гостевая
перемещать:  перемещать
кроме:  кроме
аккуратно:  аккуратно
понятно:  понятно
внутригрупповаяй:  внутригрупповаяи
последующий:  последующего
алгебра:  алгебры
сумма:  сумму сумма
кошмар:  кошмара
строка:  строкой
существовать:  существует
прямоугольник:  прямоугольников
получиться:  получиться
эксцессэмпирический:  эксцессэмпирического
рычаг:  рычага
оценка:  оценка оценки
палец:  пальцы
различный:  различных
библиотека:  библиотека
определяться:  определяется
возможность:  возможности
наименьшеезначение:  наименьшеезначения
сила:  силы
вычислимый:  вычислим
интересный:  интереснее
системылинейный:  системылинейных
нужно:  нужно
буквенный:  буквенные
смежный:  смежных
чистовой:  чистового чистовые
зависимость:  зависимость
замкнутый:  замкнутому
давно:  давно
желать:  желаю желающие
линейность:  линейности
чувство:  чувством
проходить:  проходит
показатель:  показатели
площадьс:  площадьс
присутствовать:  присутствует
выгодный:  выгодным выгоднее
убыванией:  убываниеи
полупространство:  полупространстве
повышенный:  повышенной повышенное
статистический:  статистическая статистические
также:  также
интегрирование:  интегрирование интегрирования интегрировании
легко:  легко
пока:  пока
некоторый:  некоторых некоторые
интервальный:  интервальный
соответственно:  соответственно
мера:  мере
расстояние:  расстоянием
принадлежать:  принадлежит
оценкия:  оценкии
неявный:  неявной
нить:  нить
несобственныхинтеграл:  несобственныхинтегралов
вероятностибиномиальный:  вероятностибиномиального
род:  рода
гаусс:  гаусса
лежать:  лежит
выразить:  выразить
точно:  точно
экстремальный:  экстремальные
нормаль:  нормали
определитель:  определитель
алгоритм:  алгоритме
выпуклость:  выпуклость
элемент:  элементы
сложность:  сложность сложности
менее:  менее
угол:  углами
значенияй:  значенияи
незамысловатый:  незамысловатых
нужный:  нужной
первый:  первого
кстати:  кстати
классическоеопределение:  классическоеопределение
инормаль:  инормаль
причёсывать:  причёсываем
отличный:  отлична
радиус:  радиуса
гуд:  гуд
далёкий:  дальше
вновь:  вновь
пирамида:  пирамида
нежелательно:  нежелательно
ограничиться:  ограничиться
автор:  автор автора
цель:  целях
дифференциальный:  дифференциальные
уравненияс:  уравненияс
онлайн:  онлайн
разобрать:  разберём
геометрия:  геометрии геометрия
нуль:  нуля
работа:  работа
повернуть:  повернули
новый:  новому
произвольныйтройный:  произвольныйтройной
круг:  круга
дизайн:  дизайна
это:  это
поляй:  поляи
опечатка:  опечатку
машинально:  машинально
речь:  речь
трудный:  труднее
непременно:  непременно
методомоперационный:  методомоперационного
бесповторный:  бесповторной
наверняка:  наверняка
ошибка:  ошибку
неприятный:  неприятный
л:  л
степень:  степени
снизу:  снизу
направление:  направлениях направление направления
слово:  слову
взять:  взять
касательный:  касательных
громоздкий:  громоздкими
разбираться:  разбираемся
испариться:  испарилась
типовыхзадача:  типовыхзадач
ранговойкорреляция:  ранговойкорреляции
искомое:  искомое
страничка:  странички
реализовать:  реализуемо
актуализировать:  актуализируем
перевернуть:  перевернуть
представить:  представить
исследовать:  исследовать
восприниматься:  воспринимаются
пересекать:  пересекает
линейныйкоэффициент:  линейныйкоэффициент
несобственныйинтеграл:  несобственныйинтеграл
доступно:  доступно
понятие:  понятия
логично:  логично
учиться:  учимся
задавать:  задаваемые
ипример:  ипримеры
знать:  знаем
множество:  множества
суммарный:  суммарную
фигура:  фигуры
пуассон:  пуассона
подобный:  подобные
рассматривать:  рассматривали
успех:  успехов
однако:  однако
таки:  таки
отыскание:  отыскании
математическоеожидание:  математическоеожидание
школа:  школа
напомнить:  напомню
конический:  конической
комбинация:  комбинаций
каждый:  каждая каждую
сказать:  скажу
кратное:  кратные
стоить:  стоит
системудифференциальный:  системудифференциальных
метр:  метр
последовательность:  последовательностей
квадратичный:  квадратичные
свестись:  свелось
проверить:  проверить
требоваться:  требовалось
поскольку:  поскольку
гипергеометрическоераспределение:  гипергеометрическоераспределение
ваш:  ваших
подробно:  подробно
равномерный:  равномерная равномерное
иначе:  иначе
треугольный:  треугольная
пожалуйста:  пожалуйста
золотой:  золотое
следовать:  следует
песня:  песня
себя:  собой
операция:  операцию
однозначно:  однозначно
квадрат:  квадратов
кадр:  кадром
сразу:  сразу
функциюкомплексный:  функциюкомплексной
напоминать:  напоминаю
эпицентр:  эпицентре
мода:  мода
свойстваэлементарный:  свойстваэлементарных
считать:  считать
закомментировать:  закомментирую
краткий:  краткое
калькулятор:  калькулятор
научиться:  научиться
обойти:  обойти
квартира:  квартире
единичный:  единичного
шанс:  шансов
предлагать:  предлагаю
действительно:  действительно
прочий:  прочих
экстремум:  экстремумы
горнера:  горнера
безразмерный:  безразмерен
получать:  получаем
брать:  брать
функцийв:  функцийв
видеть:  видите
контроль:  контроля
довольно:  довольно
рядышком:  рядышком
чертить:  чертить
подставить:  подставить
проявлять:  проявлять
утверждение:  утверждения
дискретнойслучайный:  дискретнойслучайной
зарезервировать:  зарезервировано
знак:  знак
короткий:  короткий
сносить:  сносим
слон:  слонов
крамер:  крамера
парабола:  парабола
запретить:  запрещено
функциидвуха:  функциидвух
черновик:  черновике
кубический:  кубический
емелин:  емелин
расправа:  расправу
состояние:  состоянии
вычисленияопределенный:  вычисленияопределенных
вэ:  вэ
задачин:  задачина
замечательный:  замечательные
системый:  системыи
удовлетворяетлить:  удовлетворяетли
сей:  сих
всякий:  всякий
тригонометрический:  тригонометрических
редкий:  редкий
аналитически:  аналитически
шесть:  шестью
заданав:  заданав
всё:  всё
изобразить:  изобразим
стандартный:  стандартен
деление:  деления
являться:  является
контуруформула:  контуруформула
график:  график
обращать:  обращать
дело:  дела деле дело
принимать:  принимая
внутри:  внутри
либо:  либо
рекомендовать:  рекомендую
независимый:  независимые
неважный:  неважное
зет:  зет
подход:  подход
привести:  привести
надёжный:  надёжных
корреляция:  корреляции
продолжить:  продолжить
заочник:  заочников
трёхмерный:  трёхмерный
подынтегральный:  подынтегральная
терять:  теряя
повторять:  повторяем
