натянутый:  натянутую натянутая
часовой:  часовой
полезный:  полезен
производный:  производные производная производной производную
предел:  предел пределами пределы пределов пределах
положительный:  положительного положительное положительным положительном
числовой:  числовые
путаться:  путаемся
производныенеявно:  производныенеявно
длинный:  длиннее
значение:  значение значения
скорее:  скорее
общий:  общему общим общая
игрек:  игрек игрека игреком
движение:  движение движения
формула:  формулы формулой формуле формула формулу
смотреть:  см смотрим смотреть
река:  река
отрицательный:  отрицательный
прийтись:  придётся
канонический:  каноническому канонические
два:  две двумя двух
отрезок:  отрезку отрезка отрезки
параметр:  параметра
дифференциал:  дифференциалах дифференциал дифференциалы дифференциалами дифференциала
больший:  наибольшее
стрелка:  стрелки стрелке
выразить:  выразим выразить
против:  против
любой:  любому любое любой
ладь:  ладей
банк:  банка
сам:  самого самом само
число:  число числе числами числа
вогнутостья:  вогнутостьи
становиться:  становится
позволять:  позволяет позволяющими позволяй
случай:  случай случае случаях
плохой:  хуже
профессия:  профессию
условие:  условии условию
пусть:  пусть
умножение:  умножения
выполнимый:  выполним
система:  система системе систему системы
группировка:  группировок группировка
условнаясходимость:  условнаясходимость
окружность:  окружность окружности
угол:  угол
александр:  александр
критичный:  критичны
остаться:  осталось
скорость:  скоростей скорость скорости
линейный:  линейные линейная линейных линейной
правый:  правой
согласие:  согласия
решать:  решаем решать решали
дуоперационный:  дуоперационным
базис:  базисах базису базис
зависимостьвектор:  зависимостьвекторов
распространить:  распространённый
снова:  снова
оно:  оно
метод:  методы методом метод
тема:  теме
страница:  страницу
поле:  полям поля полей полем поле
математический:  математическая математические математической
данные:  данных
ось:  оси
свестись:  сведётся
интеграл:  интеграл интегралу интегралов интегралах интегралы интеграла интегралом интеграле
урок:  урока урок уроке
разложение:  разложением разложение
частный:  частную частное частные частный
прозрачный:  прозрачно
икс:  икс иксом
уравнение:  уравнению уравнения уравнение уравнениям уравнениями уравнений
переход:  переход перехода
поздравлять:  поздравляю
получиться:  получилось получится
недочёт:  недочёты
практический:  практических практическим
малый:  малые наименьших малейшего
связь:  связь
ответить:  ответим
экзотический:  экзотического
нормальный:  нормальное нормального нормальных
интегральнаятеорема:  интегральнаятеоремы
некоторый:  некоторой некоторыми
корнимногочлен:  корнимногочлена
логарифмический:  логарифмическая
место:  места
подчёркивать:  подчёркиваю
основной:  основные
соответствовать:  соответствующей соответствующем соответствует соответствующий
бернулли:  бернулли
полярный:  полярные полярных полярный полярной полярным
рассмотреть:  рассмотрим рассмотренное
спроецировать:  спроецируем
ряд:  ряды ряда ряд рядов
уровень:  уровня уровне
пользоваться:  пользоваться пользовались
вычисляться:  вычисляется
доверительный:  доверительные
смысл:  смысле смысл смыслом
нечего:  нечему
среднееквадратический:  среднееквадратическое
посвятить:  посвящён посвящённый
говориться:  говорится
решение:  решениями решение решением решения решений
комбинационный:  комбинационная
смешанноепроизведение:  смешанноепроизведение
функция:  функции функция функций функцию
целый:  целая целый
дисперсия:  дисперсия дисперсии дисперсию
проверка:  проверки проверка
постараться:  постарайтесь
школьный:  школьный
мы:  нам нами
треугольник:  треугольника треугольник треугольнику
образ:  образом
непрерывнаяслучайный:  непрерывнаяслучайная
ибо:  ибо
длина:  длина длины
работа:  работе работа работу
мочь:  могут можем
знакопостоянство:  знакопостоянства
занимательный:  занимательного
площадь:  площади
фигура:  фигуру фигуры
градиент:  градиент
лопата:  лопату
линия:  линия линии линию линиями
материальный:  материальной
ясно:  ясно
комбинаторика:  комбинаторике
случайнаявеличина:  случайнаявеличина
бесконечно:  бесконечно
отношение:  отношению отношении
форма:  формы
задача:  задачу задаче задачи задач задачах
отметить:  отметить
возвращаться:  возвращаемся
игрековый:  игрековая
обратный:  обратную обратная
дополнительный:  дополнительные
готовый:  готовых
просто:  просто
ещё:  ещё
знак:  знаками знак
ограниченный:  ограниченная
порядок:  порядком порядок порядке порядку порядка порядков
остриё:  острия
посмотреть:  посмотрите
частый:  чаще
данный:  данного данном данный
непрерывный:  непрерывных непрерывная
ротор:  ротора ротор
производныефункция:  производныефункции
средний:  средняя
пересечение:  пересечения
область:  области область
торчать:  торчащий торчащих
путь:  пути путь
далеко:  далеко
математик:  математика
переменный:  переменных переменной переменные переменную переменная
пример:  пример примера примере примеры
упрощение:  упрощения
несовместный:  несовместные
независимыеслучайный:  независимыеслучайные
следовательно:  следовательно
модель:  модель модели
непрерывность:  непрерывность
тэ:  тэ
способ:  способами способом
тупо:  тупо
верхний:  верхняя верхней
сечение:  сечение
функциис:  функциис
угодный:  угодно
полный:  полной полных полное полная
зеркало:  зеркало
значит:  значит
заряжать:  заряжаем
пирсон:  пирсона
вопрос:  вопрос вопросы
межгрупповой:  межгрупповая
ортогональный:  ортогональное
интерпретировать:  интерпретировать
ошибка:  ошибки ошибку ошибок
наворотить:  навороченные
нсв:  нсв
плоский:  плоскую
гидродинамический:  гидродинамической гидродинамический
упасть:  упал
один:  одно одна одной одном
соленоидальный:  соленоидальные соленоидальным
изменение:  изменении изменения изменению
отрезка:  отрезке
величина:  величина величин величины
одновременно:  одновременно
поверхность:  поверхность поверхности
полноценно:  полноценно
интегрировать:  интегрируем интегрировать
гармония:  гармония
она:  неё
самый:  самая самое
детерминация:  детерминации
перемещение:  перемещению
сторона:  стороны сторону стороне
обязательно:  обязательно
начать:  начать
методически:  методически
подсчитать:  подсчитали
дифференциальныеуравнение:  дифференциальныеуравнения
прямой:  прямая прямой прямом прямую прямого
взять:  возьмём взять
постоянный:  постоянных
стокс:  стокса
схема:  схема
свести:  свести сведённый
самостоятельно:  самостоятельно
зетовый:  зетовая
завораживать:  завораживающая
мусор:  мусор
дробовик:  дробовик
математика:  математике математики
векторный:  векторное векторного
роторный:  роторном роторную
вероятностия:  вероятностии
аналогичный:  аналогичную
скалярный:  скалярное скалярная
предложить:  предложенные
добить:  добью
понятный:  понятен понятнее
значимость:  значимости
мысленно:  мысленно
анализ:  анализа анализ
её:  её
парный:  парной
выполнять:  выполняет выполнять
координата:  координатами координаты координата координатам координат координатах
поверхностный:  поверхностного поверхностный поверхностные поверхностному
найти:  найдём найти
сборник:  сборники
верно:  верно
параметрический:  параметрическом параметрическими параметрических параметрические параметрической
версия:  версия
придумать:  придумайте
дать:  данному дать данной
часто:  часто
косой:  косого
проконтролировать:  проконтролировать
получаться:  получается
властвовать:  властвуй
находить:  находим
надеяться:  надеюсь
форум:  форум форуме
книга:  книги книга
вспомнить:  вспомнить
эллипс:  эллипса эллипс
изменяться:  изменяется
отправить:  отправить
стрелочка:  стрелочками
замкнутый:  замкнут замкнутую замкнутая замкнутому замкнутого замкнутой
задание:  задание
вектор:  векторы вектору векторов вектора векторам вектор
вращение:  вращения
циркулировать:  циркулировать циркулирует
именно:  именно
копирование:  копирование
обходиться:  обходится
разрыв:  разрыва
выражение:  выражения
вещь:  вещей
роль:  роль
грубо:  грубо
отблагодарить:  отблагодарить
байес:  байеса
простой:  проще простейшую попроще
круг:  кругу круг круга
цилиндр:  цилиндра
оценить:  оценить
определённый:  определённому определенный определенного
результат:  результат результату
теория:  теория теорию теории
проверить:  проверьте проверить
ранний:  раньше
наш:  нашему наше наш
называть:  называют
двумерный:  двумерная
задать:  заданной задайте
тело:  тела
циркуляция:  циркуляция циркуляции циркуляцию
непосредственно:  непосредственно
проинтегрировать:  проинтегрируем проинтегрировать
отклонение:  отклонения отклонение
лежать:  лежат лежит лежащую
плоскость:  плоскости плоскостью плоскостях плоскость
направлять:  направляющий направляющему
поздний:  позже
стандартный:  стандартном
определителяй:  определителяи
согласно:  согласно
закон:  законы
приём:  приёмами
произвольный:  произвольной произвольных произвольное произвольную
ситуация:  ситуацию
вероятность:  вероятностей вероятность вероятности
старый:  старый
уравненийв:  уравненийв
осторожный:  осторожны
грин:  грина
суть:  сути
эйлер:  эйлера
успешный:  успешным
годиться:  годится
дискретный:  дискретный
направить:  направленный
обязательный:  обязательным
знакочередоваться:  знакочередующиеся
контур:  контуром контурам контура контур контуру
пожалуй:  пожалуй
упрощённо:  упрощённо
сложный:  сложной сложные сложных
фурье:  фурье
белый:  белая
гипотеза:  гипотез гипотеза гипотезы
свойство:  свойства
момент:  момент
описываться:  описывается
исследование:  исследование
весь:  всем весь
точка:  точки точка точкам точек точке
проблема:  проблем
вариация:  вариации
основа:  основы основам
слишком:  слишком
интервал:  интервалы
вручить:  вручить
кош:  коши
выше:  выше
чайник:  чайников
раздел:  раздел
вычисленияс:  вычисленияс
матричный:  матричные матричных матричный
аддитивность:  аддитивности
ровный:  ровным
действительный:  действительное
заметить:  заметили заметить
вставать:  встаёт
однородный:  однородные однородным
вычислить:  вычислить
очень:  очень
матрица:  матрицу матрицы матрицами
испытанияй:  испытанияи
интегралыть:  интегралыв
перегруппировка:  перегруппировка
прорисовываться:  прорисовывается
пространственный:  пространственный пространственным
помощь:  помощью
начало:  начало началу
вариационный:  вариационный
взглянуть:  взгляните
блог:  блог
высокий:  высших высшей высшая
пространство:  пространстве пространства
удобный:  удобный удобнее
курс:  курс курсе курса
быть:  будьте будут будем
буковка:  буковка
обнулить:  обнулить
сообщить:  сообщите
сделать:  сделать
перейти:  перейдем
компонент:  компоненты
аналитический:  аналитическая аналитической
понижение:  понижение понижением
левый:  левой левую
центр:  центр центром
видеть:  видеть
сложиться:  сложилось
флотилия:  флотилия
поток:  потоку поток
преимущественно:  преимущественно
построение:  построение
вспоминать:  вспоминаем
осуществляться:  осуществляется
линейнойкорреляционный:  линейнойкорреляционной
действие:  действия
время:  время временем
оставаться:  остаётся
замкнутость:  замкнутости
особо:  особо
сила:  силу силы
распределениякритерия:  распределениякритерий
несобственный:  несобственные
зрение:  зрения
откуда:  откуда
процесс:  процесс
скомпенсировать:  скомпенсировано
полностью:  полностью
касательная:  касательная
ответ:  ответ ответы
задачис:  задачис
открыться:  откроется
друг:  другом
разобраться:  разобраться
правило:  правила правило
функциия:  функциии
возможно:  возможно
степенной:  степенного степенные
функцийдвуха:  функцийдвух
выборка:  выборке
использование:  использовании
функцийнесколький:  функцийнескольких
возникнуть:  возникнуть
человек:  человека
множественнойлинейный:  множественнойлинейной
каждый:  каждой
единичный:  единичный единичного
распределение:  распределение распределения
забывать:  забываем
этот:  этому
тригонометрический:  тригонометрические тригонометрических
объёдинять:  объёдиняет
решить:  решим решить
задачипо:  задачипо
востребовать:  востребованную
термин:  термин
приблизить:  приближенные
видно:  видно
вариант:  вариант
примечание:  примечание
зависимый:  зависимые
путём:  путём
таблица:  таблицы
произведение:  произведение
кто:  кому
случайный:  случайных случайные
течение:  течения течением
дуга:  дуги
численно:  численно
свой:  свои
частность:  частности
отрезкать:  отрезкав
плыть:  плывёт
дивергенция:  дивергенция
чертёж:  чертежа чертёж чертеже
сайт:  сайт сайты сайта
графика:  графики графика
прорешать:  прорешали
идти:  идёт идущего
возрастание:  возрастание
эмпирический:  эмпирические
подставить:  подставим подставить
который:  который которая которое которой
найтись:  нашлось
потребоваться:  потребуется потребовалась
иррациональный:  иррациональных
определение:  определению определения
квадратичнуюформ:  квадратичнуюформу
карта:  карта
вычисление:  вычисления вычисление вычислений
гипербола:  гипербола
образец:  образце образцом
они:  ними
логика:  логики
материал:  материалов материалы
спирмена:  спирмена
интегрирование:  интегрированием интегрирование интегрирования
вид:  виду виды вид виде
записать:  записан запишем
заключительный:  заключительный
традиционный:  традиционным
лишь:  лишь
обход:  обхода обход
св:  св
второй:  второго вторым
иметь:  имеет
пара:  пара
отличный:  отличную отличны
достаточно:  достаточно
показательный:  показательное
преобразование:  преобразования преобразований
диффура:  диффурами
тройной:  тройных тройные
использовать:  используем используя использовать используйте
представлять:  представляет
статистика:  статистика
бэ:  бэ
биномиальный:  биномиальное
линиюв:  линиюв
самостоятельный:  самостоятельного
латинский:  латинский
жидкость:  жидкость жидкости
отработка:  отработки
дуприближённо:  дуприближённо
асимптота:  асимптоты
событие:  события
повторный:  повторные
сакраментальный:  сакраментальный
б:  б
декартов:  декартовыми
фнп:  фнп
пропорция:  пропорции
простейшее:  простейшие
криволинейный:  криволинейных криволинейном криволинейные криволинейный криволинейному
конец:  конце концах концу
часть:  частям части
полуось:  полуоси
двойной:  двойные двойной
несобство:  несобств
показаться:  покажется
нелинейный:  нелинейная
применить:  применить
преобразованиеквадратичный:  преобразованиеквадратичной
упускать:  упускаем
никто:  никому
функциональный:  функциональные
геометрический:  геометрическая геометрическим геометрическое
абсолютный:  абсолютная абсолютное
разный:  разными разный
тот:  тому
сложенияй:  сложенияи
сказать:  сказано
решебник:  решебнике
регрессия:  регрессии регрессия
исчисление:  исчисления
осуществлять:  осуществляемый
обойти:  обошли обойти
локальный:  локальная
ожидание:  ожидание
лаплас:  лапласа
такой:  таким такие такое такого
перегиб:  перегиба
сходимость:  сходимости сходимость
представить:  представьте
выбрать:  выбранного выбрать
сослаться:  сослаться
занятный:  позанятнее
координатный:  координатных координатные
ду:  ду
делать:  делать
коэффициент:  коэффициент
неопределённый:  неопределенный неопределенном
дробь:  дробей
собственный:  собственные
признак:  признак признаки
запутаться:  запутаться
поэтому:  поэтому
практика:  практике
пункт:  пункте
принцип:  принципе принципу
объяснить:  объясню
коль:  коль
асимметрия:  асимметрия
требование:  требование
разнонаправить:  разнонаправлено
риск:  риск
главный:  главную
сводиться:  сводящиеся
замена:  замены
показывать:  показывает
составить:  составим составить
например:  например
решенияопределённый:  решенияопределенных
нужный:  нужный нужной
силовой:  силовых
интересный:  интересный интересен
пойти:  пойдём
дело:  делам деле
выражать:  выражаем
душа:  душе
коэффициентковариация:  коэффициентковариации
разделять:  разделяй
потенциальный:  потенциальном потенциальным потенциальные
воздух:  воздуха
оценка:  оценкой оценка оценки
лопиталя:  лопиталя
скарб:  скарб
крайне:  крайне
обычно:  обычно
поляформула:  поляформула
фехнера:  фехнера
эффективный:  эффективные
беспроблемный:  беспроблемно
условный:  условные
даламбер:  даламбера
популярный:  популярнее
теорема:  теоремы
повторнойя:  повторнойи
рассказать:  рассказал
комплексный:  комплексные комплексного комплексный комплексными
ранг:  ранг
другой:  другое другие другим
кривая:  кривой
тяжестиплоска:  тяжестиплоской
задавать:  задают задаваемые
исторически:  исторически
уменьшить:  уменьшить
касаться:  касается
построить:  построить построим
противоположный:  противоположном
внимание:  внимание
лейбниц:  лейбница
лениться:  ленимся лениться
неравенство:  неравенства
медиана:  медиана
техника:  техники
направлениюй:  направлениюи
привести:  привёл привести
гостевой:  гостевая
скоро:  скоро
кроме:  кроме
аккуратно:  аккуратно
равный:  равен равная равна
главное:  главное
внутригрупповаяй:  внутригрупповаяи
зависеть:  зависит
алгебра:  алгебры
сумма:  сумму сумма
существовать:  существует
проекция:  проекции проекция
прямоугольник:  прямоугольников
эксцессэмпирический:  эксцессэмпирического
говорить:  говорит говоря
академичный:  академичным
различный:  различных
библиотека:  библиотека библиотеке
определяться:  определяется
название:  названием
корень:  корень
наименьшеезначение:  наименьшеезначения
задачка:  задачка
вычислимый:  вычислим
рассказывать:  рассказывал
системылинейный:  системылинейных
нужно:  нужно
лояльно:  лояльно
зависимость:  зависимость
эф:  эф
страшный:  страшны
должный:  должен должно
очевидный:  очевидно
желать:  желаю
показатель:  показатели
следующий:  следующий
рамка:  рамках
площадьс:  площадьс
убыванией:  убываниеи
повышенный:  повышенной
статистический:  статистическая статистические
также:  также
легко:  легко
рациональный:  рациональные рациональными
полноводный:  полноводная
прийти:  прийти пришло
нуль:  нулю нуля
читать:  читайте
интервальный:  интервальный
противоположно:  противоположно
г:  г
мера:  мере
рука:  руку руки
вообще:  вообще
потенциально:  потенциально
оценкия:  оценкии
неявный:  неявной
несобственныхинтеграл:  несобственныхинтегралов
вероятностибиномиальный:  вероятностибиномиального
физический:  физический
род:  рода
гаусс:  гаусса
полезно:  полезно
выписать:  выпишем
экстремальный:  экстремальные
нормаль:  нормали
определитель:  определитель
выпуклость:  выпуклость
элемент:  элементы
первый:  первом первого первые
интересно:  интересно
сложность:  сложности
значенияй:  значенияи
труба:  трубы трубе
кстати:  кстати
классическоеопределение:  классическоеопределение
инормаль:  инормаль
радиус:  радиуса
пирамида:  пирамида
автор:  автор автора
столько:  столько
дифференциальный:  дифференциальные
уравненияс:  уравненияс
онлайн:  онлайн
гидродинамика:  гидродинамики
проецироваться:  проецируется
геометрия:  геометрии геометрия
использоваться:  используется
новый:  новому
произвольныйтройный:  произвольныйтройной
дизайн:  дизайна
это:  это
величественно:  величественно
поляй:  поляи
находиться:  находится
ассоциация:  ассоциация
минимизировать:  минимизировать
опечатка:  опечатку
выгодный:  выгоднее
направление:  направлении направлением направление направлению
методомоперационный:  методомоперационного
бесповторный:  бесповторной
правильно:  правильно
л:  л
обойтись:  обойтись
касательный:  касательных
характерный:  характерен
типовыхзадача:  типовыхзадач
ранговойкорреляция:  ранговойкорреляции
пометить:  пометим
сколько:  сколько
исследовать:  исследовать
малое:  малым
нетрудно:  нетрудно
линейныйкоэффициент:  линейныйкоэффициент
несобственныйинтеграл:  несобственныйинтеграл
доступно:  доступно
причём:  причём
учиться:  учимся
ничто:  ничем
ипример:  ипримеры
множество:  множества
требоваться:  требуется требовалось
принимать:  принимают
гармонический:  гармоническими гармоническим
пуассон:  пуассона
успех:  успехов
однако:  однако
таки:  таки
упоминать:  упоминал
фактически:  фактически
математическоеожидание:  математическоеожидание
воспользоваться:  воспользуемся
школа:  школа
неплохой:  неплохой
неоднородный:  неоднородные
проверять:  проверяем
содержание:  содержания
думать:  думаю
кратное:  кратные
системудифференциальный:  системудифференциальных
провести:  проведите
помимо:  помимо
слово:  слова
последовательность:  последовательностей
квадратичный:  квадратичные
обширный:  обширное
ассоциироваться:  ассоциируется
расписать:  расписать
объём:  объем
поскольку:  поскольку
архив:  архиве
палка:  палка
гипергеометрическоераспределение:  гипергеометрическоераспределение
оба:  обоих
обратить:  обратите
удаться:  удастся
возможность:  возможность
понятие:  понятие
подробно:  подробно
равномерный:  равномерная равномерное
широкий:  широкая
треугольный:  треугольная
исключительно:  исключительно
получить:  полученный полученным получи
пожалуйста:  пожалуйста
следовать:  следует
кусочек:  кусочкам
модуль:  модуль
вдоль:  вдоль
себя:  собой
полагать:  полагать
квадрат:  квадратов
проциркулировать:  проциркулирует
сразу:  сразу
флакон:  флаконе
функциюкомплексный:  функциюкомплексной
относиться:  относятся
мода:  мода
свойстваэлементарный:  свойстваэлементарных
считать:  считать
калькулятор:  калькулятор
научиться:  научиться
удовлетворять:  удовлетворяет удовлетворяют
фихтенголец:  фихтенгольца
прохождение:  прохождением
предлагать:  предлагаю
действительно:  действительно
экстремум:  экстремумы
некий:  некой
горнера:  горнера
видный:  виден
смениться:  сменится
функцийв:  функцийв
ознакомиться:  ознакомиться
обывательский:  обывательском
трудозатрата:  трудозатраты
распространиться:  распространилось
три:  трёх
дискретнойслучайный:  дискретнойслучайной
ток:  тока
учебник:  учебниках
соответствие:  соответствии
крамер:  крамера
парабола:  парабола
скрупулёзный:  скрупулезное
строго:  строго
преподаватель:  преподаватели
запретить:  запрещено
функциидвуха:  функциидвух
емелин:  емелин
вычисленияопределенный:  вычисленияопределенных
отдельность:  отдельности
замечательный:  замечательные
задачин:  задачина
представляться:  представляется
удовлетворяетлить:  удовлетворяетли
системый:  системыи
сегодня:  сегодня
внутренний:  внутренней
упустить:  упущенное
заданав:  заданав
всё:  всё
изобразить:  изобразим
деление:  деления
являться:  является
контуруформула:  контуруформула
график:  график
внутри:  внутри
либо:  либо
независимый:  независимые
зет:  зет
обозначение:  обозначения
аналог:  аналог
бурный:  бурный
корреляция:  корреляции
прежде:  прежде
наверстать:  наверстать
заочник:  заочников
повторять:  повторяем
характеристика:  характеристике
