вектор:  векторы векторов
ошибка:  ошибкой ошибку
техника:  технику
переписать:  перепишите
вращение:  вращения
сборник:  сборник сборники
дифференциальный:  дифференциальные дифференциального дифференциальном дифференциальное
устный:  устном
первый:  первый первым первую первые первого
путь:  путями
уравненияс:  уравненияс
наличие:  наличии
именно:  именно
онлайн:  онлайн
геометрия:  геометрии геометрия
копирование:  копирование
прелесть:  прелесть
дать:  дано
решить:  решить решен решён
рассмотреть:  рассмотрели рассмотрим рассмотренный
разрыв:  разрыва
неравносильный:  неравносильными
выражение:  выражения выражение
нуль:  нуля нулю
работа:  работа работ
производный:  производные производная производной производную
прямой:  прямой прямую прямая
дуприближённо:  дуприближённо
сумма:  сумма сумму
новый:  новому новыми
ум:  ума
предел:  предел пределы пределов
произвольныйтройный:  произвольныйтройной
модель:  модели модель
асимптота:  асимптоты
дизайн:  дизайна
вычисленияопределенный:  вычисленияопределенных
это:  это
комментировать:  комментировать
событие:  события
отблагодарить:  отблагодарить
являться:  являются является
известный:  известные
повторный:  повторные
байес:  байеса
числовой:  числовые
простой:  проще простая простейших простой
дисперсия:  дисперсию дисперсия дисперсии
выгодно:  выгодно
решать:  решать решаем
производныенеявно:  производныенеявно
таблица:  таблицу таблицы
пример:  примере примеры пример примера примеров примерах
значение:  значение значения значений
страшный:  страшное страшны страшный
помнить:  помним
кандидат:  кандидатами
отрицательный:  отрицательные
похожий:  похожую похожие
рука:  рукой
решение:  решений решении решением решение решения
перечитать:  перечитать перечитайте
интеграл:  интегралы интеграла интеграл интеграле интегралов
поляй:  поляи
огромный:  огромная
опечатка:  опечатку
общий:  общему общим общая
контрольный:  контрольных
случай:  случаях случай случая случаев случае
уныние:  уныние
математический:  математические математическая математической математического
теория:  теория теории
находить:  находить находим
связать:  связано
продолжать:  продолжаем
состоять:  состоит
способ:  способом способа
данный:  данную данном данное данного данный
преобразовать:  преобразуем преобразовать
игрек:  игрек игреке
формула:  формулы формул формула формуле
тетрадь:  тетрадь тетради
статья:  статье
фнп:  фнп
пропорция:  пропорции
канонический:  каноническому
простейшее:  простейшие
знаменатель:  знаменателя знаменателю
дифференцирование:  дифференцировании дифференцированием дифференцированию дифференцирования
два:  две двух
гипотеза:  гипотезы гипотез гипотеза
дифференциал:  дифференциалах дифференциала
двумерный:  двумерная
больший:  наибольшее
подсказка:  подсказка
методомоперационный:  методомоперационного
нередко:  нередко
задать:  заданной задайте
конец:  конце
часть:  частям части частью
разобрать:  разобранной
осваивать:  осваивать
тело:  тела
циркуляция:  циркуляция
куба:  куба
исчезнуть:  исчезнут
неявно:  неявно
бесповторный:  бесповторной
образец:  образцы образец образце
правильно:  правильно
привести:  приведенные приведут приведём привести
двойной:  двойные двойной
предназначить:  предназначен предназначены
плоскость:  плоскости плоскость
несобство:  несобств
л:  л
нелинейный:  нелинейная
применить:  применить
получиться:  получится получилось
итоговый:  итоговые
текущий:  текущее
оставить:  оставить
какой:  каком
сам:  самого самой сама самом
поздний:  позже
преобразованиеквадратичный:  преобразованиеквадратичной
вещь:  вещь
определителяй:  определителяи
вокруг:  вокруг
число:  число числами числа
вогнутостья:  вогнутостьи
трёхэтажность:  трёхэтажности
степень:  степени степень
вид:  виде виды виду
закон:  законы
затруднение:  затруднения
дробь:  дроби дробями дробей дробь
справа:  справа
функциональный:  функциональные
принять:  приняв
взять:  взять возьмите взяты
касательный:  касательных
самый:  самым самые самое самая самый
убедиться:  убедиться
раздаться:  раздался
корень:  корня корень
читать:  читаете
профессия:  профессию
длинный:  длинным
последовательно:  последовательно
константа:  константу константа
классический:  классический
геометрический:  геометрическая геометрическое
абсолютный:  абсолютная
типовыхзадача:  типовыхзадач
графика:  графика графики
удобно:  удобно
один:  одной одна одно
умножение:  умножения
вероятность:  вероятностей вероятность вероятности
встречаться:  встречаются
ранговойкорреляция:  ранговойкорреляции
система:  система систему системе системы
частный:  частные частное
функция:  функций функцией функцию функции функция
пятый:  пятом
приниматься:  принимаются
группировка:  группировок группировка
познакомиться:  познакомимся
непрерывный:  непрерывная непрерывных
условнаясходимость:  условнаясходимость
сложенияй:  сложенияи
уравненийв:  уравненийв
конструкция:  конструкция
куб:  куб
регрессия:  регрессии регрессия
величина:  величин величина величины
счёт:  счету
александр:  александр
замечательный:  замечательная замечательные
упростить:  упростить упростило
остаться:  осталось оставшиеся
уровень:  уровень уровня
логически:  логически
рассматривать:  рассматриваемом рассматривали
который:  которые который которой которая которое
грин:  грина
полный:  полное полных полной
исчисление:  исчисления исчисление исчислении
линейный:  линейные линейная линейных линейной
поизвращаться:  поизвращаться
эйлер:  эйлера
правый:  правой
музыка:  музыка
логарифмический:  логарифмическую логарифмической логарифмическая
мешаться:  мешалась
равенство:  равенство
навешивать:  навешиваем
запись:  записи запись
согласие:  согласия
локальный:  локальная
ожидание:  ожидание
придерживаться:  придерживаться
математика:  математики математике
лаплас:  лапласа
такой:  таким таком такое таких такая
перегиб:  перегиба
сходимость:  сходимости сходимость
дуоперационный:  дуоперационным
исследовать:  исследовать
дискретный:  дискретный
показаться:  показаться покажутся
порядок:  порядке порядка порядков
базис:  базисах базис базису
поверхность:  поверхности
знакочередоваться:  знакочередующиеся
задача:  задачи
тот:  те тех
векторный:  векторного векторное
ду:  ду
далее:  далее
зависимостьвектор:  зависимостьвекторов
шаг:  шагу шаг
линейныйкоэффициент:  линейныйкоэффициент
делать:  делать
экспонент:  экспонента
приступать:  приступаем
справиться:  справиться
нахождение:  нахождении нахождение нахождения
предложный:  предложен
допустимый:  допустимых допустимо
коэффициент:  коэффициент
соответствовать:  соответствующее
неопределённый:  неопределенный неопределенном
умолчание:  умолчанию
брать:  берем брать
сначала:  сначала
дробный:  дробной
исходный:  исходные исходной
метод:  методы метод методом
несколько:  несколькими
страница:  страницу
собственный:  собственные
практически:  практически
признак:  признак признаки
недостаток:  недостаток
произвольный:  произвольных
смотреть:  смотрим
данные:  данных
сложный:  сложной сложного сложное сложных сложнее сложными сложные сложная
несобственныйинтеграл:  несобственныйинтеграл
несложный:  несложных несложны
доступно:  доступно
объяснение:  объяснения
работать:  работает
будущее:  будущем
фурье:  фурье
урок:  урока урок уроке
поле:  поля
поэтому:  поэтому
разложение:  разложением разложение
учиться:  учимся
практика:  практике практикой
свойство:  свойства свойство
задавать:  задаваемые задают
типовой:  типовой
допустить:  допустить
хватить:  хватит
модуль:  модули модулем модуль
исследование:  исследование
икс:  икс икса
принцип:  принципе
ипример:  ипримеры
уравнение:  уравнению уравнений уравнения уравнение
точка:  точки точке
множество:  множества
найти:  найти найдем
оценка:  оценки оценка
переход:  переход
вариация:  вариации
требоваться:  требуется
асимметрия:  асимметрия
комплексный:  комплексными комплексные комплексного комплексный
вложение:  вложения вложение вложениями вложениях
основа:  основы
студент:  студент
слишком:  слишком
поверхностный:  поверхностные
раздел:  разделов
интервал:  интервалы
шаблон:  шаблону шаблона
книга:  книга книги
риск:  риск
формулировка:  формулировку
главный:  главную
кош:  коши
желательно:  желательно
представимый:  представим
координата:  координат координаты координатах
фигура:  фигуры
очередь:  очередь
пуассон:  пуассона
подобный:  подобные подобная
успех:  успехов
сводиться:  сводящиеся
чайник:  чайников
собственно:  собственно
замена:  замены
вложить:  вложен
практический:  практических
преобразование:  преобразований преобразованиях преобразование преобразования
вычисленияс:  вычисленияс
однако:  однако
целесообразно:  целесообразно
некоторый:  некоторым некоторых
глаз:  глазами
равноценный:  равноценны
малый:  малые наименьших
связь:  связь
понижение:  понижением понижение
матричный:  матричные матричных матричный
предварительный:  предварительной предварительное
подробный:  подробная подробными
обратный:  обратном обратная обратную
результат:  результате
дополнительный:  дополнительных
произведение:  произведении произведения произведение
заметить:  заметили заметил
навык:  навыки
уверить:  уверены
математическоеожидание:  математическоеожидание
например:  например
однородный:  однородные однородным
сомнение:  сомнения
решенияопределённый:  решенияопределенных
вычислить:  вычислить
нормальный:  нормальное
школа:  школа
очень:  очень
интегральнаятеорема:  интегральнаятеоремы
звонок:  звонок
корнимногочлен:  корнимногочлена
матрица:  матрицу матрицы матрицами
условие:  условие
испытанияй:  испытанияи
интегралыть:  интегралыв
иметь:  имеем иметь
неоднородный:  неоднородные
необходимо:  необходимо
ночь:  ночи
перегруппировка:  перегруппировка
зависеть:  зависят
правило:  правило правила правилу
основной:  основные
тангенс:  тангенса
наверх:  наверх
логарифм:  логарифма логарифмы логарифмов логарифмами логарифмом логарифм
помощь:  помощью
бернулли:  бернулли
полярный:  полярные полярной полярных
коэффициентковариация:  коэффициентковариации
ряд:  ряд ряды ряда ряде рядов
оформить:  оформить
быть:  будете буду будут
вариационный:  вариационный
внутренний:  внутренняя внутренней
второй:  второй вторым втором второго
должный:  должны должен
элементарный:  элементарных
вопрос:  вопросы вопрос
обратиться:  обратиться обратитесь
кратное:  кратные
внешний:  внешней внешняя
значительно:  значительно
системудифференциальный:  системудифференциальных
примениться:  применятся
обозначить:  обозначим
блог:  блог
трёхэтажный:  трехэтажная
доверительный:  доверительные
спросить:  спросил
последовать:  последовать
высокий:  высших высшей высшая
повергать:  повергает
заключать:  заключаем
среднееквадратический:  среднееквадратическое
пойти:  пойти
пространство:  пространстве
абсолютно:  абсолютно
алгоритм:  алгоритм
перекидывать:  перекидываем
тип:  типа
лопиталя:  лопиталя
последовательность:  последовательностей
удобный:  удобный
комбинационный:  комбинационная
матана:  матана
уловка:  уловок
курс:  курс
оба:  обе оба
квадратичный:  квадратичные
голос:  голос
компактно:  компактно
смешанноепроизведение:  смешанноепроизведение
обычно:  обычно
шутка:  шуткой
буковка:  буковка
объём:  объем
предполагаться:  предполагается
ставить:  ставим
хитрость:  хитростей хитростями
окончательно:  окончательно
поляформула:  поляформула
проверить:  проверить
сообщить:  сообщите
сделать:  сделать
линия:  линиями линии линия
фехнера:  фехнера
аналитический:  аналитическая аналитической
поскольку:  поскольку
школьный:  школьный школьных школьные
эффективный:  эффективные
левый:  левой
мы:  нам
центр:  центр
автомат:  автомате
образ:  образом
гипергеометрическоераспределение:  гипергеометрическоераспределение
условный:  условные
непрерывнаяслучайный:  непрерывнаяслучайная
другой:  других другое другие
эллипс:  эллипс
раз:  раза
прямо:  прямо
действие:  действие действия
позволить:  позволит
длина:  длина
материал:  материал материалы материалов
любой:  любой любом
сайт:  сайта сайты сайт
мочь:  могут можем
знакопостоянство:  знакопостоянства
производная:  производных
разность:  разности разность
сладкий:  сладкая
подробно:  подробно
хотеть:  хотите
равномерный:  равномерная равномерное
приятный:  приятный
браковать:  бракуют
градиент:  градиент
треугольный:  треугольная
тонкость:  тонкость тонкости
определение:  определения определению
палочка:  палочки
использовать:  используйте используя использовать используем
пожалуйста:  пожалуйста
даламбер:  даламбера
возвести:  возвести
пробовать:  пробуем
теорема:  теоремы
затем:  затем
комбинаторика:  комбинаторике
случайнаявеличина:  случайнаявеличина
повторнойя:  повторнойи
принимать:  принимать
оправдать:  оправдано
построение:  построение
следовать:  следует
вспоминать:  вспоминаем
проводить:  проводимые
бесконечно:  бесконечно
зверский:  зверский
линейнойкорреляционный:  линейнойкорреляционной
числитель:  числитель числителя
туда:  туда
время:  время времени
скобка:  скобки скобке
ранг:  ранг
расписывать:  расписывать
вращаться:  вращаться
кривая:  кривой
форма:  формы
квадрат:  квадратов
возникнуть:  возникнут
тяжестиплоска:  тяжестиплоской
отметить:  отметить
артподготовка:  артподготовки
сразу:  сразу
почему:  почему
распределениякритерия:  распределениякритерий
окончательный:  окончательный
функциюкомплексный:  функциюкомплексной
чётный:  чётное
напоминать:  напоминаю
наворотить:  навороченного
область:  область области
проверка:  проверка
мановение:  мановению
третий:  третий
предстоять:  предстоит
построить:  построить
готовый:  готовых готово
давать:  давать
несобственный:  несобственные
просто:  просто
мода:  мода
приём:  приём приемами приёмы
следующий:  следующую следующий следующие
свойстваэлементарный:  свойстваэлементарных
ещё:  ещё
вэ:  вэ
преподаватель:  преподаватели
глубокий:  глубокого глубокое
внимание:  внимание
стандартный:  стандартной
остальной:  остальное
лекционный:  лекционный
лейбниц:  лейбница
калькулятор:  калькулятор
слагаемое:  слагаемом
научиться:  научиться
дифференцироваться:  дифференцироваться
неравенство:  неравенства
процесс:  процесс
поток:  поток
кто:  кого
проверять:  проверять
касательная:  касательная
ответ:  ответ ответы
задачис:  задачис
рассуждать:  рассуждали
предвидеть:  предвижу
дальнейший:  дальнейшие
реальный:  реальных
недавно:  недавно
друг:  другом
разобраться:  разобраться
медиана:  медиана
бывать:  бывает
пройти:  пройденный
превратить:  превратить
функциия:  функциии
записать:  записать
частый:  чаще
возможно:  возможно
степенной:  степенного степенные
неприятный:  неприятную
функцийдвуха:  функцийдвух
равный:  равна
направлениюй:  направлениюи
запомниться:  запомнилась
выборка:  выборке
определённый:  определенный определенного
гостевой:  гостевая
подразумевать:  подразумевать
распределение:  распределения распределение
экстремум:  экстремумы
горнера:  горнера
основание:  основание
отмечаться:  отмечалось
производныефункция:  производныефункции
средний:  средняя
говорить:  говорить говоря
понятно:  понятно
волшебный:  волшебной
функцийнесколький:  функцийнескольких
подопытный:  подопытное
подготовка:  подготовки
внутригрупповаяй:  внутригрупповаяи
применять:  применяем
понять:  понять
алгебра:  алгебры
корректно:  корректно
далеко:  далеко
математик:  математика
любить:  любят
переменный:  переменных переменной
функцийв:  функцийв
оценить:  оцените
три:  трех трёх
видеть:  видите
несовместный:  несовместные
независимыеслучайный:  независимыеслучайные
множественнойлинейный:  множественнойлинейной
выполнение:  выполнения
знакомый:  знакомое
существовать:  существует
анализ:  анализ анализа
банальный:  банальных
непрерывность:  непрерывность
минус:  минус
прямоугольник:  прямоугольников
эксцессэмпирический:  эксцессэмпирического
содержать:  содержит
мгновенный:  мгновенный
подставить:  подставить
функциис:  функциис
дифференцировать:  дифференцировать
потренироваться:  потренируемся
лёгкий:  легче
зеркало:  зеркало
криволинейный:  криволинейные
значит:  значит
различный:  различных
позиция:  позиции
листочек:  листочек
пирсон:  пирсона
библиотека:  библиотека
аналогичный:  аналогичные
просить:  просят
межгрупповой:  межгрупповая
простота:  простоту
ортогональный:  ортогональное
дискретнойслучайный:  дискретнойслучайной
задачипо:  задачипо
подходящий:  подходящими
фокус:  фокус
востребовать:  востребованную
наименьшеезначение:  наименьшеезначения
нсв:  нсв
задачин:  задачина
сила:  силы
приблизить:  приближенные
предложить:  предложена
знак:  знак
упрощение:  упрощений
изучить:  изучить
штрих:  штрих штрихи
системылинейный:  системылинейных
нужно:  нужно
вроде:  вроде
проанализировать:  проанализировать
низкий:  низкий
задание:  задания заданиях задание
примечание:  примечание
упасть:  упал
ход:  ходе
организовать:  организовать
зависимый:  зависимые
путём:  путём
зависимость:  зависимость
отклонение:  отклонение
крамер:  крамера
отрезка:  отрезке
что:  чему
прийтись:  придется
трудно:  трудно
случайный:  случайных случайные
предварительно:  предварительно
замкнутый:  замкнутому
тройка:  тройки
освоение:  освоения
дуга:  дуги
частность:  частности
внимательно:  внимательно
свой:  свои
первоначальный:  первоначального
отрезкать:  отрезкав
желать:  желаю желающие
вежливый:  вежливый
дивергенция:  дивергенция
парабола:  парабола
линейность:  линейности
множитель:  множителей
выноситься:  выносится
форум:  форуме форум
показатель:  показатели
наш:  наш
оформление:  оформления оформление оформлении
начать:  начнем начать
мучение:  мучениями
прорешать:  прорешать
квадратный:  квадратный квадратного
площадьс:  площадьс
запретить:  запрещено
изучение:  изучении изучения
функциидвуха:  функциидвух
статистический:  статистические статистическая
черновик:  черновике
емелин:  емелин
оформлять:  оформлять
исчезать:  исчезает
убыванией:  убываниеи
одинаковый:  одинаковые
повышенный:  повышенной
детерминация:  детерминации
сторона:  стороны
возрастание:  возрастание
эмпирический:  эмпирические
строгость:  строгостью
компактный:  компактному
также:  также
интегрирование:  интегрирование
легко:  легко
заключительный:  заключительные
рациональный:  рациональные
использование:  использование
обещать:  обещанная
найтись:  нашлось
учебник:  учебнике
системый:  системыи
удовлетворяетлить:  удовлетворяетли
полезный:  полезный
этот:  этих эта
навесить:  навесив
читатель:  читателям
довести:  довести
дифференциальныеуравнение:  дифференциальныеуравнения
ситуация:  ситуация
иррациональный:  иррациональных
детский:  детской
интервальный:  интервальный
перейти:  перейти
перерисовать:  перерисуйте
применение:  применения
тригонометрический:  тригонометрических
постоянный:  постоянных
понимать:  понимает
стокс:  стокса
квадратичнуюформ:  квадратичнуюформу
схема:  схема
карта:  карта
косинус:  косинус косинуса
параметрический:  параметрической параметрическом
многочлен:  многочлена
самостоятельно:  самостоятельно
гипербола:  гипербола
повышать:  повышать
вообще:  вообще
казаться:  казаться
телефонный:  телефонный
дробовик:  дробовик
они:  ними
оценкия:  оценкии
неявный:  неявной
фишка:  фишка
несобственныхинтеграл:  несобственныхинтегралов
вероятностибиномиальный:  вероятностибиномиального
уметь:  умеет
вероятностия:  вероятностии
логика:  логики
спирмена:  спирмена
скалярный:  скалярное
род:  рода
гаусс:  гаусса
заданав:  заданав
уверенно:  уверенно
автопилот:  автопилоте
всё:  всё
оговорка:  оговорку
значимость:  значимости
лекция:  лекции
тройной:  тройные
возникать:  возникает
равносильный:  равносильны
особый:  особых
деление:  деления
мысленно:  мысленно
контуруформула:  контуруформула
частное:  частного
экстремальный:  экстремальные
график:  график
близко:  близко
лишь:  лишь
комментарий:  комментариями
дело:  дела деле дело
весь:  весь всей
её:  её
парный:  парной
св:  св
избавиться:  избавимся
нормаль:  нормали
определитель:  определитель
искусственно:  искусственно
доказать:  доказать
выпуклость:  выпуклость
поднять:  поднять
пара:  пара
элемент:  элементы
достаточно:  достаточно
текст:  текст
показательный:  показательное
упрощать:  упрощают
равносильность:  равносильности
рекомендовать:  рекомендую
помучаться:  помучается
независимый:  независимые
раскрыть:  раскрыть
менее:  менее
получить:  получи
нога:  ногами
автор:  автора автор
кузнецов:  кузнецова
сложность:  сложности
штука:  штуку
диффура:  диффурами
часто:  часто
значенияй:  значенияи
справедливо:  справедливо
нужный:  нужной
получаться:  получается
редкий:  редка
вычисление:  вычисление
я:  мной
классическоеопределение:  классическоеопределение
инормаль:  инормаль
задумываться:  задумываться
статистика:  статистика
экзамен:  экзамене
корреляция:  корреляции
прежде:  прежде
монстр:  монстра
биномиальный:  биномиальное
записаться:  запишется
симпатичный:  симпатичному
пирамида:  пирамида
заочник:  заочников
разный:  разные
нежелательно:  нежелательно
повторение:  повторения
линиюв:  линиюв
самостоятельный:  самостоятельного
расписать:  распишу
максимально:  максимально
справедливый:  справедливы
отношение:  отношении
развалить:  развалить
хотеться:  хочется
нарисоваться:  нарисовалась
повторять:  повторяем
закрепить:  закрепим
устно:  устно
настать:  настало
вынести:  вынести
час:  часа
