придать:  придать придадим
секущий:  секущая секущей секущую
уяснить:  уяснить
коллега:  коллега
производный:  производные производная производной производную производного
предел:  предел пределами пределы пределов предела
небольшой:  небольшой невелико
качественно:  качественно
числовой:  числовые
проблема:  проблему проблем
точнее:  точнее
производныенеявно:  производныенеявно
значение:  значение значений значения значении
выбрать:  выберут выбрал выбрать выбран
обозначать:  обозначают обозначает
десятиметровый:  десятиметровом
находить:  находить находят находили
движение:  движение движения
формула:  формулы формулой формуле формула формулу
смотреть:  см смотрим
приблизить:  приближенных приближенные
читатель:  читатель читатели
особенно:  особенно
канонический:  каноническому
стремиться:  стремиться стремится
два:  две двух
отрезок:  отрезку отрезок отрезка
альпинистский:  альпинистское
дифференциал:  дифференциалах дифференциалов дифференциалом дифференциал дифференциала дифференциале
больший:  наибольшее большим большую
многие:  многие
один:  одну одна одной
против:  против
проводиться:  проводится
пьянка:  пьянка
сам:  самого самом самим саму сама самой
применить:  применю
число:  число числе числами числа
вогнутостья:  вогнутостьи
позволять:  позволяет
ребро:  ребром ребро
особенность:  особенность особенности
строгий:  строгое строгую
случай:  случай случаев случае случаях
скромный:  скромным
убедиться:  убедиться убедятся
профессия:  профессию
пусть:  пусть
удобно:  удобно
умножение:  умножения
система:  система системе систему системы
группировка:  группировок группировка
показывать:  показывая показывает
условнаясходимость:  условнаясходимость
путать:  путать
слово:  словами словом слову
угол:  угол углу угла углов
заключительный:  заключительная
александр:  александр
ось:  ось оси
экран:  экрану
термин:  термины
находиться:  находился находились находимся
существование:  существование существованием существовании
закон:  закон законы закону
линейный:  линейные линейная линейную линейных линейной
вниз:  вниз
правый:  правой
стать:  стало стать
равенство:  равенство равенстве равенством
быть:  суть будем
согласие:  согласия
понятие:  понятию понятии понятия понятий понятие
совет:  совет
дуоперационный:  дуоперационным
из:  изо
базис:  базисах базису базис
холмистый:  холмистому
зависимостьвектор:  зависимостьвекторов
снова:  снова
оно:  оно
соответствовать:  соответствующее соответствуют
сначала:  сначала
значительный:  значительную значительная
метод:  методы методом метод
правосторонний:  правосторонний
тема:  теме
геометрически:  геометрически
страница:  страницу страницы
математический:  математическая математического математические математический математической
данные:  данных
прямой:  прямых прямая прямой прямые прямую
интеграл:  интеграл интегралов интегралы интеграла интеграле
урок:  урока уроки урок уроке
разложение:  разложением разложение
конечный:  конечен конечны
икс:  икс икса
сумма:  суммой сумму сумма
уравнение:  уравнению уравнения уравнение уравнений
преодолеть:  преодолев
дуга:  дугой дуги дугами
мочь:  можете могут
переход:  переход
утверждение:  утверждение
совпадать:  совпадают совпадает совпадающую
получить:  полученную полученного получим получено полученное полученной полученным получили получи
заметка:  заметку
молодой:  молодых
желательно:  желательно
очередь:  очередь
первый:  первое первую первой первому первом первого первый
цвет:  цветом
практический:  практических практическим практический
доступный:  доступен
целесообразно:  целесообразно
малый:  малые малом малое наименьших меньшую малый меньшей
связь:  связь связи
повлечь:  повлекло
точка:  точку точки точках точка точкам точке
приложение:  приложениях приложения
плохо:  плохо
скорость:  скоростью скорость скорости
нормальный:  нормальное
интегральнаятеорема:  интегральнаятеоремы
итоговый:  итоговое
корнимногочлен:  корнимногочлена
логарифмический:  логарифмическая
решить:  решил решить
глагол:  глагол
условно:  условно
начать:  начнём начать начните
основной:  основные
функция:  функцией функции функция функций функцию
бернулли:  бернулли
полярный:  полярные полярных полярной
участок:  участках участков участка участок участке
рассмотреть:  рассмотрим рассмотрено рассмотреть рассмотрена
ряд:  ряды ряда ряд рядов
уровень:  уровня уровне
значительно:  значительно
определение:  определении определению определение определения
доверительный:  доверительные
попросту:  попросту
смысл:  смысле смысл
среднееквадратический:  среднееквадратическое
расположение:  расположению расположение
коротко:  коротко
говориться:  говорится
убывание:  убывание убывания убывании
комбинационный:  комбинационная
оба:  обе обеих оба
листок:  листок
детальный:  детальной
смешанноепроизведение:  смешанноепроизведение
демонстрационный:  демонстрационная демонстрационной
дисперсия:  дисперсия дисперсии дисперсию
спускаться:  спускаемся
круто:  круто
школьный:  школьный школьному школьном
высота:  высота высоту высоте высоты
мы:  нам
прямоугольный:  прямоугольный
принадлежащий:  принадлежащую
образ:  образом
непрерывнаяслучайный:  непрерывнаяслучайная
ибо:  ибо
четыре:  четыре
прямо:  прямо
длина:  длина длине
наблюдаться:  наблюдается
материал:  материал материалов материалы материалам
процесс:  процессе
немного:  немного
знакопостоянство:  знакопостоянства
противоположный:  противоположной
неплохо:  неплохо
интервал:  интервале интервала интервалах интервалы интервал интервалу интервалов
градиент:  градиент
догадаться:  догадались
удачно:  удачно
линия:  линия линии линиями
полагать:  полагаем
вспомнить:  вспомним
коричневый:  коричневой коричневый коричневая
ясно:  ясно
комбинаторика:  комбинаторике
случайнаявеличина:  случайнаявеличина
иной:  иного иное иными
дифференцировать:  дифференцируя дифференцировать дифференцируема дифференцируемой
бесконечно:  бесконечно
оттачиваться:  оттачивается
отношение:  отношению отношение отношении отношения
давать:  даёт давайте
удивительный:  удивительной
форма:  формы
определённый:  определённая определённых определенный определенного
задача:  задачу задачи задач задача
статья:  статьи статьёй статье
чёрный:  чёрной чёрную
обратный:  обратную обратная обратное
рассматривать:  рассматривать рассматриваемой рассматриваемых рассматриваемого рассматриваемом
неполный:  неполным
график:  графиком графику графиков график
год:  годы года
готовый:  готовых
просто:  просто
измерительный:  измерительного
ещё:  ещё
таковой:  такового
обычный:  обычная обычную
свой:  своих своё
уважаемый:  уважаемые
уменьшение:  уменьшения уменьшением
нахождение:  нахождения нахождение нахождении
единый:  единым единая единой
подобный:  подобных
данный:  данного данном данный
непрерывный:  непрерывных непрерывная непрерывна
вернуться:  вернуться
производныефункция:  производныефункции
средний:  средняя среднюю
провести:  проведённого проведём проведите
отметить:  отметил отмечен
область:  области область
зелёный:  зелёной зелёная зелёными зелёным
подобрать:  подобрать
плюс:  плюс
путь:  пути путь путями
корректно:  корректно
предположим:  предположим
далеко:  далеко
математик:  математика
мудрый:  мудрый
переменный:  переменных переменной
пример:  пример примера примерам примере примеры
посмотреть:  посмотрим
разность:  разность
горка:  горку горки
несовместный:  несовместные
буква:  буквы
независимыеслучайный:  независимыеслучайные
вверх:  вверх
дюжина:  дюжина
следовательно:  следовательно
зверь:  звери
модель:  модель модели
непрерывность:  непрерывность непрерывности непрерывностью
минус:  минус
семейство:  семейство
уклон:  уклон
функциис:  функциис
полный:  полной полных полное полного полному
зеркало:  зеркало
уменьшать:  уменьшать уменьшая уменьшаем
значит:  значит
исходный:  исходная исходных
пирсон:  пирсона
некоторый:  некоторую некотором некоторое
вопрос:  вопрос вопросом вопросы
геометрический:  геометрических геометрический геометрическая геометрическое
межгрупповой:  межгрупповая
ортогональный:  ортогональное
синь:  синей
заменить:  заменить
представить:  представят представьте
малиновый:  малиновым малиновые малиновый малиновая
доставать:  достаёт
нсв:  нсв
аргумент:  аргументу аргумента
граница:  границах
положение:  положение
тесно:  тесно
придумать:  придумал
какой:  какое какие каком каким
быстро:  быстро
упасть:  упал
ход:  ходе
гарантированно:  гарантированно
отрезка:  отрезке
красный:  красный красная красному красной
величина:  величина величин величины
скинуть:  скинем
указать:  укажет
подъём:  подъемов подъёма подъёмах подъемом подъёмом подъём
нарисоваться:  нарисовалось
учебный:  учебном учебные
таблица:  таблица таблицы таблицей
преодолевать:  преодолеваем
детерминация:  детерминации
сторона:  стороны сторону сторона
обязательно:  обязательно
следующий:  следующие следующее следующий следующем
подробный:  подробное подробной
дифференциальныеуравнение:  дифференциальныеуравнения
взять:  возьмём возьмите взять взятой
постоянный:  постоянных постоянна постоянной
стокс:  стокса
схема:  схема
соответствие:  соответствие
символ:  символом символа символ
неформальный:  неформальный
дифференцирование:  дифференцирования
окрестность:  окрестность окрестности
дробовик:  дробовик
сущность:  сущности
пытливый:  пытливые
часть:  частью частям часть части частях
математика:  математике математики
векторный:  векторное векторного
слабо:  слабо
ваш:  ваши вашего ваших
вероятностия:  вероятностии
медленно:  медленно
скалярный:  скалярное
весёлый:  весёлыми
совершенно:  совершенно
наш:  нашем наше наш нашей нашего
критический:  критических
значимость:  значимости
дать:  дадут данному данная данные данной
страшный:  страшного
мысленно:  мысленно
промежуток:  промежутках промежуток
предельный:  предельный предельное
анализ:  анализа анализ
её:  её
частный:  частное частные
парный:  парной
топографический:  топографической
сбоку:  сбоку
несколько:  несколько
найти:  найдём найденное найти найденная
момент:  моменты момент
сборник:  сборники
параметрический:  параметрическом параметрической
прислать:  пришли
озвучить:  озвучу
часто:  часто
пология:  пологий
увлекательный:  увлекательное
получаться:  получается
другой:  другая другие другую
решение:  решение решением решения решений
форум:  форум форуме
книга:  книги книга
эксплуатироваться:  эксплуатируется
обстоятельный:  обстоятельный
ровный:  ровный ровному ровных ровного ровная
случаем:  случаем
инструментарий:  инструментария
приращение:  приращение приращением приращения приращению приращениями
вектор:  векторы векторов
вращение:  вращения
полениться:  поленюсь
именно:  именно
копирование:  копирование
дальнейший:  дальнейшим
разрыв:  разрыва
выражение:  выражения
дорожка:  дорожки
вершина:  вершину вершинах
роль:  роль
парабола:  параболы парабола
грубо:  грубо
идеально:  идеально
отблагодарить:  отблагодарить
являться:  являются является
байес:  байеса
выгодно:  выгодно
решать:  решать
ущелие:  ущелье
точность:  точности
маленький:  маленькое маленький меньше мала
результат:  результат результата результате
теория:  теория теорию теорией теории
связать:  связано
отсутствовать:  отсутствует
ранний:  раньше
характеризовать:  характеризует
называть:  называемый называют
изменение:  изменение изменения
двумерный:  двумерная
задать:  заданной задать задайте зададим
тело:  тела
циркуляция:  циркуляция
слева:  слева
плоскость:  плоскости плоскость
пол:  пол
общий:  общим общая общем общего общей
гранит:  гранита
поздний:  позже
определителяй:  определителяи
итог:  итогу итоге
выделить:  выделить
корректный:  корректнее корректным
согласно:  согласно
дважды:  дважды
дробь:  дроби дробей
справа:  справа
заменимый:  заменим
самый:  самым самую самое
качество:  качестве
изящно:  изящно
действие:  действий действия
вероятность:  вероятностей вероятность вероятности
сравнение:  сравнению
любой:  любое любой любого любую
заключение:  заключение
уравненийв:  уравненийв
сработать:  сработает
появиться:  появились появилась появился
грин:  грина
эйлер:  эйлера
направо:  направо
предыдущий:  предыдущим предыдущего
невозможно:  невозможно
дискретный:  дискретный
знакочередоваться:  знакочередующиеся
информация:  информацией информация
рассказать:  рассказать
минимум:  минимума минимум
бесконечность:  бесконечности
пожалуй:  пожалуй
практически:  практически
произвольный:  произвольных произвольное произвольную
склон:  склона склоне склону
крутой:  крут крутым круче
сложный:  сложной сложные сложных
будущее:  будущем
фурье:  фурье
поле:  поля
посредством:  посредством
гипотеза:  гипотез гипотеза гипотезы
свойство:  свойства
взмывать:  взмывает
авторский:  авторском
откинуть:  откинем
простой:  прост простые
исследование:  исследование
начинаться:  начинается
вариация:  вариации
занимать:  занимает
основа:  основы
глаз:  глаза
слишком:  слишком
мало:  мало
положительный:  положительна положительны положительным
кош:  коши
параграф:  параграфа
примерять:  примерять
составлять:  составляет
чайник:  чайников чайники
раздел:  раздел
вычисленияс:  вычисленияс
который:  котором который которая которое которого которых которой
двигать:  двигаем двигая
модуль:  модуля
матричный:  матричные матричных матричный
последний:  последний
заметить:  заметили заметьте
однородный:  однородные однородным
вычислить:  вычислить
очень:  очень
коэффициент:  коэффициентом коэффициент коэффициента коэффициенту
матрица:  матрицу матрицы матрицами
испытанияй:  испытанияи
интегралыть:  интегралыв
оное:  оного
перегруппировка:  перегруппировка
построить:  построенное построить
каждый:  каждое каждому каждом каждой каждый
монитор:  монитора монитору
помощь:  помощью
дифференциальный:  дифференциальном дифференциальных дифференциальные
метр:  метра метре метров метр
провернуть:  провернём
вариационный:  вариационный
выражать:  выражает
неопределённость:  неопределённости
миновать:  минуя
добраться:  добраться
блог:  блог
высокий:  высших высшей высоким высшая
школа:  школы школа
единственный:  единственной
пространство:  пространстве
забыть:  забыли
оказываться:  оказываемся
удобный:  удобный
курс:  курс курсе
координата:  координаты координат координатах
ордината:  ординат
лист:  лист
окончательно:  окончательно
сообщить:  сообщите
сделать:  сделать
главный:  главном главной главную
аналитический:  аналитическая аналитическое аналитической
понижение:  понижение понижением
левый:  левой левее левая левую
центр:  центр
описать:  опишем
обозначить:  обозначить обозначил обозначив
производная:  производных
преобразование:  преобразованиях преобразования преобразований
наклон:  наклона наклон
идти:  идут идёт шла
орёл:  орлами
аккуратный:  аккуратнее
быстрый:  быстрее быстрым
построение:  построение
осуществляться:  осуществляется
гора:  гору горы
природа:  природе природу
линейнойкорреляционный:  линейнойкорреляционной
пользоваться:  пользовались пользуясь
существенно:  существенно
время:  время времени
оставаться:  остаётся
пора:  пор пора
особо:  особо
неизменный:  неизменным
почему:  почему
распределениякритерия:  распределениякритерий
техника:  технике техника
читаться:  читается
автобан:  автобану
отметка:  отметка
семантика:  семантики
предстоять:  предстоит
несобственный:  несобственные
искомый:  искомая
зрение:  зрения
откуда:  откуда
случайность:  случайность
подойти:  подошло
вразумительный:  вразумительной
полностью:  полностью
касательная:  касательная касательной
прямолинейный:  прямолинейные
задачис:  задачис
комплексовать:  комплексуйте
правило:  правила правило правилами
функциия:  функциии
степенной:  степенного степенные
функцийдвуха:  функцийдвух
выборка:  выборке
проделать:  проделанных
голодный:  голодные
понятный:  понятным понятнее
уменьшаться:  уменьшается
функцийнесколький:  функцийнескольких
односторонний:  односторонние односторонними
понять:  понять
кочка:  кочки кочек
рост:  роста рост
точный:  точное
важный:  важнейшей важнейшим важную
положительно:  положительно
множественнойлинейный:  множественнойлинейной
зависимость:  зависимости зависимость
дорога:  дороги дорогу дорога
распределение:  распределение распределения
забывать:  забываем
город:  города город
заострять:  заостряю
подниматься:  поднимаемся
навигатор:  навигатор
пройти:  пройдём
задачипо:  задачипо
сообщать:  сообщала
востребовать:  востребованную
низкий:  низкое
видно:  видно
знак:  знаку
учиться:  учащиеся учимся
снимка:  снимок
образец:  образец
кривая:  кривые кривой
катет:  катету катета
примечание:  примечание
графически:  графически
зависимый:  зависимые
отклонение:  отклонение
следовать:  следовало следует
что:  чему чём
конкретный:  конкретное
произведение:  произведение
вполне:  вполне
случайный:  случайных случайные
частность:  частности
численно:  численно
отрезкать:  отрезкав
играть:  играет
дивергенция:  дивергенция
существовать:  существовало существует существуют
чертёж:  чертежа чертёж чертеже
двигаться:  двигаться
сайт:  сайт сайте сайты сайта
графика:  графики графика
ассоциировать:  ассоциировать
спешить:  спешите
квадратный:  квадратный
путешествие:  путешествие
неверно:  неверно
ситуация:  ситуации
синий:  синий
причина:  причине
возрастание:  возрастание возрастания
эмпирический:  эмпирические
найтись:  нашлось
этот:  этих
знать:  зная знать
аналогично:  аналогично
бесконечный:  бесконечного бесконечны
иррациональный:  иррациональных
квадратичнуюформ:  квадратичнуюформу
характеристика:  характеристики
карта:  карта картой
реферат:  реферата
экстремум:  экстремумах экстремумов экстремумы
гипербола:  гипербола
зависеть:  зависящий зависит
равно:  равно
они:  ними
обозначение:  обозначение
закономерный:  закономерный
логика:  логики
спирмена:  спирмена
вид:  виду виды вид виде
возникать:  возникает
низина:  низинах
близко:  близко
лишь:  лишь
св:  св
второй:  второго вторая
иметь:  имеет
отложить:  отложите
долгий:  долгие
достаточно:  достаточно
показательный:  показательное
бывать:  бывают бывает
назвать:  назовём
убыль:  убыль
горизонталь:  горизонтали
диффура:  диффурами
остаться:  оставшиеся
параллельный:  параллельная параллельных
весьма:  весьма
вычисление:  вычисление вычислений
завести:  завела
статистика:  статистика
прилежащий:  прилежащему
биномиальный:  биномиальное
особый:  особые особых
потренироваться:  потренироваться
линиюв:  линиюв
справедливый:  справедливы
хотеться:  хочется
показать:  покажем покажет
непонятка:  непонятки
любопытный:  любопытные
посетитель:  посетителей
везде:  везде
дуприближённо:  дуприближённо
прочитать:  прочитайте
левосторонний:  левосторонний
асимптота:  асимптоты
шажок:  шажок
событие:  события событий
устремить:  устремить
механический:  механический
повторный:  повторные
смех:  смех
различный:  различны различных различным
учитывать:  учитывая
состоять:  состоит
постоянно:  постоянно
константа:  константы
замена:  замену замены
фнп:  фнп
пособие:  пособия
забираться:  забираемся
выделять:  выделяем
измерить:  измерить
простейшее:  простейшие
отсрочить:  отсрочить
мера:  мера меру мере
нить:  нитью
достигаться:  достигается
приступать:  приступать
двойной:  двойные двойной
вправо:  вправо
несобство:  несобств
о:  обо
бумага:  бумаги
показаться:  покажется
нелинейный:  нелинейная
преобразованиеквадратичный:  преобразованиеквадратичной
разрывный:  разрывных
петлять:  петляющие
функциональный:  функциональные
переходить:  переходить
классический:  классический
ничтожно:  ничтожно
абсолютный:  абсолютная
разный:  разными разной разные
треугольник:  треугольник
тот:  тому той
сложенияй:  сложенияи
регрессия:  регрессии регрессия
ориентироваться:  ориентируетесь
печалька:  печалька
расстояние:  расстояние
требовать:  требуют
исчисление:  исчисления исчислении
актуальный:  актуален
гораздо:  гораздо
локальный:  локальная
отрицательный:  отрицательным отрицательна
сказать:  сказать скажу
ожидание:  ожидание
лаплас:  лапласа
такой:  таким такое такая
перегиб:  перегиба
сходимость:  сходимости сходимость
осознавать:  осознавая
достигать:  достигает
ду:  ду
далее:  далее
лёгкий:  лёгким
мысль:  мысль
неопределённый:  неопределенный неопределенном
максимум:  максимума
собственный:  собственные
признак:  признак признаки
соображение:  соображений
поэтому:  поэтому
практика:  практике
вместо:  вместо
крутизна:  крутизны крутизну
разумеется:  разумеется
проработать:  проработать
отработать:  отработать
теоретический:  теоретический
неравенство:  неравенство неравенства
исследовать:  исследуем исследовать
асимметрия:  асимметрия
приключение:  приключение
шаблон:  шаблону
сверху:  сверху
матан:  матан
сводиться:  сводящиеся
собственно:  собственно
одежда:  одежду
происхождение:  происхождение
элементарный:  элементарный
задаться:  зададимся
составить:  составим составить составит
подопытный:  подопытной
послание:  послание
например:  например
решенияопределённый:  решенияопределенных
интересный:  интересный интересен
угловой:  угловой угловому углового угловым
выглядеть:  выглядит
мерило:  мерилом
задаваться:  задаётся
предполагать:  предполагаю
аналогичный:  аналогичное
базироваться:  базируется
тангенс:  тангенса тангенс тангенсу тангенсов
коэффициентковариация:  коэффициентковариации
магистраль:  магистрали
лягушка:  лягушками
противоход:  противоход
суд:  суда
рисунок:  рисунку рисунок рисунке
перечисленный:  перечисленные
отрывать:  отрывать
рассуждение:  рассуждения
финн:  финнами
широкий:  широком
факт:  фактов факт факты
абсцисса:  абсцисс
долго:  долго
лопиталя:  лопиталя
называться:  называется
потребоваться:  потребовалось
развеять:  развеет
квакать:  квакающими
поляформула:  поляформула
наверное:  наверное
фехнера:  фехнера
противолежащий:  противолежащего
эффективный:  эффективные
условный:  условные
эллипс:  эллипс
ноль:  ноль
доказательство:  доказательство
достигаемый:  достигаем
даламбер:  даламбера
теорема:  теоремы
стандартный:  стандартный
повторнойя:  повторнойи
естественно:  естественно
грех:  грех
комплексный:  комплексные комплексного комплексный комплексными
аналогия:  аналогии
скобка:  скобки
ранг:  ранг
засечка:  засечек
тяжестиплоска:  тяжестиплоской
содержательный:  содержательнее
использовать:  используя использовать используйте
нулевой:  нулевая нулевое
вникать:  вникают
относительно:  относительно
ставиться:  ставится
проверка:  проверка
касаться:  касается
вызвать:  вызвавшему
внимание:  внимание
лейбниц:  лейбница
оказаться:  окажемся
судьба:  судьба
лениться:  ленимся
багаж:  багажа
поток:  поток
бросаться:  бросается
пытаться:  пытался
медиана:  медиана
направлениюй:  направлениюи
благодаря:  благодаря
гостевой:  гостевая
переписать:  перепишем
кроме:  кроме
животворящий:  животворящий
равный:  равен равна
понятно:  понятно
знание:  знаний
вывод:  вывод
мастер:  мастером
внутригрупповаяй:  внутригрупповаяи
алгебра:  алгебры алгебра
учебник:  учебник
невероятно:  невероятно
пониматься:  понимается
намного:  намного
овраг:  оврага
прямоугольник:  прямоугольников
эксцессэмпирический:  эксцессэмпирического
говорить:  говорит говоря
потребность:  потребностей
оценка:  оценка оценки
неожиданный:  неожиданному неожиданный
криволинейный:  криволинейные
библиотека:  библиотека
идея:  идея
определяться:  определяется
настолько:  настолько
возможность:  возможности
корень:  корень
экстремаленький:  экстремалы
издание:  издание
наименьшеезначение:  наименьшеезначения
сила:  силы сил
насмотреться:  насмотревшиеся
вычислимый:  вычислим
запросто:  запросто
осуществимый:  осуществим
системылинейный:  системылинейных
определить:  определена
замкнутый:  замкнутому
очевидный:  очевидно
проверить:  проверим проверить
желать:  желаю
прагматичный:  прагматичен
истолковывать:  истолковывает
располагать:  располагать
показатель:  показатели
свет:  свете
площадьс:  площадьс
ранее:  ранее
убыванией:  убываниеи
повышенный:  повышенной
статистический:  статистическая статистические
также:  также
интегрирование:  интегрирование
охарактеризовать:  охарактеризовать
легко:  легко
рациональный:  рациональные
расположить:  расположенную
скептик:  скептики
пока:  пока
нуль:  нулю нуля
раскрутка:  раскрутка
интервальный:  интервальный
соответственно:  соответственно
проанализировать:  проанализировал
среднее:  среднем
объяснение:  объяснение
рука:  руку руки
подставить:  подставили
оценкия:  оценкии
неявный:  неявной
развивать:  развиваем
подобраться:  подобрались
несобственныхинтеграл:  несобственныхинтегралов
вероятностибиномиальный:  вероятностибиномиального
уметь:  умеет
род:  рода
гаусс:  гаусса
шоссе:  шоссе
рельеф:  рельеф
полезно:  полезно
проштудировать:  проштудировать
точно:  точно
экстремальный:  экстремальные
спуск:  спусках спуск
маршрут:  маршрут
нормаль:  нормали
определитель:  определитель
повременить:  повременить
технарь:  технарей
выпуклость:  выпуклость
элемент:  элементы
знаменатель:  знаменатель
начало:  начала начале
линейка:  линейки линейку
разбирать:  разбирать
сложность:  сложности
добрый:  добрая
значенияй:  значенияи
справедливо:  справедливо
поглощать:  поглощать
взяться:  взялись взялась
объяснять:  объяснять
нужный:  нужной
кстати:  кстати
вывести:  выведена вывести
дельта:  дельта дельту
классическоеопределение:  классическоеопределение
инормаль:  инормаль
далёкий:  дальше
терминология:  терминологию
пирамида:  пирамида
изобразить:  изобразите изображена изобразим
автор:  автор автора
интерпретация:  интерпретация
понимание:  понимания
близкий:  ближайшем
уравненияс:  уравненияс
онлайн:  онлайн
подводить:  подводят
геометрия:  геометрии геометрия
использоваться:  используется
работа:  работа
новый:  новому
произвольныйтройный:  произвольныйтройной
ниже:  ниже
основный:  основного
дизайн:  дизайна
это:  это
поляй:  поляи
место:  местах местами
опечатка:  опечатку
тетрадка:  тетрадку
способ:  способом
неудивительный:  неудивительно
расположиться:  расположится
совместить:  совместите
речь:  речь
увеличиваться:  увеличивается
направление:  направлении направления направлению
комментарий:  комментарий
методомоперационный:  методомоперационного
бесповторный:  бесповторной
мой:  моём моей
ошибка:  ошибку
намёк:  намёк
л:  л
упомянуть:  упомянул
поздно:  поздно
снизу:  снизу
внизу:  внизу
эталон:  эталона
касательный:  касательных касательную
приблизительно:  приблизительно
типовыхзадача:  типовыхзадач
ранговойкорреляция:  ранговойкорреляции
отдельно:  отдельно
наткнуться:  наткнуться
курсовик:  курсовика
подсказывать:  подсказывает
конец:  концу
одинаковый:  одинаков
пропорция:  пропорциям
дотянуться:  дотянется
ветвь:  ветвь
малое:  малым
нетрудно:  нетрудно
поверхность:  поверхности
сохранять:  сохраняет
пойти:  пошла
линейныйкоэффициент:  линейныйкоэффициент
чертёжить:  чертёжа
несобственныйинтеграл:  несобственныйинтеграл
доступно:  доступно
причём:  причём
задавать:  задаваемые
достоверный:  достоверные
сегодняшний:  сегодняшних
ипример:  ипримеры
множество:  множества
прозрачный:  прозрачная
поверхностный:  поверхностные
холм:  холма
фигура:  фигуры
пуассон:  пуассона
успех:  успехов
большой:  большое
однако:  однако
таки:  таки
фактически:  фактически
убывать:  убывает
отрицательно:  отрицательно
математическоеожидание:  математическоеожидание
закачиваться:  закачивается
успешно:  успешно
предпочтение:  предпочтения
неоднородный:  неоднородные
необходимо:  необходимо
средство:  средствами
безоблачный:  безоблачно
около:  около
возрастать:  возрастает возрастают
обратить:  обратим обратите
думать:  думаю
обратиться:  обратиться
кратное:  кратные
системудифференциальный:  системудифференциальных
нехорошесть:  нехорошестей
изначально:  изначально
вдумчиво:  вдумчиво
цельный:  цельный
алгоритм:  алгоритм
расти:  растёт
последовательность:  последовательностей
должный:  должно
квадратичный:  квадратичные
координатный:  координатные
стык:  стыка
объём:  объем
утверждать:  утверждать
поскольку:  поскольку
невкусный:  невкусным
гипергеометрическоераспределение:  гипергеометрическоераспределение
верхний:  верхнюю
приложимый:  приложим
раз:  раза
дно:  дно
избавиться:  избавился
обрыв:  обрывом
равномерный:  равномерная равномерное
изучить:  изучим
треугольный:  треугольная
насыщение:  насыщение
выполнить:  выполню
картина:  картина
пожалуйста:  пожалуйста
влево:  влево
формализовать:  формализовать
себя:  собой
раскрыть:  раскрыли
однозначно:  однозначно
квадрат:  квадратов
удивиться:  удивятся
зашифровать:  зашифрованное
ускорение:  ускорение
недурно:  недурно
поставить:  поставить
сразу:  сразу
функциюкомплексный:  функциюкомплексной
напоминать:  напоминаю
заодно:  заодно
мода:  мода
свойстваэлементарный:  свойстваэлементарных
принимать:  принимает
дифференцируемость:  дифференцируемость дифференцируемости
калькулятор:  калькулятор
научиться:  научиться
происходить:  происходит
фихтенголец:  фихтенгольца
приближаться:  приближаться
карандаш:  карандаш
уместиться:  уместится
делить:  делённый
глубокий:  глубокое
действительно:  действительно
осуществить:  осуществлено
горнера:  горнера
отмечаться:  отмечалось
двояко:  двояко
случайно:  случайно
предельно:  предельно
получать:  получаем
функцийв:  функцийв
активно:  активно
видеть:  видите
отвесный:  отвесным
спутниковый:  спутниковый
довольно:  довольно
опубликовать:  опубликовал
местность:  местность
беречь:  берегите
иллюстрация:  иллюстрации
содержать:  содержащий
понимать:  понимать
три:  трёх
пятый:  пятой
дискретнойслучайный:  дискретнойслучайной
фокус:  фокус
сабж:  сабжу
крамер:  крамера
принципиальный:  принципиальный
базовый:  базовые
строго:  строго
запретить:  запрещено
функциидвуха:  функциидвух
емелин:  емелин
снаряжение:  снаряжение
произойти:  произошла
вычисленияопределенный:  вычисленияопределенных
задачин:  задачина
замечательный:  замечательные
системый:  системыи
удовлетворяетлить:  удовлетворяетли
приходиться:  приходится
сей:  сих
всякий:  всякий
доля:  доле
перейти:  перейти
применение:  применения
тригонометрический:  тригонометрических
каков:  каковы
преподаватель:  преподавателя
аналитически:  аналитически
заданав:  заданав
порядок:  порядка порядков
всё:  всё
тройной:  тройные
тривиальный:  тривиален
деление:  деления
контуруформула:  контуруформула
весь:  весь всей
делать:  делает
доказать:  доказать
простота:  простоты
либо:  либо
рекомендовать:  рекомендую
примерно:  примерно
независимый:  независимые
занять:  занять
типичный:  типичный
подход:  подход
изучение:  изучения
привести:  привести
львиный:  львиной
дело:  дело
корреляция:  корреляции
прежде:  прежде
потребитель:  потребителей
горнолыжный:  горнолыжный
вблизи:  вблизи
ознакомление:  ознакомления
приложить:  приложите
заочник:  заочников
чёткий:  чёткая
умещаться:  умещается
мозг:  мозг
повторять:  повторяем
закрепить:  закрепим
парить:  парящими
