помечать:  помечать
вектор:  векторы векторов
раздел:  разделе
посетитель:  посетителей
везде:  везде
частный:  частным частные частном частное
вращение:  вращения
дифференциальный:  дифференциальные дифференциального дифференциальном дифференциальное
первый:  первый первую первое первого
уравненияс:  уравненияс
нарисоваться:  нарисовались нарисовалась
именно:  именно
онлайн:  онлайн
смысл:  смысл
аббревиатура:  аббревиатур
лода:  лоду
копирование:  копирование
геометрия:  геометрии геометрия
дальнейший:  дальнейшим дальнейшее
справка:  справка
решить:  решить решим
рассмотреть:  рассмотрели
разрыв:  разрыва
работа:  работа
выражение:  выражения
сумма:  сумма сумму суммы
производный:  производные производная производной производную
прямой:  прямой прямую прямая
дуприближённо:  дуприближённо
узнать:  узнаете
новый:  новому
предел:  предел пределы пределов
слагаемое:  слагаемые слагаемым слагаемых
произвольныйтройный:  произвольныйтройной
модель:  модели модель
около:  ок
характеристический:  характеристическое характеристическим характеристического характеристический
асимптота:  асимптоты
дизайн:  дизайна
правильный:  правильные
вычисленияопределенный:  вычисленияопределенных
это:  это
событие:  события событие
отблагодарить:  отблагодарить
являться:  являются является
технический:  технический техническая
повторный:  повторные
порядок:  порядок порядка порядков
байес:  байеса
числовой:  числовые
простой:  проще простых простом простой
дисперсия:  дисперсию дисперсия дисперсии
решать:  решать решайте
производныенеявно:  производныенеявно
таблица:  таблицу таблицы
пример:  примере примеры пример примерам примеров
провернуть:  провернуть
подобный:  подобный подобного подобные подобных
скорее:  скорее
решение:  решений решениями решении решением решению решение решения
задачник:  задачника
поляй:  поляи
интеграл:  интегралы интеграла интеграл интеграле интегралов
опечатка:  опечатку
общий:  общему общим общая общем общего общее
случай:  случаях случая случаев случае
интересный:  интересному интереснее
результат:  результат результате
математический:  математические математическая математической математическое
теория:  теория теории
найти:  найденные найти найдено найдём
продолжать:  продолжаем
проверить:  проверьте проверим проверить
закономерный:  закономерным
формула:  формулы формула
константа:  константы констант константа константами
данный:  данном данный
технически:  технически
сам:  сами самому сама самом
полезный:  полезна
фнп:  фнп
однородный:  однородного однородное однородные однородным однородных
старший:  старшими
действительный:  действительные действительных
разок:  разок
увеличиваться:  увеличивается
прийтись:  придётся
канонический:  каноническому
структура:  структуру
простейшее:  простейшие
экспонент:  экспонент экспоненты
два:  две
гипотеза:  гипотезы гипотез гипотеза
дифференциал:  дифференциалах дифференциала
двумерный:  двумерная
больший:  наибольшее большее
который:  которых который которой которая
методомоперационный:  методомоперационного
выразить:  выразим
многие:  многие
задать:  заданной задайте заданным
конец:  конце
часть:  частям часть части частью
различный:  различные различных
тело:  тела
циркуляция:  циркуляция
куба:  куба
ехать:  ехать
бесповторный:  бесповторной
образно:  образно
двойной:  двойные двойной
компания:  компания
ошибка:  ошибку
плоскость:  плоскости плоскость
несобство:  несобств
л:  л
обойтись:  обойтись
нелинейный:  нелинейная
брать:  берём
правый:  правая правой правую
преобразованиеквадратичный:  преобразованиеквадратичной
определителяй:  определителяи
вогнутостья:  вогнутостьи
напрашиваться:  напрашивается напрашивающийся
многий:  многих
неизвестный:  неизвестными
вид:  виде виды вид виду
жирный:  жирный
закон:  законы
справа:  справа
навык:  навыками
функциональный:  функциональные
взять:  взять
касательный:  касательных
одинокий:  одинокая
статья:  статья статьи
лишний:  лишнее лишней лишняя
воздушный:  воздушное
корень:  корня корни корень корней корнями
читать:  читаете
балласт:  балласта
профессия:  профессию
значение:  значения
исходный:  исходное
разбираться:  разбираемся
спешить:  спеша
тот:  той тех ту
буква:  буква
условие:  условием условие условия условиям
устный:  устные
скомпоновать:  скомпонуем
геометрический:  геометрическая геометрическое
абсолютный:  абсолютная
схема:  схемой схема
типовыхзадача:  типовыхзадач
форма:  форма формы
удобно:  удобно
пункт:  пункт
умножение:  умножения
составить:  составлена составим
перепроверить:  перепроверим
вероятность:  вероятностей вероятность вероятности
табличный:  табличных
выполнимый:  выполним
система:  система систему системе системы
функция:  функций функции функция
воспользоваться:  воспользоваться
ранговойкорреляция:  ранговойкорреляции
группировка:  группировок группировка
он:  нему нём
непрерывный:  непрерывная непрерывных
условнаясходимость:  условнаясходимость
срабатывать:  срабатывает
сложенияй:  сложенияи
уравненийв:  уравненийв
киселёв:  киселёв
подбор:  подбора подборе подбор
решебник:  решебнике
регрессия:  регрессии регрессия
величина:  величин величина величины
александр:  александр
задача:  задачами задачи задача
уровень:  уровень уровня
рассказать:  расскажу
переписать:  переписать
грин:  грина
полный:  полное полных полной
неоднородный:  неоднородного неоднородные неоднородном неоднородных
исчисление:  исчисления
линейный:  линейные линейная линейном линейное линейных линейного линейными линейной
отыскать:  отыскать
занудно:  занудно
коэффициент:  коэффициентов коэффициент коэффициенты коэффициентами
приходить:  приходит приходим
входить:  входит
эйлер:  эйлера
равенство:  равенство
помин:  помине
согласие:  согласия
годиться:  годится
гораздо:  гораздо
локальный:  локальная
основательный:  поосновательнее
процесс:  процесса
ожидание:  ожидание ожиданий
совет:  совет
придерживаться:  придерживаться
математика:  математики математике
лаплас:  лапласа
такой:  таким такие такое таких такими
удовлетворять:  удовлетворяющее
перегиб:  перегиба
присутствовать:  присутствуют присутствует
предыдущий:  предыдущем
сходимость:  сходимости сходимость
дуоперационный:  дуоперационным
исследовать:  исследовать
дискретный:  дискретный
занятый:  занято
базис:  базисах базис базису
начальный:  начальным начальное начальные
поверхность:  поверхности
знакочередоваться:  знакочередующиеся
обычный:  обычному обычное
векторный:  векторного векторное
член:  член членов члены члена
страница:  странице страницу
наиболее:  наиболее
принцип:  принцип
ду:  ду
далее:  далее
зависимостьвектор:  зависимостьвекторов
противник:  противник
линейныйкоэффициент:  линейныйкоэффициент
снова:  снова
неопределённый:  неопределенный неопределенном
соответствовать:  соответствующее
использовать:  использовали используйте использовать используем
посвятить:  посвящена
подбирать:  подбираемом
сначала:  сначала
ситуация:  ситуациях ситуация
метод:  методы метод методом
дробь:  дробей
тема:  теме
собственный:  собственные
удивительно:  удивительно
пробежаться:  пробежаться
голова:  голову
начинаться:  начиналось начинается
домножение:  домножение домножением
признак:  признак признаки
произвольный:  произвольных
смотреть:  смотрим
данные:  данных
сложный:  сложной сложных сложные
запутаться:  запутаться
несобственныйинтеграл:  несобственныйинтеграл
доступно:  доступно
искать:  искать ищем
возможность:  возможностей возможность
окучивать:  окучиваем
работать:  работает работая
взгляд:  взгляда взглядом
фурье:  фурье
урок:  урока уроков уроке
поле:  поля
нижеследующий:  нижеследующие
разложение:  разложением разложение
поэтому:  поэтому
разделить:  разделить
свойство:  свойства
практика:  практике
разумеется:  разумеется
момент:  момент
задавать:  задаваемые
начало:  началом
типовой:  типовой
заслуженно:  заслуженно
понравиться:  понравилось понравится
синус:  синус
исследование:  исследование
икс:  икс иксами
кусок:  кусок
помогать:  помогает
ипример:  ипримеры
уравнение:  уравнению уравнениям уравнений уравнении уравнения уравнение уравнениями уравнением
точка:  точки точке
множество:  множества
никакой:  никаких
проблема:  проблем
переход:  переход
вариация:  вариации
коль:  коль
асимметрия:  асимметрия
шаг:  шаге
оценка:  оценки оценка
комплексный:  комплексными комплексные комплексных комплексного комплексный
основа:  основы
поверхностный:  поверхностные
переходить:  переходим
интервал:  интервалы
книга:  книга книге книги
разыскиваться:  разыскивается
главный:  главную
кош:  коши
желательно:  желательно
параграф:  параграфа параграф параграфе
координата:  координат координаты координатах
фигура:  фигуры
выше:  выше
длительность:  длительность
разделять:  разделять
пуассон:  пуассона
неоднородность:  неоднородности
сводиться:  сводящиеся
чайник:  чайников
собственно:  собственно
дать:  дать данной данная
версия:  версию версия
замена:  замены
преобразование:  преобразований преобразованиях преобразования
практический:  практических
вычисленияс:  вычисленияс
пара:  пары
целесообразно:  целесообразно
некоторый:  некоторым
однако:  однако
малый:  малые наименьших
связь:  связь
маленький:  меньше
таки:  таки
понижение:  понижением понижение
матричный:  матричные матричных матричный
проверка:  проверке проверка проверкой
вкладка:  вкладке
разминка:  разминка
выглядеть:  выглядят
дополнительный:  дополнительных дополнительные
заметить:  заметили заметить
ответ:  ответе ответ ответы
математическоеожидание:  математическоеожидание
например:  например
штатный:  штатную штатном штатный
решенияопределённый:  решенияопределенных
небольшой:  небольшая
вычислить:  вычислить
нормальный:  нормальное
школа:  школа
очень:  очень
интегральнаятеорема:  интегральнаятеоремы
приём:  приёмов приём приёме
хотя:  хотя
корнимногочлен:  корнимногочлена
логарифмический:  логарифмическая
матрица:  матрицу матрицы матрицами
испытанияй:  испытанияи
интегралыть:  интегралыв
ошибиться:  ошиблись
младший:  младшей
перегруппировка:  перегруппировка
экспонента:  экспонентой
проверять:  проверяем
правило:  правило правила
основной:  основные
лайта:  лайт
обнаруживаться:  обнаруживается
обмануть:  обмануть
товарищ:  товарищей
помощь:  помощью
бернулли:  бернулли
завоевать:  завоёванные
полярный:  полярные полярной полярных
коэффициентковариация:  коэффициентковариации
штука:  штук
ряд:  ряд ряды ряда рядов
сокращать:  сокращают
содержание:  содержания
быть:  будете буду будем
вариационный:  вариационный
один:  одном одно
оформляться:  оформляется
обратный:  обратная обратную
думать:  думаю
разношёрстный:  разношёрстная
вопрос:  вопросы вопрос
кратное:  кратные кратных
учиться:  учимся
применение:  применением
исключение:  исключением
системудифференциальный:  системудифференциальных
блог:  блог
доверительный:  доверительные
алгебра:  алгебру алгебры
затесаться:  затесалась
получить:  получена получено получи
финальный:  финальных
высокий:  высших высшей высшая
очевидный:  очевидная очевидна очевидном
помешать:  помешает
помимо:  помимо
вывод:  выводу
среднееквадратический:  среднееквадратическое
формирование:  формирования
чтение:  чтением
пространство:  пространстве
алгоритм:  алгоритм алгоритму
лопиталя:  лопиталя
называться:  называется
удовольствие:  удовольствие
воедино:  воедино
комбинационный:  комбинационная
удобный:  удобный удобна
аномальный:  аномальных
курс:  курс
последовательность:  последовательностей
должный:  должно должен
итоговый:  итоговый
квадратичный:  квадратичные
смешанноепроизведение:  смешанноепроизведение
нужный:  нужна нужной
объём:  объем
макаренко:  макаренко
чудо:  чудес
вместе:  вместе
очередной:  очередной
мимо:  мимо
сообщить:  сообщите
столбик:  столбиком
поляформула:  поляформула
наверное:  наверное
линия:  линиями линии линия
фехнера:  фехнера
трудность:  трудность
аналитический:  аналитическая аналитической
разбивка:  разбивку
прозвонить:  прозвонить
трудный:  трудной
аппарат:  аппарата
поскольку:  поскольку
школьный:  школьный школьная
эффективный:  эффективные эффективнее
центр:  центр
образ:  образом
гипергеометрическоераспределение:  гипергеометрическоераспределение
условный:  условные
непрерывнаяслучайный:  непрерывнаяслучайная
диффура:  диффурах диффуры диффур диффурами
эллипс:  эллипс
ибо:  ибо
раз:  раза
вычёркивать:  вычёркивать
поправка:  поправкой
прямо:  прямо
позволить:  позволит
графика:  графика графики
длина:  длина
помнить:  помнят помните
посмотреть:  посмотреть
сайт:  сайта сайты сайт
немного:  немного
мочь:  могут могу
квадрат:  квадрата квадратов
знакопостоянство:  знакопостоянства
производная:  производных производными
подробно:  подробно
равномерный:  равномерная равномерное
иначе:  иначе
неплохо:  неплохо
треугольный:  треугольная
сокращение:  сокращений
градиент:  градиент
количество:  количество
удачно:  удачно
сопрячь:  сопряжённые
самый:  самую
определение:  определения определению
разрешимый:  разрешимы
обозначаться:  обозначалось
пожалуйста:  пожалуйста
даламбер:  даламбера
торопиться:  торопиться
теорема:  теоремы
шанс:  шанс
комбинаторика:  комбинаторике
просьба:  просьбам
случайнаявеличина:  случайнаявеличина
приятный:  приятнейшими
повторнойя:  повторнойи
построение:  построение
стильно:  стильно
следовать:  следует
ровно:  ровно
бесконечно:  бесконечно
наш:  наша наш нашей наши
называть:  называть
линейнойкорреляционный:  линейнойкорреляционной
действие:  действия
время:  время времени
ранг:  ранг
трофей:  трофеи
кривая:  кривой
оставаться:  остаётся
особо:  особо
отметить:  отметить
тяжестиплоска:  тяжестиплоской
кадр:  кадром
соответствующий:  соответствующего соответствующие
почему:  почему
распределениякритерия:  распределениякритерий
функциюкомплексный:  функциюкомплексной
напоминать:  напоминаю
позабыться:  позабылся
область:  область области
обозначение:  обозначений обозначение
четвёртый:  четвёртого
обладать:  обладающих
продолжение:  продолжением
построить:  построить
коснуться:  коснусь
готовый:  готовых готово
три:  тремя трёх
просто:  просто
непостоянный:  непостоянными
несобственный:  несобственные
ненулевой:  ненулевая
следующий:  следующую следующий следующем
пояснение:  пояснениями
ещё:  ещё
провести:  проведём
мода:  мода
свойстваэлементарный:  свойстваэлементарных
считать:  считать
внимание:  внимание
вернуться:  вернёмся
проходить:  проходят проходит
краткий:  краткое
повышать:  повышаем
лейбниц:  лейбница
калькулятор:  калькулятор
появиться:  появилась
судьба:  судьба
научиться:  научиться
релаксация:  релаксации
постоянный:  постоянны постоянных
родственный:  родственные
неравенство:  неравенства
завершать:  завершаем завершающем
поток:  поток
касательная:  касательная
задачис:  задачис
оба:  оба
корректировка:  корректировке
соседний:  соседней
открыться:  откроется
свести:  сведём
разбить:  разбить
друг:  другом друзьям
всяко:  всяко
присмотреться:  присмотреться
медиана:  медиана
группа:  группу
бывать:  бывает
нахождение:  нахождения
функциия:  функциии
техника:  техники
степенной:  степенного степенные
функцийдвуха:  функцийдвух
направлениюй:  направлениюи
определённый:  определенный определенного
выборка:  выборке
излишний:  излишних
гостевой:  гостевая
многочлен:  многочлены многочлена многочлен
скоро:  скоро
действительно:  действительно
распределение:  распределения распределение
кроме:  кроме
экстремум:  экстремумы
горнера:  горнера
производныефункция:  производныефункции
средний:  средняя
привести:  приведём привести
понятно:  понятно
функцийнесколький:  функцийнескольких
недруг:  недругам
подготовка:  подготовки
прийти:  пришло
второй:  вторая второго вторую
главное:  главное
подарок:  подарок
применять:  применять применяем
внутригрупповаяй:  внутригрупповаяи
подобрать:  подобрать
перегруппировать:  перегруппируем
досада:  досаде
воссоединение:  воссоединение
тематический:  тематические
получать:  получаем
далеко:  далеко
число:  числами числа
математик:  математика
идз:  идз
переменный:  переменных переменной
упрощение:  упрощения
приподнять:  приподнять
функцийв:  функцийв
ценитель:  ценителей
ознакомиться:  ознакомиться
несовместный:  несовместные
независимыеслучайный:  независимыеслучайные
множественнойлинейный:  множественнойлинейной
наоборот:  наоборот
исходить:  исходя
выдвигать:  выдвигаем
прикладываться:  прикладывается
анализ:  анализ анализа
следовательно:  следовательно
оборот:  оборот обороты
остановиться:  остановлюсь
прямоугольник:  прямоугольников
непрерывность:  непрерывность
эксцессэмпирический:  эксцессэмпирического
ждать:  ждёте
забывать:  забываем
красиво:  красиво
функциис:  функциис
среди:  среди
пятый:  пятого
зеркало:  зеркало
криволинейный:  криволинейные
значит:  значит
пирсон:  пирсона
сойтись:  сошлось
библиотека:  библиотека
пересекаться:  пересекается
межгрупповой:  межгрупповая
ортогональный:  ортогональное
третий:  третьей третьего
дискретнойслучайный:  дискретнойслучайной
задачипо:  задачипо
название:  названием названия
обыкновенный:  обыкновенные
востребовать:  востребованную
наименьшеезначение:  наименьшеезначения
нсв:  нсв
пролетать:  пролетает
сила:  силы
начать:  начните начать
задачин:  задачина
приблизить:  приближенные
стать:  стал
сестра:  сестрой
горячий:  горячим
сложить:  сложить
системылинейный:  системылинейных
нужно:  нужно
смело:  смело
вроде:  вроде
вводный:  вводной
наработать:  наработанными
образец:  образец
быстро:  быстро
примечание:  примечание
упасть:  упал
выкладка:  выкладки
чистовой:  чистового
изучать:  изучать
разделаться:  разделаться
зависимый:  зависимые
прочее:  прочего
приравнять:  приравняем
зависимость:  зависимость
отклонение:  отклонение
избавиться:  избавиться
крамер:  крамера
отрезка:  отрезке
очистка:  очистки
другой:  другие
материал:  материалы материалов
произведение:  произведение
устраивать:  устраивает
справочный:  справочного
случайный:  случайных случайные
мы:  нами
замкнутый:  замкнутому
эпснуум:  эпснуум
сколько:  сколько
дуга:  дуги
частность:  частности
отрезкать:  отрезкав
прилагаться:  прилагаются
дивергенция:  дивергенция
левый:  левую
парабола:  парабола
похожий:  похожих
строго:  строго
форум:  форуме форум
повторимый:  повторим
показатель:  показатели
оформление:  оформления
рамка:  рамках
найдёно:  найдёно
площадьс:  площадьс
способ:  способу способ
признаться:  признайтесь
ранее:  ранее
большинство:  большинстве
функциидвуха:  функциидвух
запретить:  запрещено
статистический:  статистические статистическая
рекомендовать:  рекомендуйте рекомендованного рекомендую
емелин:  емелин
заданав:  заданав
краснов:  краснов
причина:  причине
честной:  честная
убыванией:  убываниеи
строка:  строки
детерминация:  детерминации
повышенный:  повышенной
возрастание:  возрастание
эмпирический:  эмпирические
также:  также
интегрирование:  интегрирование
подставить:  подставим
легко:  легко
степень:  степенями степень
рациональный:  рациональные
замечательный:  замечательные
найтись:  нашлось
системый:  системыи
удовлетворяетлить:  удовлетворяетли
этот:  этих эта
выполнить:  выполнить
выясниться:  выяснится
характерный:  характерно
громоздкий:  громоздкие
сегодня:  сегодня
дифференциальныеуравнение:  дифференциальныеуравнения
отыскание:  отыскание
любовь:  любовь
иррациональный:  иррациональных
надёжность:  надёжности
интервальный:  интервальный
допустить:  допущен
подстановка:  подстановке
стокс:  стокса
квадратичнуюформ:  квадратичнуюформу
тригонометрический:  тригонометрических
карта:  карта
диффуров:  диффуров
распространить:  распространённым
соответственно:  соответственно
итак:  итак
параметрический:  параметрической параметрическом
вычисление:  вычисления вычислении вычисление
гипербола:  гипербола
вообще:  вообще
подопечный:  подопечные
неформальный:  неформальный
равно:  равно
дробовик:  дробовик
они:  ними
оценкия:  оценкии
неявный:  неявной
несобственныхинтеграл:  несобственныхинтегралов
вероятностибиномиальный:  вероятностибиномиального
первоначальный:  первоначальная
параноидальный:  параноидально
хлопоты:  хлопот
вероятностия:  вероятностии
логика:  логики
связанный:  связанный
скалярный:  скалярное
спирмена:  спирмена
большой:  побольше
род:  рода
гаусс:  гаусса
оставить:  оставлю
совершенно:  совершенно
автопилот:  автопилоте
всё:  всё
понятный:  понятен
значимость:  значимости
честно:  честно
тройной:  тройные
лнд:  лнду
возникать:  возникает
особый:  особых
упомянуть:  упомянутой
деление:  деления
собрат:  собратьями
сформулировать:  сформулировал
контуруформула:  контуруформула
частное:  частного
понять:  поймёте
экстремальный:  экстремальные
график:  график
близко:  близко
полка:  полке
верный:  верное
лишь:  лишь
выбрать:  выбрана
весь:  вся
эстетика:  эстетики
дело:  деле дело
её:  её
парный:  парной
св:  св
рябушко:  рябушко
нормаль:  нормали
иметь:  имеет иметь
присест:  присест
приветствовать:  приветствую
определитель:  определитель
желать:  желающие
выпуклость:  выпуклость
поднять:  поднять
примерный:  примерный
энна:  энной
кандидат:  кандидата
несколько:  несколько
быстрый:  быстрому
совесть:  совести
элемент:  элементы
достаточно:  достаточно
сборник:  сборники
верно:  верно
выгодный:  выгоден
показательный:  показательное
купе:  купе
сложность:  сложность сложности
обращать:  обращаем
либо:  либо
огрех:  огрех
эн:  эн
независимый:  независимые
след:  следам
менее:  менее
автор:  автора автор
потерять:  потерять
дифуров:  дифуров
маловероятный:  маловероятно
почленно:  почленно
часто:  часто
неправильно:  неправильно
значенияй:  значенияи
приличный:  приличный
доказываться:  доказывается
получаться:  получается
упаковать:  упаковать
кстати:  кстати
многочисленный:  многочисленным
находить:  находим
надеяться:  надеюсь
классическоеопределение:  классическоеопределение
место:  место
инормаль:  инормаль
статистика:  статистика
студент:  студенты
корреляция:  корреляции
представлять:  представляют
прежде:  прежде
изящный:  изящное
подставлять:  подставляем
занятный:  занятнее
биномиальный:  биномиальное
далёкий:  дальше
неуместный:  неуместной
пирамида:  пирамида
лечиться:  лечится
заочник:  заочников
линиюв:  линиюв
соблюсти:  соблюсти
находиться:  находятся
расписать:  распишу
самостоятельный:  самостоятельного
рука:  руки
тушеваться:  тушеваться
отношение:  отношении
подлежать:  подлежит
говорить:  говоря
повторять:  повторяем
трата:  тратой
разогреться:  разогреться
задание:  задание
