положительность:  положительности
столбцы:  столбцов
парный:  парное парной парные парными
грубый:  грубую
верхний:  верхнего
семь:  семь
производный:  производные производная производной производную
длинный:  длинная
слагаемое:  слагаемое слагаемые слагаемому слагаемом слагаемого слагаемых
предел:  предел пределы пределов
симметрический:  симметрическая симметрической
числовой:  числовые
помахать:  помахать
точнее:  точнее
производныенеявно:  производныенеявно
значение:  значение значений значениях значения
форма:  формой форме формы форм форма форму
отрицательный:  отрицательные отрицательный отрицательной отрицателен отрицательным отрицательна отрицательны
зеркальный:  зеркальный
формула:  формулы формуле формула формул формулу
смотреть:  см смотрим
особенно:  особенно
прийтись:  придётся
канонический:  каноническому каноническом
сталкиваться:  сталкивались
положительный:  положительными положительные положительна положительной положительны
свой:  своём своих свои
дифференциал:  дифференциалах дифференциала
больший:  наибольшее большим
многие:  многие
составить:  составлен составим составленный
любой:  любому любой любого любых любом
число:  число числами числу чисел числа
вогнутостья:  вогнутостьи
позволять:  позволяет
шварценеггер:  шварценеггеру шварценеггера
случай:  случай случаи случая случае случаях
убедиться:  убедиться
профессия:  профессию
критерий:  критерием критерия критерию критерий
удобно:  удобно
умножение:  умножения умножение
алгебраический:  алгебраическом
система:  система системе системах систему системы
квадратичный:  квадратичная квадратичной квадратичных квадратичный квадратичные квадратичную
группировка:  группировок группировка
условнаясходимость:  условнаясходимость
слово:  словами
элементарный:  элементарном
александр:  александр
остаться:  осталось оставшиеся
логически:  логически
пограничный:  пограничный
который:  которые котором который которого которых которой
редко:  редко
линейный:  линейные линейная линейную линейных линейной
коэффициент:  коэффициентов коэффициентами коэффициент коэффициенты коэффициента
неположительносить:  неположительнось
выполнять:  выполняя
согласие:  согласия
доказать:  доказано
решать:  решаем решать
дуоперационный:  дуоперационным
базис:  базисах базису базис
предположить:  предположить
зависимостьвектор:  зависимостьвекторов
оно:  оно
сначала:  сначала
метод:  методы методом метод
страница:  страницу
столбец:  столбцу столбце столбец столбца
произведение:  произведениями произведения произведением произведение произведений
математический:  математическая математические математической
данные:  данных
искать:  искать
интеграл:  интеграл интегралов интегралы интеграла интеграле
урок:  урока уроке
разложение:  разложением разложение
прозрачный:  прозрачно
уравнение:  уравнению уравнения уравнение уравнений
переход:  переход
симметрично:  симметрично
симметрия:  симметрии
существо:  существу
очередь:  очередь
практический:  практических
малый:  малые наименьших
связь:  связь
перещёлкать:  перещёлкаем
отличный:  отличен
нормальный:  нормальное
делаться:  делается
интегральнаятеорема:  интегральнаятеоремы
корнимногочлен:  корнимногочлена
логарифмический:  логарифмическая
место:  места место местах
основной:  основные
бернулли:  бернулли
полярный:  полярные полярных полярной
рассмотреть:  рассмотрим рассмотренный
ряд:  ряды ряда ряд рядов
уровень:  уровня
должный:  должны должна
доверительный:  доверительные
среднееквадратический:  среднееквадратическое
работать:  работать работает работают
тривиальный:  тривиальный
комбинационный:  комбинационная
минор:  миноры минора миноров минор
оба:  обе оба
понимать:  понимая
смешанноепроизведение:  смешанноепроизведение
функция:  функции функция функций
дисперсия:  дисперсия дисперсии дисперсию
орден:  орден
школьный:  школьный
мы:  нам нами
образ:  образом
непрерывнаяслучайный:  непрерывнаяслучайная
четыре:  четыре
прямо:  прямо
длина:  длина
материал:  материал материалов материалы
мочь:  могут
знакопостоянство:  знакопостоянства
разрастаться:  разрастаются
градиент:  градиент
конец:  конец конце
линия:  линия линии линиями
ограничиться:  ограничились
актёр:  актёр
комбинаторика:  комбинаторике
случайнаявеличина:  случайнаявеличина
матричный:  матричном матричная матричные матричных матричное матричный
знак:  знаков знака знак
бесконечно:  бесконечно
украшать:  украшает
равный:  равны равными равен равный равна
задача:  задачу задачей задачи задачах
несовместный:  несовместна несовместные
статья:  статьи статью
обстоять:  обстоят
вспоминать:  вспоминать
чётный:  чётное
обратный:  обратную обратная
дополнительный:  дополнительные
рассматривать:  рассматривать рассматривали рассматриваемая
диагональ:  диагонали диагональ
третий:  третий третье
готовый:  готовых
анализировать:  анализируем
просто:  просто
видеть:  видим
ещё:  ещё
вернуться:  вернёмся
преподаватель:  преподавателю
обращать:  обращаю
вышеприведённый:  вышеприведённой вышеприведённых
баян:  баян
непрерывный:  непрерывных непрерывная
производныефункция:  производныефункции
средний:  средняя
называть:  называемая называют
область:  области область
отрицательность:  отрицательности отрицательность
математик:  математика
переменный:  переменных переменной переменные переменную переменная
пример:  пример примера примерах примеры
посмотреть:  посмотрим
независимыеслучайный:  независимыеслучайные
выполнение:  выполнения выполнение
новый:  новом новому
следовательно:  следовательно
модель:  модель модели
минус:  минус
непрерывность:  непрерывность
содержать:  содержит
усугубляться:  усугубляться
функциис:  функциис
полный:  полной полных полный полное
зеркало:  зеркало
начинать:  начинает
значит:  значит
исходный:  исходная
пирсон:  пирсона
член:  члены член членов
вопрос:  вопрос вопросы
понимание:  понимании понимание
межгрупповой:  межгрупповая
ортогональный:  ортогональное
высокий:  высокой высших высшей высшая
нсв:  нсв
простыня:  простыня простынёй
вырожденный:  вырожденной
распространить:  распространенная распространённые
вроде:  вроде
перемножить:  перемножить
упасть:  упал
один:  одно одна
отрезка:  отрезке
величина:  величина величин величины
одновременно:  одновременно
внимательно:  внимательно
запись:  запись
получить:  полученные получен полученный получили получи
строчка:  строчку
наталкивать:  наталкивает
знакоопределённость:  знакоопределённость знакоопределенность
она:  неё
детерминация:  детерминации
действительный:  действительному действительной действительны действительные
обязательно:  обязательно
замысловатый:  замысловатая
начать:  начать начну
запомнить:  запомнить
важный:  важные
выполнить:  выполнить выполнен
матрица:  матрицей матрицу матриц матрицы матрица матрицами матрице
подробный:  подробное
дифференциальныеуравнение:  дифференциальныеуравнения
прямой:  прямая прямой прямую
взять:  возьмём
постоянный:  постоянных
стокс:  стокса
схема:  схема
соответствие:  соответствие соответствии
многочлен:  многочлена многочлен
равняться:  равняться
дробовик:  дробовик
лёгкий:  лёгкую
знакопеременный:  знакопеременна знакопеременной
математика:  математике математики
векторный:  векторное векторного
сам:  самом сами
простенький:  простенькой
вероятностия:  вероятностии
аналогичный:  аналогичную аналогичных
поделить:  поделить
скалярный:  скалярное скалярная
следующий:  следующее следующая следующий следующем
совершенно:  совершенно
противоположный:  противоположного противоположных
значимость:  значимости
страшный:  страшного страшный страшных
анализ:  анализа анализ
её:  её
частный:  частное частные
координата:  координатами координаты координат координатах
найти:  найдём найти
сборник:  сборники
параметрический:  параметрическом параметрической
неоднородный:  неоднородный неоднородные
часто:  часто
разминочный:  разминочные
надобность:  надобность
определённость:  определённость
получаться:  получается
старое:  старое
комбинация:  комбинации
какой:  какие каких
угол:  угла
решение:  решение решением решения решений
форум:  форум форуме
записывать:  записывать записываем
книга:  книги книга
степень:  степенью степени
стоять:  стоят
менять:  менять
устно:  устно
проанализировать:  проанализируем
задание:  задание задания
вектор:  векторы вектору векторов вектора векторе
вращение:  вращения
вписаться:  вписалось
именно:  именно
копирование:  копирование
разрыв:  разрыва
выражение:  выражения
рабочий:  рабочий
отблагодарить:  отблагодарить
байес:  байеса
икс:  иксов
выяснить:  выясним
точность:  точности
результат:  результат результате результаты
теория:  теория теории
связать:  связано
отсутствовать:  отсутствует
определять:  определяем определяет
нулевой:  нулевым нулевые нулевого нулевой
умножить:  умножить умножим
главный:  главный главных главной главные главную
сильвестр:  сильвестру сильвестра
подстрочный:  подстрочные
двумерный:  двумерная
язык:  языком
задать:  заданной задайте
тело:  тела
циркуляция:  циркуляция
незамедлительный:  незамедлительной
рамка:  рамки рамках
плоскость:  плоскости плоскость
опциональный:  опционально
общий:  общим общая общей общую
получиться:  получится получиться получилась
поздний:  позже
определителяй:  определителяи
согласно:  согласно
дважды:  дважды
закон:  законы
справа:  справа
качество:  качестве
пункт:  пункт пункта пункту
вероятность:  вероятностей вероятность вероятности вероятностью
заключение:  заключение
уравненийв:  уравненийв
транспонировать:  транспонированная
нечётный:  нечётное
занятный:  занятную
грин:  грина
устройство:  устройство
входить:  входит входят
эйлер:  эйлера
иной:  иное иными
восстановить:  восстановить
остальной:  остальные остальных
дискретный:  дискретный
знакочередоваться:  знакочередующиеся знакочередуются
квадрат:  квадратах квадрат квадратом квадратами квадратов
произвольный:  произвольных произвольное произвольные
сложный:  сложной сложные сложных
фурье:  фурье
поле:  поля
гипотеза:  гипотез гипотеза гипотезы
свойство:  свойства
исследование:  исследование
неравенство:  неравенством неравенству неравенств неравенство неравенства
сыграть:  сыграл
точка:  точки точке
первый:  первую первому первого первый
занимать:  занимает
вариация:  вариации
основа:  основы
интервал:  интервалы
кош:  коши
параграф:  параграфа
соответствующий:  соответствующих соответствующие
чайник:  чайников
сигнализировать:  сигнализируют
вычисленияс:  вычисленияс
правый:  правую правые
ст:  ст
два:  двум двух
последний:  последний последнее
заметить:  заметили заметьте
однородный:  однородные однородный однородным однородных
вычислить:  вычислить
очень:  очень
испытанияй:  испытанияи
интегралыть:  интегралыв
перегруппировка:  перегруппировка
каждый:  каждое каждому каждой каждую
помощь:  помощью помощь
простой:  простых простой
вариационный:  вариационный
удвоить:  удвоить
отпасть:  отпал
блог:  блог
последовательность:  последовательности последовательностей
пространство:  пространстве
удобный:  удобный
путь:  путь
курс:  курс
иррациональный:  иррациональными иррациональных
сообщить:  сообщите
аналитический:  аналитическая аналитической
понижение:  понижение понижением
двойка:  двойки
определить:  определить определена
знать:  знаю
неотрицательность:  неотрицательность неотрицательности
ненулевой:  ненулевой ненулевая ненулевом ненулевых ненулевые ненулевого
сочетание:  сочетаний
центр:  центр
квадратный:  квадратное
узнать:  узнаем
сверяться:  сверяемся
затем:  затем
построение:  построение
дискриминант:  дискриминантом дискриминант
проверка:  проверку проверка
хохлов:  хохлову
линейнойкорреляционный:  линейнойкорреляционной
действие:  действия
время:  время
гладко:  гладко
пора:  пор
сила:  силу силы
прилагательное:  прилагательное
почему:  почему
распределениякритерия:  распределениякритерий
отлично:  отлично
дальнейший:  дальнейшее
обозначение:  обозначений
аргумент:  аргумента
несобственный:  несобственные
термин:  термином
провести:  проведём
откуда:  откуда
касательная:  касательная
ответ:  ответ ответы
задачис:  задачис
разбить:  разбить
разобраться:  разобраться разберёмся
правило:  правила правило
функциия:  функциии
удвоенный:  удвоенными
степенной:  степенного степенные
функцийдвуха:  функцийдвух
выборка:  выборке
угловой:  угловых угловой угловые
функцийнесколький:  функцийнескольких
понять:  понять
положительно:  положительно
множественнойлинейный:  множественнойлинейной
зависимость:  зависимости зависимость
тема:  темы
распределение:  распределение распределения
забывать:  забываем забывая
неположительный:  неположительны неположителен
непривычный:  непривычном
номер:  номерами
представимый:  представима
задачипо:  задачипо
востребовать:  востребованную
приблизить:  приближенные
поставить:  поставленной
изучить:  изучить изучите
вариант:  вариант
смущать:  смущает
зависимый:  зависимые
отклонение:  отклонение
что:  чему чём
таблица:  таблицы
завершить:  завершена
случайный:  случайных случайные
одинаковый:  одинаковыми
дуга:  дуги
стандартный:  стандартная
отрезкать:  отрезкав
дивергенция:  дивергенция
помочь:  помог
сайт:  сайт сайты сайта
наш:  наш
графика:  графики графика
оформление:  оформления
корень:  корнями
идти:  идёт
расположить:  расположены
возрастание:  возрастание
эмпирический:  эмпирические
найтись:  нашлось
этот:  этих эта
потребоваться:  потребуется
неотрицательный:  неотрицательны неотрицательно неотрицателен неотрицательной неотрицательна
держать:  держат
определение:  определению определения
квадратичнуюформ:  квадратичнуюформу
карта:  карта
выявить:  выявить
гипербола:  гипербола
совместный:  совместную
равно:  равно
они:  ними ими
логика:  логики
спирмена:  спирмена
вид:  виду виды вид виде
лишь:  лишь
заставить:  заставили
св:  св
второй:  второго второму второй
иметь:  имеет имеем
решить:  решено решить
нипочём:  нипочём
достаточно:  достаточно
показательный:  показательное
преобразование:  преобразования преобразований
соответствовать:  соответствует
противоречить:  противоречит
диффура:  диффурами
относиться:  относится
подразумевать:  подразумевает
вычисление:  вычисление
быть:  будем
статистика:  статистика
скороговорка:  скороговоркой
биномиальный:  биномиальное
нижний:  нижнюю
линиюв:  линиюв
самостоятельный:  самостоятельного
отношение:  отношении
второе:  второе
ждать:  жду
сергей:  сергею
рассчитать:  рассчитан
отправляться:  отправляются
дуприближённо:  дуприближённо
добрый:  доброе
определённый:  определённой определённое определенный определенного
неполный:  неполный
асимптота:  асимптоты
предполагать:  предполагаем
событие:  события
повторный:  повторные
яркий:  ярче
б:  б
небольшой:  небольшом
данный:  данную данном данный
константа:  константы констант
фнп:  фнп
наука:  науки
простейшее:  простейшие
часть:  частям части
двойной:  двойные двойной
несобство:  несобств
внешний:  внешнее
нелинейный:  нелинейная
три:  трём трёх
преобразованиеквадратичный:  преобразованиеквадратичной
краевой:  краевые
функциональный:  функциональные функциональное
пересечение:  пересечении
геометрический:  геометрическая геометрическое геометрическом
абсолютный:  абсолютная
интересный:  интересные
встречаться:  встречаются встречается
сложенияй:  сложенияи
регрессия:  регрессии регрессия
раскрываться:  раскрывается
исчисление:  исчисления
раскрой:  раскрою
локальный:  локальная
ожидание:  ожидание
лаплас:  лапласа
такой:  таким такое такого такая
перегиб:  перегиба
сходимость:  сходимости сходимость
благодарность:  благодарность
оказаться:  оказаться окажется оказался
ду:  ду
далее:  далее
делать:  делать
мысль:  мысль
неопределённый:  неопределенный неопределенном
конкретный:  конкретные
дробь:  дробей
собственный:  собственные собственных
признак:  признак признаки
соображение:  соображений
элемент:  элемент элементов элементы
пара:  паре пару
поэтому:  поэтому
соскучиться:  соскучились
полосочка:  полосочку
никакой:  никаких никакой
асимметрия:  асимметрия
чередование:  чередование
сводиться:  сводящиеся
собственно:  собственно
замена:  замены
строка:  строке строки строка строк
записать:  запишем записать
маленький:  меньше
например:  например
решенияопределённый:  решенияопределенных
озарение:  озарения
хотя:  хотя
коэффициентковариация:  коэффициентковариации
сбросить:  сбросим
бицепс:  бицепсами
лопиталя:  лопиталя
называться:  называется
ставить:  ставим
поляформула:  поляформула
наверное:  наверное
фехнера:  фехнера
споловиненный:  споловиненные
эффективный:  эффективные
условный:  условные
эллипс:  эллипс
даламбер:  даламбера
теорема:  теоремы теорема
единица:  единицы
повторнойя:  повторнойи
ваш:  ваше
комплексный:  комплексные комплексного комплексный комплексными
ранг:  ранг ранге рангу рангом
кривая:  кривой
тяжестиплоска:  тяжестиплоской
относительно:  относительно
ставиться:  ставится ставятся
касаться:  касается
построить:  построить
хотеть:  хочу
смешанный:  смешанные смешанных
внимание:  внимание
лейбниц:  лейбница
ради:  ради
поток:  поток
предыдущий:  предыдущего
медиана:  медиана
замечание:  замечания
бывать:  бывает
всеоружие:  всеоружии
направлениюй:  направлениюи
гостевой:  гостевая
скоро:  скоро
стать:  станет
кроме:  кроме
привести:  приведём привести
понятно:  понятно
вывод:  вывод
внутригрупповаяй:  внутригрупповаяи
алгебра:  алгебры
сумма:  сумму сумма
некогда:  некогда
существовать:  существует существуют
прямоугольник:  прямоугольников
эксцессэмпирический:  эксцессэмпирического
говорить:  говорит говорят говоря
оценка:  оценка оценки
криволинейный:  криволинейные
различный:  различных
библиотека:  библиотека
наименьшеезначение:  наименьшеезначения
задачка:  задачка задачку
вычислимый:  вычислим
системылинейный:  системылинейных
нужно:  нужно
упреждать:  упреждаю
другой:  другие
назначение:  назначение
замкнутый:  замкнутому
очевидный:  очевидно
знакопеременность:  знакопеременности
проверить:  проверим проверить
показатель:  показатели
тяжёлый:  тяжёлую
площадьс:  площадьс
присутствовать:  присутствует
убыванией:  убываниеи
видимость:  видимость
повышенный:  повышенной
статистический:  статистическая статистические
также:  также
интегрирование:  интегрирование
дать:  данная данной
легко:  легко
рациональный:  рациональные
нуль:  нулю нуля нулей
видный:  видна
ситуация:  ситуация
некоторый:  некоторых
интервальный:  интервальный
определитель:  определителю определитель определителе определители
выделять:  выделяя
усложнение:  усложнении
вообще:  вообще
сменить:  сменив
оценкия:  оценкии
неявный:  неявной
несобственныхинтеграл:  несобственныхинтегралов
вероятностибиномиальный:  вероятностибиномиального
род:  рода
неизвестный:  неизвестных
гаусс:  гаусса
определимый:  определим
особый:  особых
выразить:  выразить
точно:  точно
одинокий:  одиноких
экстремальный:  экстремальные
нормаль:  нормали
приветствовать:  приветствую
желать:  желающие
разминка:  разминки
выпуклость:  выпуклость
интересно:  интересно
сложность:  сложности
встретиться:  встретился
значенияй:  значенияи
неположительно:  неположительно
нужный:  нужной
кстати:  кстати
классическоеопределение:  классическоеопределение
инормаль:  инормаль
разворачивать:  разворачивать
амплуа:  амплуа
далёкий:  дальше
автомат:  автоматом
пирамида:  пирамида
автор:  автор автора
разница:  разница
счёт:  счёт
дифференциальный:  дифференциальные
уравненияс:  уравненияс
онлайн:  онлайн
разобрать:  разберём разберу
геометрия:  геометрии геометрия
работа:  работа
произвольныйтройный:  произвольныйтройной
ниже:  ниже
дизайн:  дизайна
дух:  духе
это:  это
сталлоно:  сталлоне
поляй:  поляи
находиться:  находится
опечатка:  опечатку
продолжать:  продолжаем
речь:  речь
продолжаться:  продолжается
трудный:  труднее
вызывать:  вызывает
методомоперационный:  методомоперационного
бесповторный:  бесповторной
лишний:  лишних
ошибка:  ошибку
л:  л
прибавить:  прибавлю
касательный:  касательных
типовыхзадача:  типовыхзадач
ранговойкорреляция:  ранговойкорреляции
прийти:  пришло
приноровиться:  приноровились
творческий:  творческое
эквивалентный:  эквивалентно
носить:  ношу
исследовать:  исследовать
испугаться:  испугались
поверхность:  поверхности
линейныйкоэффициент:  линейныйкоэффициент
несобственныйинтеграл:  несобственныйинтеграл
доступно:  доступно
объяснение:  объяснения
мпг:  мпгу
причём:  причём
учиться:  учимся
задавать:  задаваемые
понравиться:  понравилось
ипример:  ипримеры
множество:  множества
поверхностный:  поверхностные
объяснить:  объяснить
фигура:  фигуры
изучать:  изучаем
пуассон:  пуассона
подобный:  подобные
терять:  теряют
большой:  большое
однако:  однако
несмотря:  несмотря
устный:  устное
отрицательно:  отрицательно
математическоеожидание:  математическоеожидание
неприятный:  неприятное
школа:  школа
напомнить:  напомню
проверять:  проверяем
оформить:  оформить
шесть:  шесть
кратное:  кратные
количество:  количеством
системудифференциальный:  системудифференциальных
симметричный:  симметричных симметричные
рассчитывать:  рассчитываем
усугублять:  усугублять
холст:  холст
объём:  объем
требоваться:  требовалось
поскольку:  поскольку
гипергеометрическоераспределение:  гипергеометрическоераспределение
понятие:  понятие
равномерный:  равномерная равномерное
треугольный:  треугольная
картина:  картина
использовать:  используйте
пожалуйста:  пожалуйста
ориентироваться:  ориентироваться
принимать:  принимать
записываться:  записывается
следовать:  следует
левый:  левого
полагать:  полагать
сразу:  сразу
функциюкомплексный:  функциюкомплексной
единственный:  единственный
мода:  мода
свойстваэлементарный:  свойстваэлементарных
краткий:  краткое
калькулятор:  калькулятор
научиться:  научиться
происходить:  происходит
удовлетворять:  удовлетворяет удовлетворяют
индекс:  индексы
теряться:  теряется
действительно:  действительно
экстремум:  экстремумы
горнера:  горнера
отмечаться:  отмечалось
комбинаторный:  комбинаторную
альфа:  альфа
получать:  получаем
функцийв:  функцийв
довольно:  довольно
арнольд:  арнольду
приплюсовать:  приплюсованной
среди:  среди
весёлый:  веселее
дискретнойслучайный:  дискретнойслучайной
самый:  самое
множитель:  множителем
крамер:  крамера
законный:  законные
начало:  начале
парабола:  парабола
сказать:  сказал
строго:  строго
запретить:  запрещено
к:  ко
функциидвуха:  функциидвух
емелин:  емелин
широко:  широко
вычисленияопределенный:  вычисленияопределенных
задачин:  задачина
замечательный:  замечательные
системый:  системыи
удовлетворяетлить:  удовлетворяетли
сей:  сих
тригонометрический:  тригонометрических
заданав:  заданав
порядок:  порядка порядков
всё:  всё
тройной:  тройные
деление:  деления
автоматически:  автоматически
контуруформула:  контуруформула
неположительность:  неположительности
график:  график
дело:  дела деле дело
занятие:  занятие
вне:  вне
долгий:  долгое
либо:  либо
эн:  эн
независимый:  независимые
весь:  всей
пойти:  пошло
корреляция:  корреляции
условие:  условию
заочник:  заочников
повторять:  повторяем
