уравнение:  уравнениях уравнению уравнений уравнения уравнение
вектор:  векторы векторов
эффективный:  эффективное эффективные
чтение:  чтение
столько:  столько
получить:  получить полученное получим получена получено получи
ссылка:  ссылки
цель:  целях
раскрывать:  раскрывать раскрываем
забыть:  забыл
встретиться:  встретиться встретился
вращение:  вращения
дифференциальный:  дифференциальные дифференциальных
полениться:  поленюсь
уравненияс:  уравненияс
долгожданный:  долгожданные
онлайн:  онлайн
геометрия:  геометрии геометрия
копирование:  копирование
решить:  решить решил
цепь:  цепь
разрыв:  разрыва
один:  одного одним
выражение:  выражения выражение
работа:  работа
последовательность:  последовательностях последовательностей последовательность
производный:  производные производная производной производную
прямой:  прямой прямую прямая
дуприближённо:  дуприближённо
сумма:  сумма суммой сумму
новый:  новому
ум:  ума
предел:  предел пределами предела пределы пределе пределов
слагаемое:  слагаемые
модель:  модели модель
положительный:  положительный положительных
буковка:  буковкой
произвольныйтройный:  произвольныйтройной
посетить:  посетите
ниже:  ниже
асимптота:  асимптоты
дизайн:  дизайна
признак:  признаками признак признаки признаков признаку признака признаком
факториал:  факториал факториалами факториала факториалы
это:  это этим
член:  члене член члена
этаж:  этажа этаже
значок:  значок
событие:  события
отблагодарить:  отблагодарить
основание:  основании основание
повторный:  повторные
разочаровать:  разочарую
понимание:  понимание понимания
байес:  байеса
указывать:  указываем указывая
числовой:  числовые числовая числовых числовой
дисперсия:  дисперсию дисперсия дисперсии
решать:  решать решаем
производныенеявно:  производныенеявно
познакомить:  познакомить
пример:  примере примером примеры пример примера примеров примерах
провернуть:  провернуть
решение:  решений решением решение решения
поляй:  поляи
интеграл:  интегралы интеграла интеграл интегралом интеграле интегралов
находиться:  находится находиться находилось находятся
опечатка:  опечатку
случай:  случаях случай случая случаи случае
б:  б
математический:  математические математическая математической математическому
теория:  теория теории
находить:  находить
навык:  навык
способ:  способом способа способ
формула:  формулы формула формулу
смотреть:  см
данный:  данном данный
фнп:  фнп
четвёртый:  четвертую
заниматься:  занимался
канонический:  каноническому
простейшее:  простейшие
знаменатель:  знаменателя знаменателе знаменатели знаменатель
два:  две
гипотеза:  гипотезы гипотез гипотеза
дифференциал:  дифференциалах дифференциала
самый:  самых самое самая самый
больший:  наибольшее
содержаться:  содержатся
двумерный:  двумерная
задать:  заданной задайте
конец:  конце концу
методомоперационный:  методомоперационного
часть:  частям
тело:  тела
циркуляция:  циркуляция
бесповторный:  бесповторной
перец:  перец
табличный:  табличную
степень:  степенях степени степеней степенями степень степенью
наверняка:  наверняка
правильно:  правильно
двойной:  двойные двойной
ошибка:  ошибку
плоскость:  плоскости плоскость
несобство:  несобств
отношение:  отношение отношения отношении
избавляться:  избавляемся
специальность:  специальности
л:  л
общий:  общим общая общий общем общего
нелинейный:  нелинейная
применить:  применить
получиться:  получится получатся получилась
непрерывный:  непрерывна непрерывная непрерывных
пара:  парой пара
специализироваться:  специализировался
переписывать:  переписываем
соответствовать:  соответствующим
определителяй:  определителяи
выносить:  выносим
число:  число числами числа
вогнутостья:  вогнутостьи
преобразованиеквадратичный:  преобразованиеквадратичной
шеренга:  шеренги
вещь:  вещь
важно:  важно
вид:  виде виды вида виду
внизу:  внизу
закон:  законы
дробь:  дроби дробей дробь
счётчик:  счётчика
функциональный:  функциональные
комментарий:  комментарии
башня:  башни
касательный:  касательных
качество:  качестве
упрощать:  упрощаем
актуальный:  актуальны
корень:  корня корнем корень корней
последний:  последнем
профессия:  профессию
длинный:  длинным длинный
они:  ими ними
сравнить:  сравнить
константа:  константу константа
большой:  большой
условие:  условием условия условию
геометрический:  геометрическая геометрическое
абсолютный:  абсолютная
типовыхзадача:  типовыхзадач
разный:  разными разные
графика:  графика графики
определённый:  определенном определенный определенного
удобно:  удобно
умножение:  умножения
вероятность:  вероятностей вероятность вероятности
одинаковый:  одинаковы
встречаться:  встречаются встречается
ранговойкорреляция:  ранговойкорреляции
система:  система систему системе системы
частный:  частные частное
функция:  функций функцию функции функция
рука:  руки
группировка:  группировок группировка
условнаясходимость:  условнаясходимость
сложенияй:  сложенияи
уравненийв:  уравненийв
куб:  куб
множитель:  множитель множители множителей
палец:  пальцах
регрессия:  регрессии регрессия
величина:  величин величина величины
александр:  александр
эйфелевый:  эйфелевой
необходимый:  необходимый
зря:  зря
остаться:  остался
который:  которые который которая
редко:  редко
грин:  грина
суть:  сути
линейный:  линейные линейная линейных линейной
полный:  полное полных полной
исчисление:  исчисления
входить:  входит
эйлер:  эйлера
путём:  путем
дополнительный:  дополнительный
расходиться:  расходящимся расходится расходиться расходились
каноничный:  каноничный
подходить:  подходит
усвоить:  усвоил
предыдущий:  предыдущим предыдущем предыдущему
согласие:  согласия
локальный:  локальная
каждый:  каждого
проблема:  проблемы
известный:  известной
ожидание:  ожидание
придерживаться:  придерживаться
математика:  математики математике
лаплас:  лапласа
перегиб:  перегиба
такой:  таким такое такого такая такую
сходимость:  сходимости сходимость
дуоперационный:  дуоперационным
сформулировать:  сформулировать сформулирую
справедливость:  справедливости
исследовать:  исследовать исследуем исследуемый
дискретный:  дискретный
базис:  базисах базис базису
телега:  телега
поверхность:  поверхности
знакочередоваться:  знакочередующиеся
задача:  задачи задача
векторный:  векторного векторное
рассказать:  рассказать
ду:  ду
малопонятный:  малопонятным
далее:  далее
зависимостьвектор:  зависимостьвекторов
линейныйкоэффициент:  линейныйкоэффициент
делать:  делать делаем
снова:  снова
распространить:  распространенных
оно:  оно
математик:  математик математика
день:  день
неопределённость:  неопределенности неопределенность
бесконечность:  бесконечности
коэффициент:  коэффициент коэффициенты
неопределённый:  неопределенный неопределенном
сначала:  сначала
брать:  берем
метод:  методы метод методом
составлять:  составляем
страница:  страницу
собственный:  собственные
числитель:  числителе числитель числители числителя
голова:  голову
старший:  старших старшей старшая старшую старшие
четвёрка:  четверку
несобственныйинтеграл:  несобственныйинтеграл
произвольный:  произвольных
баллистика:  баллистикой
данные:  данных
сложный:  сложной сложная сложных сложнее сложные
рядом:  рядом
доступно:  доступно
опыт:  опыте
повториться:  повторюсь
страничка:  страничку
фурье:  фурье
урок:  урока урок уроку уроке
дать:  дан даст данная
поле:  поля
разложение:  разложением разложение разложения
поэтому:  поэтому
разделить:  разделить
свойство:  свойства свойство
вместо:  вместо
разумеется:  разумеется
задавать:  задаваемые
сводиться:  сводится сводящиеся
начало:  началом начало начала
деление:  делении делением деление деления
пункт:  пункте пунктов
горнера:  горнера
менять:  меняет
запустить:  запущен
исследование:  исследование исследовании исследований
ипример:  ипримеры
точка:  точки точке
множество:  множества
найти:  найти
оценка:  оценки оценка
переход:  переход
поздравлять:  поздравляю
вариация:  вариации
асимметрия:  асимметрия
комплексный:  комплексными комплексные комплексного комплексный
наполеоновский:  наполеоновских
основа:  основы
студент:  студент
слишком:  слишком
поверхностный:  поверхностные
нетерпение:  нетерпением
технический:  технической
изменить:  изменило
интервал:  интервалы
книга:  книга книги
сдать:  сдать
главный:  главную
кош:  коши
основной:  основной основные
причём:  причем
параграф:  параграфа параграфе
статья:  статьей статью статьи
координата:  координат координаты координатах
фигура:  фигуры
первый:  первое первой первом первого
пуассон:  пуассона
типовой:  типовые типовых
окончательный:  окончательного
подобный:  подобные подобном
рассматривать:  рассматривали
величество:  величества
чайник:  чайников
собственно:  собственно
успех:  успехов
прилепить:  прилепить
замена:  замены
практический:  практических
алгоритм:  алгоритма алгоритму
вычисленияс:  вычисленияс
предельный:  предельного предельный
преобразование:  преобразований преобразования
малый:  малые наименьших
связь:  связь
таки:  таки
понижение:  понижением понижение
матричный:  матричные матричных матричный
честь:  честь
результат:  результате
замечательный:  замечательные замечательный
заметить:  заметили
применение:  применение применения
математическоеожидание:  математическоеожидание
например:  например
однородный:  однородные однородным
сомнение:  сомнения
решенияопределённый:  решенияопределенных
экзамен:  экзамен
вычислить:  вычислить
плохо:  плохо
нормальный:  нормальное
школа:  школа
интегральнаятеорема:  интегральнаятеоремы
корнимногочлен:  корнимногочлена
логарифмический:  логарифмическая
матрица:  матрицу матрицы матрицами
курс:  курса курс
испытанияй:  испытанияи
оформлять:  оформляем
интегралыть:  интегралыв
несобственный:  несобственного несобственные несобственный несобственным
неоднородный:  неоднородные
необходимо:  необходимо
перегруппировка:  перегруппировка
запомнить:  запомнили
правило:  правило правила
приводить:  приводим
многочлен:  многочленов многочлены многочлена многочлен
семёрка:  семерку
вычурно:  вычурно
образец:  образцу образец
раскрытие:  раскрытием
учебный:  учебного учебный
трудный:  трудным
применяться:  применяется
вверху:  вверху
помощь:  помощью
бернулли:  бернулли
французский:  французский
полярный:  полярные полярной полярных
коэффициентковариация:  коэффициентковариации
ряд:  ряд ряды ряда рядов
рассмотреть:  рассмотрим рассмотренном рассмотренных рассмотренный
вариационный:  вариационный
уровень:  уровня
обратный:  обратная обратную
предпосылка:  предпосылкой предпосылки предпосылка
второй:  второй второго
должный:  должны должно должен
использовать:  использую используйте используя использует использовать используем
вопрос:  вопросы вопрос
кратное:  кратные
учиться:  учимся учитесь
войско:  войск
живописный:  живописных
системудифференциальный:  системудифференциальных
блог:  блог
доверительный:  доверительные
смысл:  смысле
поморочить:  поморочено
высокий:  высших высшей высокой высшая высоких
попадаться:  попадается
неравенство:  неравенству неравенства
помешать:  помешает
высечь:  высечена
среднееквадратический:  среднееквадратическое
пойти:  пойти
пространство:  пространстве
уметь:  уметь
несолидно:  несолидно
лопиталя:  лопиталя
год:  год года
сентябрь:  сентября
удобный:  удобный
комбинационный:  комбинационная
квадратичный:  квадратичные
обычно:  обычно
смешанноепроизведение:  смешанноепроизведение
знаменитый:  знаменитый
объём:  объем
стремиться:  стремится стремятся
сократить:  сокращенного сократить
недопонимание:  недопонимание
вместе:  вместе
поляформула:  поляформула
проверить:  проверить
иметь:  иметь
сообщить:  сообщите
интегральный:  интегрального интегральный
сделать:  сделать
линия:  линиями линии линия
фехнера:  фехнера
аналитический:  аналитическая аналитической
усвоение:  усвоения
штука:  штука
поскольку:  поскольку
школьный:  школьный
мы:  нам
центр:  центр
учёба:  учебу
образ:  образом
записывать:  записывая
гипергеометрическоераспределение:  гипергеометрическоераспределение
условный:  условные
непрерывнаяслучайный:  непрерывнаяслучайная
пояснение:  пояснения
извлекаться:  извлекается
эллипс:  эллипс
ибо:  ибо
прямо:  прямо
длина:  длина
материал:  материал материалы материалов
тема:  темам тема темы
любой:  любой
сайт:  сайта сайты сайт
немного:  немного
мочь:  могут мог
знакопостоянство:  знакопостоянства
подробно:  подробно
фамилия:  фамилия
равномерный:  равномерная равномерное
треугольный:  треугольная
градиент:  градиент
определение:  определения определению
трудность:  трудности
пересдавать:  пересдаете
вспомнить:  вспомним
начаться:  начался
вывод:  выводом вывод
пожалуйста:  пожалуйста
даламбер:  даламбера даламбер
возвести:  возвести
тонкость:  тонкости
теорема:  теоремы
факт:  факт
ясно:  ясно
комбинаторика:  комбинаторике
затем:  затем
случайнаявеличина:  случайнаявеличина
располагаться:  располагаться располагается
повторнойя:  повторнойи
построение:  построение
сходиться:  сходящимся сходится сходились сходиться
бяка:  бяка
бесконечно:  бесконечно
давать:  даёт дает
линейнойкорреляционный:  линейнойкорреляционной
действие:  действия
нижний:  нижний
аналогия:  аналогии
скобка:  скобки скобках скобок
ранг:  ранг
расписывать:  расписывать расписываем
квадрат:  квадратов квадрат
возникнуть:  возникнут возник
кривая:  кривой
вычисление:  вычислению вычисления вычисление
форма:  формы
пора:  пор
тяжестиплоска:  тяжестиплоской
отметить:  отметить
ньютон:  ньютона
сразу:  сразу
почему:  почему
распределениякритерия:  распределениякритерий
функциюкомплексный:  функциюкомплексной
луи:  луи
область:  область области
проверка:  проверка
продолжение:  продолжением
стандартный:  стандартным
третий:  третий
построить:  построить
готовый:  готовых
просто:  просто
видеть:  видим
заодно:  заодно
выполнять:  выполнять выполняем
приём:  приём
скрестить:  скрестили
ещё:  ещё
мода:  мода
популярный:  популярны
свойстваэлементарный:  свойстваэлементарных
логарифм:  логарифм
лейбниц:  лейбница
ядро:  ядра
калькулятор:  калькулятор
лерон:  лерон
научиться:  научиться
чётко:  четко
свой:  своих своей
поток:  поток
удовлетворять:  удовлетворяет
полностью:  полностью
кто:  кого
касательная:  касательная
ответ:  ответ ответа ответы
задачис:  задачис
оба:  оба
расписать:  распишем
возводить:  возводить
медиана:  медиана
тригонометрический:  тригонометрических
доводить:  доводим
функциия:  функциии
пушечный:  пушечные
частый:  чаще
четырехэтажность:  четырехэтажности
бесповоротный:  бесповоротного
возможно:  возможно
степенной:  степенного степенные
функцийдвуха:  функцийдвух
говорить:  говорят
направлениюй:  направлениюи
формально:  формально
читатель:  читателей
выборка:  выборке
гостевой:  гостевая
лето:  лето
верный:  верная
распределение:  распределения распределение
использование:  использовании использования
банкет:  банкета
кроме:  кроме
экстремум:  экстремумы
постараться:  постараюсь
поздравление:  поздравления
производныефункция:  производныефункции
средний:  средняя
огюстен:  огюстен
понятно:  понятно
единица:  единице единица
функцийнесколький:  функцийнескольких
знак:  знаком знак
случайно:  случайно
отщипывать:  отщипываем
краска:  красках
применять:  применять
сравнение:  сравнения
заслать:  зашли
внутригрупповаяй:  внутригрупповаяи
последующий:  последующего
зависеть:  зависит зависящей
предельно:  предельно
алгебра:  алгебры
куба:  кубе
рост:  роста
функцийв:  функцийв
переменный:  переменных переменной
продвинуться:  продвинуться
обвести:  обвести
ознакомиться:  ознакомиться
несовместный:  несовместные
независимыеслучайный:  независимыеслучайные
множественнойлинейный:  множественнойлинейной
допускать:  допускают
простой:  простейшую простейший простой простым
мучиться:  мучался
анализ:  анализ анализу анализа
существовать:  существует
классика:  классика
пытаться:  пытаются
штуковина:  штуковина
прямоугольник:  прямоугольников
непрерывность:  непрерывность
эксцессэмпирический:  эксцессэмпирического
жан:  жан
добавляться:  добавляется
пометка:  пометку
подставить:  подставить
радикальный:  радикальный
функциис:  функциис
помечать:  помечаем
зеркало:  зеркало
криволинейный:  криволинейные
начинать:  начинает
значит:  значит
различный:  различных
устранять:  устраняем
пирсон:  пирсона
ходовой:  ходовой
некоторый:  некоторую некоторых
праздник:  праздник праздника
устранение:  устранения
умение:  умения
библиотека:  библиотека
три:  трёх
межгрупповой:  межгрупповая
ортогональный:  ортогональное
дискретнойслучайный:  дискретнойслучайной
задачипо:  задачипо
похожий:  похож похожие похожий
фокус:  фокус
экзотический:  экзотические
востребовать:  востребованную
наименьшеезначение:  наименьшеезначения
нсв:  нсв
задачин:  задачина
сила:  силы
приблизить:  приближенные
параметр:  параметрам
убывать:  убывающая
учебник:  учебниках
верхний:  верхний
помещать:  помещаем
ждать:  ждали
сильный:  сильным
системылинейный:  системылинейных
нужно:  нужно
начать:  начал начнем начать
закуска:  закуску
задание:  задания
слукавить:  слукавил
почленный:  почленное почленном
примечание:  примечание
упасть:  упал
взять:  возьму возьмём
следующий:  следующего следующий следующие
изучать:  изучать
зависимый:  зависимые
зависимость:  зависимость
отклонение:  отклонение
крамер:  крамера
отрезка:  отрезке
прийтись:  придется
другой:  другие
математически:  математически
таблица:  таблицы
произведение:  произведение
век:  века
одновременно:  одновременно
вполне:  вполне
случайный:  случайных случайные
важный:  важный
замкнутый:  замкнутому
халтура:  халтуру
давно:  давно
пропускать:  пропускать
очевидный:  очевидно
дуга:  дуги
частность:  частности
отрезкать:  отрезкав
расправляться:  расправляемся
желать:  желаю
дивергенция:  дивергенция
забивать:  забивать
трафаретный:  трафаретны
парабола:  парабола
карандаш:  карандашом
опытный:  опытных
строго:  строго
проходить:  проходит
форум:  форуме форум
показатель:  показатели показателе
наш:  наш
оформление:  оформления оформление
рассматриваться:  рассматривались
площадьс:  площадьс
шпага:  шпаги
раскрой:  раскроем
функциидвуха:  функциидвух
запретить:  запрещено
статистический:  статистические статистическая
энтузиазм:  энтузиазмом
емелин:  емелин
предлагаться:  предлагается
присутствовать:  присутствует
убыванией:  убываниеи
вычисленияопределенный:  вычисленияопределенных
повышенный:  повышенной
детерминация:  детерминации
конечный:  конечное
возрастание:  возрастание
эмпирический:  эмпирические
сработать:  сработать
турбо:  турбо
также:  также
интегрирование:  интегрирование
тот:  тех
ах:  ах
рациональный:  рациональные
найтись:  нашлось
натуральный:  натуральный
системый:  системыи
удовлетворяетлить:  удовлетворяетли
выясниться:  выяснится
аналогично:  аналогично
прийти:  придёт
нуль:  нулю
сегодня:  сегодня
дифференциальныеуравнение:  дифференциальныеуравнения
начинка:  начинке начинку
обратиться:  обратитесь
прогрессия:  прогрессия
сей:  сих
бином:  биномом
указать:  указать
цепочка:  цепочка цепочкой
иррациональный:  иррациональных
сожаление:  сожалению
интервальный:  интервальный
окно:  окном
летать:  летали
происходить:  происходящего
раскинуть:  раскинуть
постоянный:  постоянных
смотреться:  смотрится
стокс:  стокса
квадратичнуюформ:  квадратичнуюформу
сокращать:  сокращаем
схема:  схема
карта:  карта
устраняться:  устраняется
итак:  итак
параметрический:  параметрической параметрическом
гипербола:  гипербола
вообще:  вообще
устранить:  устранена
равно:  равно
заключительный:  заключительных
дробовик:  дробовик
лично:  лично
оценкия:  оценкии
неявный:  неявной
устать:  устал
сам:  самом
несобственныхинтеграл:  несобственныхинтегралов
вероятностибиномиальный:  вероятностибиномиального
доказательство:  доказательства
работать:  работайте
вероятностия:  вероятностии
логика:  логики
спирмена:  спирмена
скалярный:  скалярное
род:  рода
гаусс:  гаусса
заданав:  заданав
уверенно:  уверенно
совершенно:  совершенно
порядок:  порядка порядков
всё:  всё
значимость:  значимости
тип:  тип
тройной:  тройные
хэ:  хэ
страшный:  страшного
являться:  является
контуруформула:  контуруформула
экстремальный:  экстремальные
изложить:  изложить
поступать:  поступаю
график:  график
лишь:  лишь
дело:  дела деле дело
жаждать:  жаждали
её:  её
парный:  парной
св:  св
биография:  биографию
нормаль:  нормали
определитель:  определитель
провокационный:  провокационный
выпуклость:  выпуклость
мой:  мои
примерный:  примерный
кандидат:  кандидата
несколько:  несколько
элемент:  элементы
сборник:  сборники
шаг:  шаг
показательный:  показательное
либо:  либо
интересно:  интересно
рекомендовать:  рекомендую
аккорд:  аккордах
эн:  эн
раскрыть:  раскрыть
независимый:  независимые
примерно:  примерно
менее:  менее
автор:  автора автор
сложность:  сложности
диффура:  диффурами
почленно:  почленно
часто:  часто
значенияй:  значенияи
этот:  эта
привести:  привести
узнать:  узнать
весьма:  весьма
нужный:  нужной
получаться:  получается
какой:  какие
быть:  будем
содержать:  содержат
классическоеопределение:  классическоеопределение
инормаль:  инормаль
статистика:  статистика
корреляция:  корреляции
биномиальный:  биномиальное
далёкий:  дальше
автомат:  автоматом
редкий:  реже
пирамида:  пирамида
заочник:  заочников
помнить:  помните
повторение:  повторения
линиюв:  линиюв
подынтегральный:  подынтегральная
самостоятельный:  самостоятельного
делимый:  делим
хотеться:  хочется
повторять:  повторяем
выглядеть:  выглядеть
проанализировать:  проанализируем
оказаться:  окажется
