уравнение:  уравнениях уравнению уравнений уравнении уравнения уравнение
вектор:  векторы векторов
дифференцировать:  дифференцируем
столько:  столько
внимательный:  внимательны
знаменатель:  знаменателей знаменателя знаменателю знаменателе знаменатель
цель:  целях
получить:  получить получим получена получи
вид:  видов виде виды вид виду
разобраться:  разобрались
наподобие:  наподобие
вращение:  вращения
дифференциальный:  дифференциальные
уравненияс:  уравненияс
именно:  именно
онлайн:  онлайн
чайник:  чайником чайников
разобрать:  разберём
геометрия:  геометрии геометрия
копирование:  копирование
решить:  решить решим
отработать:  отработайте
рассмотреть:  рассмотрели рассмотрен
разгрызть:  разгрызть
разрыв:  разрыва
работа:  работа работы
выражение:  выражения выражение
сумма:  сумма сумму суммы
нуль:  нуля нули нулём
производный:  производные производная производной производную
прямой:  прямой прямую прямая
дуприближённо:  дуприближённо
один:  одного одну одна
новый:  новому
предел:  предел пределы пределов
слагаемое:  слагаемые слагаемого слагаемых
произвольныйтройный:  произвольныйтройной
модель:  модели модель
асимптота:  асимптоты
разложить:  разложить разложены разложено разложим
дизайн:  дизайна
правильный:  правильные правильная правильной
свободный:  свободные свободный
это:  это этим
название:  название
событие:  события
отблагодарить:  отблагодарить
являться:  являются является являетесь
нулевой:  нулевыми
который:  которую которых которого который которой
повторный:  повторные
неопределённый:  неопределенных неопределенный неопределенном неопределенного неопределенными
байес:  байеса
числовой:  числовые числовой
простой:  проще простыми простых
дисперсия:  дисперсию дисперсия дисперсии
выгодно:  выгодно
решать:  решать решаем
производныенеявно:  производныенеявно
пример:  примере примеры пример примера примеров примерах
бытность:  бытность
решение:  решений решении решением решение решения
неправильный:  неправильная неправильной
поляй:  поляи
интеграл:  интегралы интеграла интеграл интеграле интегралов
находиться:  находится находился находятся
точность:  точности
опечатка:  опечатку
общий:  общему общим общая общее
плясать:  плясать
каменный:  каменным
б:  б
теория:  теория теории
математический:  математические математическая математической математического
тихо:  тихо
продолжать:  продолжаем
найти:  найденные найдены найден найти найденными
проверить:  проверьте проверить
речь:  речь
дать:  дало данная дана
формула:  формулы формула формулу
данный:  данном данный
всякий:  всякого
разбросать:  разбросает
статья:  статье статьи
фнп:  фнп
заготовка:  заготовку
необходимый:  необходимы
выделять:  выделяем выделять
отрицательный:  отрицательный отрицателен
трудный:  труднее
прийтись:  придётся пришлось
канонический:  каноническому
многочлен:  многочленах многочленов многочлены многочлена многочлен
простейшее:  простейшие
метод:  методе методы методами методах методом метод
умножить:  умножить
гипотеза:  гипотезы гипотез гипотеза
дифференциал:  дифференциалах дифференциала
двумерный:  двумерная
больший:  наибольшее большую большие
методомоперационный:  методомоперационного
задать:  заданной задайте
конец:  конце конца
подбирать:  подбираем
часть:  частям части частях
комментарий:  комментарий
тело:  тела
циркуляция:  циркуляция
бесповторный:  бесповторной
особенность:  особенностях
слева:  слева
внести:  внести
правильно:  правильно
двойной:  двойные двойной
институтский:  институтской
ошибка:  ошибку
рассматриваться:  рассматривался
плоскость:  плоскости плоскость
несобство:  несобств
избавляться:  избавляемся
л:  л
странно:  странно
нелинейный:  нелинейная
брать:  берём берем
получиться:  получится
выбрать:  выберет
связь:  связи связь
интуитивный:  интуитивная
три:  трём трёх
преобразованиеквадратичный:  преобразованиеквадратичной
определителяй:  определителяи
степень:  степени степень
вычитать:  вычитаем
вогнутостья:  вогнутостьи
неизвестный:  неизвестными неизвестные
выделить:  выделить
загвоздочка:  загвоздочка
закон:  законы
дробь:  дроби дробей дробь
выяснить:  выяснить
справа:  справа
функциональный:  функциональные
наука:  наука
случай:  случай случая случае
касательный:  касательных
низ:  низ
убедиться:  убедиться убедитесь
значение:  значения
понятный:  понятного понятнее
последний:  последнем
запомнить:  запомните
профессия:  профессию
последовательно:  последовательно
тот:  той те
заниматься:  заниматься
устный:  устные
геометрический:  геометрическая геометрическое
абсолютный:  абсолютная
графика:  графика графики
типовыхзадача:  типовыхзадач
правый:  правых правой
получаться:  получаются получались получается
умножение:  умножения
вероятность:  вероятностей вероятность вероятности
одинаковый:  одинаковы
ранговойкорреляция:  ранговойкорреляции
система:  система систему системе систем системы
частный:  частные частное
функция:  функций функцию функции функция
привести:  приведенное привести
непрерывный:  непрерывная непрерывных
группировка:  группировок группировка
условнаясходимость:  условнаясходимость
сложенияй:  сложенияи
получать:  получая
уравненийв:  уравненийв
раскрывать:  раскрываем
слово:  словами
экономия:  экономии
самый:  самые самый
множитель:  множитель множители множителей множителя
регрессия:  регрессии регрессия
величина:  величин величина величины
александр:  александр
красоваться:  красовалось
вычитание:  вычитание вычитания
халявный:  халявная
рассматривать:  рассматриваемом рассматривать рассматриваемого
грин:  грина
полный:  полное полных полной полный
смеяться:  смеялся
исчисление:  исчисления
линейный:  линейные линейная линейную линейных линейной
редко:  редко
коэффициент:  коэффициентов коэффициент коэффициенты коэффициентами
эйлер:  эйлера
равенство:  равенство
согласие:  согласия
локальный:  локальная
настоятельно:  настоятельно
ожидание:  ожидание
математика:  математики математике
лаплас:  лапласа
перегиб:  перегиба
такой:  таким такое таких такая
представить:  представить
сходимость:  сходимости сходимость
дуоперационный:  дуоперационным
исследовать:  исследовать
ошибочка:  ошибочка
дискретный:  дискретный
нетрудно:  нетрудно
указать:  указанным
базис:  базисах базис базису
никто:  никто
поверхность:  поверхности
дискриминант:  дискриминант
знакочередоваться:  знакочередующиеся
задача:  задачи
составить:  составить составим
векторный:  векторного векторное
член:  член члены
ду:  ду
наиболее:  наиболее
далее:  далее
зависимостьвектор:  зависимостьвекторов
наворотить:  навороченными
линейныйкоэффициент:  линейныйкоэффициент
отсутствовать:  отсутствуют
делать:  делать делаю делаем
мысль:  мысль
рисовать:  рисуем
остаток:  остатка
снова:  снова
предпоследний:  предпоследний
сначала:  сначала
составлять:  составляем
собственный:  собственные
страница:  страницу
числитель:  числителе числитель числителя
практически:  практически
несобственныйинтеграл:  несобственныйинтеграл
признак:  признак признаки
произвольный:  произвольных
смотреть:  смотрим
данные:  данных
сложный:  сложной сложных сложные сложная
рассмотрение:  рассмотрению
доступно:  доступно
объяснение:  объяснения
следовать:  следуйте следует
подсократить:  подсократил
фурье:  фурье
учиться:  учимся
поле:  поля
поэтому:  поэтому
разложение:  разложением разложение разложении
сойтись:  сойтись
практика:  практике
свойство:  свойства
задавать:  задаваемые
урок:  урока урок уроке
разделить:  разделить
интересный:  интересен
типовой:  типовой
мож:  мож
исследование:  исследование
принцип:  принципе принципам
объяснить:  объясню
весь:  всем
выступить:  выступит
ипример:  ипримеры
точка:  точки точке
знать:  знаем знаете
множество:  множества
оценка:  оценки оценка
мочь:  можете
переход:  переход
вариация:  вариации
асимметрия:  асимметрия
комплексный:  комплексными комплексные комплексного комплексный
основа:  основы
поверхностный:  поверхностные
вопрос:  вопросом вопросы вопрос
интервал:  интервалы
телодвижение:  телодвижения
книга:  книга книги
скажем:  скажем
главный:  главную
кош:  коши
основной:  основной основные
желательно:  желательно
координата:  координат координаты координатах
фигура:  фигуры
представимый:  представим
выше:  выше
первый:  первое первой первом первого
пуассон:  пуассона
изучение:  изучению
подобный:  подобные
успех:  успехов
сводиться:  сводящиеся
соответствующий:  соответствующих соответствующие
каждый:  каждым каждое каждой каждый
преобразование:  преобразований преобразования
замена:  замены
вычисленияс:  вычисленияс
результат:  результаты результате
малый:  малые наименьших
маленький:  меньше маленьких маленькая маленькие
понижение:  понижением понижение
матричный:  матричные матричных матричный
прочь:  прочь
два:  двум
расчёт:  расчеты
методичка:  методички
заметить:  заметили заметить
навык:  навыки
благополучно:  благополучно
математическоеожидание:  математическоеожидание
уметь:  умеем
например:  например
однородный:  однородные однородным
решенияопределённый:  решенияопределенных
записывать:  записываем
вычислить:  вычислить
разыскивать:  разыскиваем
нормальный:  нормальное
школа:  школа
очень:  очень
вернуться:  вернемся
интегральнаятеорема:  интегральнаятеоремы
хотя:  хотя
корнимногочлен:  корнимногочлена
логарифмический:  логарифмическая
идти:  шла идет
матрица:  матрицу матрицы матрицами
этап:  этапе
испытанияй:  испытанияи
интегралыть:  интегралыв
доцент:  доцент
неоднородный:  неоднородные
необходимо:  необходимо
перегруппировка:  перегруппировка
проверять:  проверяем
правило:  правило правила правилу
принципиальный:  принципиальных
приводить:  приводим приводить
выражать:  выражаем
чистовой:  чистовое
вверху:  вверху
помощь:  помощью
бернулли:  бернулли
полярный:  полярные полярной полярных
коэффициентковариация:  коэффициентковариации
ряд:  ряд ряды ряда рядов
вариационный:  вариационный
уровень:  уровня
обратный:  обратная обратную обратные
последующий:  последующие
второй:  второй втором второго
элементарный:  элементарных
накатать:  накатанной накатанная
задаваться:  задаемся
причина:  причинам причине
кратное:  кратные кратных
приём:  прием
взглянуть:  взгляните
системудифференциальный:  системудифференциальных
блог:  блог
соответствовать:  соответствующая
доверительный:  доверительные
смысл:  смысле
высокий:  высших высшей высшая
изначально:  изначально
обыденный:  обыденна
произведение:  произведения произведение
дробный:  дробные
нюанс:  нюанс
среднееквадратический:  среднееквадратическое
остаться:  оставшейся
пространство:  пространстве
алгоритм:  алгоритм алгоритму
тип:  типа
лопиталя:  лопиталя
последовательность:  последовательностей
удобный:  удобный
комбинационный:  комбинационная
путь:  путь
должный:  должно
курс:  курс
крайне:  крайне
квадратичный:  квадратичные
быть:  будьте буду будут будем
смешанноепроизведение:  смешанноепроизведение
некоторый:  некотором некоторых
объём:  объем
эх:  эх
ставить:  ставим
сократить:  сокращенного
поляформула:  поляформула
столбик:  столбиком
сообщить:  сообщите
проверка:  проверки проверку проверка
сделать:  сделать
трудность:  трудность трудности
линия:  линиями линии линия
фехнера:  фехнера
состоять:  состояли состояла
аналитический:  аналитическая аналитической
перейти:  перейдем
поскольку:  поскольку
школьный:  школьный школьное школьном
эффективный:  эффективные
левый:  левой
производить:  производим
центр:  центр
образ:  образом
гипергеометрическоераспределение:  гипергеометрическоераспределение
оба:  обоих
условный:  условные
непрерывнаяслучайный:  непрерывнаяслучайная
квадратный:  квадратное квадратный
эллипс:  эллипс
третий:  третьем третий третье
ноль:  ноль
сложение:  сложения
сложно:  сложно
поступить:  поступить
единственно:  единственно
обратить:  обратите обратил
длина:  длина
удаться:  удастся
любой:  любой
интегрироваться:  интегрируется
сборник:  сборника сборники
сайт:  сайта сайты сайт
квадрат:  квадрата квадратов квадрат
знакопостоянство:  знакопостоянства
траектория:  траектории
подробно:  подробно
равномерный:  равномерная равномерное
треугольный:  треугольная
неплохо:  неплохо
градиент:  градиент
догадаться:  догадались
посетить:  посетить
учитель:  учителем
определение:  определения определению
выйти:  вышла
использовать:  используйте используя используем
пожалуйста:  пожалуйста
даламбер:  даламбера
ориентироваться:  ориентироваться
теорема:  теоремы теорема
комбинаторика:  комбинаторике
целый:  целые
случайнаявеличина:  случайнаявеличина
повторнойя:  повторнойи
построение:  построение
бесконечно:  бесконечно
линейнойкорреляционный:  линейнойкорреляционной
рассказать:  рассказал
настраиваться:  настраиваемся
действие:  действия
ранг:  ранг
скобка:  скобки скобке
кривая:  кривой
форма:  формы
равный:  равны равна
поставить:  поставить
тяжестиплоска:  тяжестиплоской
сразу:  сразу
почему:  почему
распределениякритерия:  распределениякритерий
функциюкомплексный:  функциюкомплексной
область:  область области
продолжение:  продолжением
построить:  построить
готовый:  готовых готово готова
несобственный:  несобственные
просто:  просто
мода:  мода
заодно:  заодно
свойстваэлементарный:  свойстваэлементарных
выполнять:  выполнять
считать:  считать
принимать:  принимает
внимание:  внимание
увеличиться:  увеличился
момент:  момента
икс:  иксы икса
зрение:  зрения
калькулятор:  калькулятор
лейбниц:  лейбница
недоставать:  недостающие
научиться:  научиться научился
откуда:  откуда
неравенство:  неравенства
наш:  наше наш нашу нашем
процесс:  процесс
поток:  поток
минералка:  минералка
касательная:  касательная
ответ:  ответ ответы
задачис:  задачис
буква:  букву
расшутиться:  расшутился
дальнейший:  дальнейшие
реально:  реально
неразложимый:  неразложимый неразложим
обращать:  обращаю
медиана:  медиана
превратить:  превратить
функциия:  функциии
записать:  записать
завершать:  завершающем
степенной:  степенного степенные
функцийдвуха:  функцийдвух
направлениюй:  направлениюи
определённый:  определенный определенного
выборка:  выборке
кратный:  кратный
гостевой:  гостевая
действительно:  действительно
серьёзный:  серьезная серьезный
распределение:  распределения распределение
кроме:  кроме
экстремум:  экстремумы
снижаться:  снижающейся
горнера:  горнера
производныефункция:  производныефункции
средний:  средняя
понятно:  понятно
пиво:  пиву
функцийнесколький:  функцийнескольких
случайно:  случайно
вывод:  вывод
внутригрупповаяй:  внутригрупповаяи
он:  нём
алгебра:  алгебры
корявый:  корявый
трёхчлен:  трехчлен
число:  числами числа
математик:  математика
функцийв:  функцийв
переменный:  переменных переменной переменные
раскладывать:  раскладывать раскладываем
деление:  деление деления
проскакивать:  проскакивает
видеть:  видите
несовместный:  несовместные
ознакомиться:  ознакомиться
независимыеслучайный:  независимыеслучайные
множественнойлинейный:  множественнойлинейной
водка:  водки
существовать:  существует
анализ:  анализ анализа
делитель:  делителя
нахождение:  нахождением
начинать:  начинаем
прямоугольник:  прямоугольников
непрерывность:  непрерывность
нехорошесть:  нехорошести
эксцессэмпирический:  эксцессэмпирического
подставить:  подставить
возникнуть:  возникли
хороший:  хорошего хорошие
функциис:  функциис
этот:  этому
зеркало:  зеркало
различный:  различных
криволинейный:  криволинейные
значит:  значит
исходный:  исходная
пирсон:  пирсона
смочь:  сможете
библиотека:  библиотека
приписать:  приписать
межгрупповой:  межгрупповая
ортогональный:  ортогональное
старший:  старшей старшая старшую старшие
дискретнойслучайный:  дискретнойслучайной
утверждать:  утверждает
задачипо:  задачипо
пятый:  пятой
востребовать:  востребованную
наименьшеезначение:  наименьшеезначения
нсв:  нсв
отмечать:  отмечаем
сила:  силы
другой:  другую другие другого
задачка:  задачка
приблизить:  приближенные
выяснять:  выясняем
верх:  верха
системылинейный:  системылинейных
нужно:  нужно
рациональный:  рациональный рациональные
задание:  задания задание
упасть:  упал
ход:  ходе
соответствие:  соответствии
зависимый:  зависимые
зависимость:  зависимость
отклонение:  отклонение
крамер:  крамера
несомненно:  несомненно
отрезка:  отрезке
материал:  материалы материала материалов
что:  чему
пропуск:  пропусков
придумать:  придумает
таблица:  таблицы
похожий:  похожий
случайный:  случайных случайные
время:  времени
замкнутый:  замкнутому
очевидный:  очевидно
дуга:  дуги
перебрать:  перебрать
отрезкать:  отрезкав
приведение:  приведение
желать:  желаю
дивергенция:  дивергенция
парабола:  парабола
линейность:  линейности
базовый:  базовые
строго:  строго
форум:  форуме форум
основный:  основная
показатель:  показатели
следующий:  следующий
взаимно:  взаимно
площадьс:  площадьс
запретить:  запрещено
функциидвуха:  функциидвух
интегрировать:  интегрируем
статистический:  статистические статистическая
умолчать:  умолчу
емелин:  емелин
оформлять:  оформлять
умножать:  умножаем
подынтегральный:  подынтегральную подынтегральная
буковка:  буковку
убыванией:  убываниеи
вычисленияопределенный:  вычисленияопределенных
повышенный:  повышенной
возрастание:  возрастание
эмпирический:  эмпирические
детерминация:  детерминации
нежели:  нежели
интегрирование:  интегрирование интегрирования интегрированием
легко:  легко
задачин:  задачина
замечательный:  замечательные
системый:  системыи
начать:  начать
удовлетворяетлить:  удовлетворяетли
найтись:  нашлось
пока:  пока
дифференциальныеуравнение:  дифференциальныеуравнения
почленный:  почленного
ситуация:  ситуация
напрашиваться:  напрашивающийся
иррациональный:  иррациональных
интервальный:  интервальный
тригонометрический:  тригонометрических
постоянный:  постоянных
квадратичнуюформ:  квадратичнуюформу
стокс:  стокса
схема:  схема схеме
карта:  карта
параметрический:  параметрической параметрическом
итак:  итак
куб:  кубов
проводить:  проводим
гипербола:  гипербола
оформление:  оформление
взять:  взял
вообще:  вообще
несложный:  несложная
равно:  равно
приехать:  приехали
одинокий:  одинокий одиноких
дробовик:  дробовик
они:  ними
лично:  лично
оценкия:  оценкии
неявный:  неявной
параграф:  параграф параграфе
встречаться:  встречается
несобственныхинтеграл:  несобственныхинтегралов
вероятностибиномиальный:  вероятностибиномиального
подстановка:  подстановки
сам:  самом
произойти:  произошло
вероятностия:  вероятностии
логика:  логики
появляться:  появляться
род:  рода
заданав:  заданав
скалярный:  скалярное
спирмена:  спирмена
гаусс:  гаусса
выполнить:  выполнили
совершенно:  совершенно
порядок:  порядка порядков
всё:  всё
значимость:  значимости
тройной:  тройные
трогать:  трогаем
полезно:  полезно
возникать:  возникает
направить:  направлены
страшный:  страшного
сказать:  сказала
заключительный:  заключительный
мысленно:  мысленно
контуруформула:  контуруформула
выразить:  выразить
какой:  каким
экстремальный:  экстремальные
график:  график
группа:  группе
дело:  деле
облегчение:  облегчением
св:  св
парный:  парной
рябушко:  рябушко
успешный:  успешного
нормаль:  нормали
иметь:  имеет
определитель:  определитель
временно:  временно
пытка:  пыток
приступить:  приступили
выпуклость:  выпуклость
энна:  энной
пара:  пара
несколько:  несколько
элемент:  элементы
шаг:  шаг
показательный:  показательное
либо:  либо
отсюда:  отсюда
объяснять:  объясняю
рекомендовать:  рекомендую
примерно:  примерно
независимый:  независимые
раскрыть:  раскрыть
раскладываться:  раскладывается
менее:  менее
автор:  автора автор
сложность:  сложности
диффура:  диффурами
почленно:  почленно
часто:  часто
значенияй:  значенияи
узнать:  узнать
никак:  никак
выговаривать:  выговаривать
немного:  немного
улыбаться:  улыбаться
нужный:  нужной
вычисление:  вычисление
выполняться:  выполняется
вздохнуть:  вздохнем
находить:  находим
я:  мной
надеяться:  надеюсь
классическоеопределение:  классическоеопределение
инормаль:  инормаль
способ:  способ
статистика:  статистика
корреляция:  корреляции
лад:  лад
хитрый:  хитрее
подставлять:  подставляем
биномиальный:  биномиальное
гуд:  гуд
далёкий:  дальше
заочник:  заочников
пирамида:  пирамида
объект:  объектом
гоготать:  гоготать
лицо:  лицом
дожить:  доживет
линиюв:  линиюв
разный:  разные
шутка:  шутки
чёрточка:  черточку
самостоятельный:  самостоятельного
отношение:  отношении
делимый:  делим
говорить:  говоря
повторять:  повторяем
понимание:  понимания
закрепить:  закрепим
второе:  второе
устно:  устно
складывать:  складываем
выглядеть:  выглядеть
