вектор:  векторы векторов
посетитель:  посетителей
вид:  видов виде виды вида вид виду
вращение:  вращения
дифференциальный:  дифференциальные
уравненияс:  уравненияс
расположиться:  расположилась расположился
привет:  привет
онлайн:  онлайн
геометрия:  геометрии геометрия
копирование:  копирование
критически:  критически
решить:  решить
отработать:  отработайте
рассмотреть:  рассмотрели рассмотрим рассмотрю
разрыв:  разрыва
работа:  работа работе
выражение:  выражения выражениям
сумма:  сумма сумму
математический:  математических математические математическая математической
производный:  производные производная производной производную
прямой:  прямой прямую прямая
дуприближённо:  дуприближённо
нуль:  нуля
новый:  новому новую
предел:  предел пределы пределов
произвольныйтройный:  произвольныйтройной
модель:  модели модель
асимптота:  асимптоты
предполагать:  предполагаем
дизайн:  дизайна
это:  это
икс:  иксом икс
событие:  события
отблагодарить:  отблагодарить
технический:  технический техническими
известный:  известные известны известна
который:  которую которые который
повторный:  повторные
порядок:  порядок порядка порядков
байес:  байеса
содержательный:  содержательными содержательным
исходный:  исходного исходное
числовой:  числовые
минус:  минуса минус
дисперсия:  дисперсию дисперсия дисперсии
коллекция:  коллекции
решать:  решать
производныенеявно:  производныенеявно
пример:  примере примеры пример примера
декабрь:  декабря
значение:  значение
помнить:  помним
решение:  решений решением решение решения
поляй:  поляи
интеграл:  интегралы интеграла интеграл интеграле интегралов
находиться:  находится
опечатка:  опечатку
случай:  случаях случай случаев случае
результат:  результат
теория:  теория теории
состоять:  состоит состоящий состоять состояла
формула:  формулы формула формуле
данный:  данном данное данный
смотреть:  см
фнп:  фнп
охотник:  охотником
вечный:  вечной
пояснение:  пояснений
прийтись:  придётся
канонический:  каноническому
простейшее:  простейшие простейшее
начинающий:  начинающих
умножить:  умножить умножим
два:  две двумя двух
гипотеза:  гипотезы гипотез гипотеза
дифференциал:  дифференциалах дифференциала
двумерный:  двумерная
больший:  наибольшее
сдаться:  сдадутся
методомоперационный:  методомоперационного
задать:  заданной задайте
выразить:  выразим выразить
конец:  конце концом конец
часть:  частям часть части
заметить:  заметьте заметили
тело:  тела
циркуляция:  циркуляция
бесповторный:  бесповторной
знакомый:  знакомые знакомая
слева:  слева
внести:  внести
правильно:  правильно
обратный:  обратной обратная обратную
двойной:  двойные двойной
перемножать:  перемножаем
ошибка:  ошибку
плоскость:  плоскости плоскость
несобство:  несобств
л:  л
общий:  общим общая общие общий
нелинейный:  нелинейная
брать:  берём
надоесть:  надоела
оставить:  оставить
правый:  правая правой правую
какой:  каком
луна:  луны
преобразованиеквадратичный:  преобразованиеквадратичной
матрица:  матриц матрицу матрицы матрица матрицами
определителяй:  определителяи
число:  число чисел числами числа
вогнутостья:  вогнутостьи
важно:  важно
абзац:  абзацем
неизвестный:  неизвестными неизвестный неизвестной неизвестная
верный:  верный верное
согласно:  согласно
закон:  законы
дробь:  дроби дробей дробь
первый:  первым первом первого
справа:  справа
навык:  навыками
позволять:  позволяет
функциональный:  функциональные
минор:  миноров
разрешение:  разрешения
касательный:  касательных
урок:  уроками урок урока уроке
убедиться:  убедиться
читать:  читаете
профессия:  профессию
действие:  действий действие действия действием
геометрический:  геометрическая геометрическое
абсолютный:  абсолютная
графика:  графика графики
типовыхзадача:  типовыхзадач
стремиться:  стремящейся
комментарий:  комментариев
пункт:  пункт
умножение:  умножения умножением умножение
готовый:  готовый готовых готового готово
вероятность:  вероятностей вероятностью вероятность вероятности
ранговойкорреляция:  ранговойкорреляции
система:  система систему системе системы
частный:  частные частный частное
функция:  функций функции функция
выполнимый:  выполним
четвёртый:  четвёртом
непрерывный:  непрерывная непрерывных
группировка:  группировок группировка
заняться:  заняться
условнаясходимость:  условнаясходимость
сложенияй:  сложенияи
заключение:  заключение
уравненийв:  уравненийв
транспонировать:  транспонированная
регрессия:  регрессии регрессия
величина:  величин величина величины
свой:  свой
александр:  александр
милость:  милость
вычитание:  вычитание
уровень:  уровень уровня
контрольный:  контрольной
обладать:  обладать
множитель:  множители множителей
грин:  грина
полный:  полное полных полной полный
исчисление:  исчисления
линейный:  линейные линейная линейных линейного линейной
редко:  редко
суть:  сути
удачный:  удачной
эйлер:  эйлера
направо:  направо
разрешимый:  разрешим
равенство:  равенство
согласие:  согласия
локальный:  локальная
начинать:  начиная
константа:  константа
отличие:  отличиями
ожидание:  ожидание
математика:  математики математике
лаплас:  лапласа
перегиб:  перегиба
такой:  таким такое
птица:  птицы
сходимость:  сходимости сходимость
дуоперационный:  дуоперационным
исследовать:  исследовать исследуем
дискретный:  дискретный
базис:  базисах базис базису
ход:  ходу ход
поверхность:  поверхности
сделать:  сделают сделать
знакочередоваться:  знакочередующиеся
задача:  задачи задача
следующий:  следующая следующей
обычный:  обычному
векторный:  векторного векторное
несколько:  нескольких
ду:  ду
далее:  далее
зависимостьвектор:  зависимостьвекторов
последний:  последним
линейныйкоэффициент:  линейныйкоэффициент
распространить:  распространённый
нахождение:  нахождении нахождением
оно:  оно
коэффициент:  коэффициент
неопределённый:  неопределенный неопределенном
сначала:  сначала
метод:  методы методом метод
сам:  самому самой самом
собственный:  собственные
тема:  теме
страница:  страницу
голова:  голову
практически:  практически
несобственныйинтеграл:  несобственныйинтеграл
признак:  признак признаки
произвольный:  произвольных
данные:  данных
сложный:  сложной сложных сложные
элемент:  элемент элементов элементы
доступно:  доступно
продолжаться:  продолжаться
свестись:  сведётся
тройка:  тройку
фурье:  фурье
красивший:  красивше
учиться:  учимся
поле:  поля
поэтому:  поэтому
разложение:  разложением разложение
задавать:  задаваемые
практика:  практике
свойство:  свойства свойству
вместо:  вместо
некоторый:  некоторыми некоторых некоторые
сводиться:  сводится сводящиеся
исследование:  исследование
экзамен:  экзаменов
ипример:  ипримеры
точка:  точки точке
знать:  знаем
уравнение:  уравнению уравнений уравнения уравнение
множество:  множества
найти:  найти найдено найденного нашёл найдём найдем найденное
оценка:  оценки оценка
никакой:  никаких
переход:  переход
вариация:  вариации
поздравлять:  поздравляю
требоваться:  требуется требовалось
асимметрия:  асимметрия
шаг:  шаге
комплексный:  комплексными комплексные комплексного комплексный
основа:  основы
поверхностный:  поверхностные
интервал:  интервалы
книга:  книга книги
главный:  главную
кош:  коши
желательно:  желательно
координата:  координат координаты координатах
фигура:  фигуры
элементарный:  элементарен
пуассон:  пуассона
соответствующий:  соответствующих соответствующие
чайник:  чайников
собственно:  собственно
смена:  сменой
преобразование:  преобразований преобразования
замена:  замены
отличный:  отличная
вычисленияс:  вычисленияс
однако:  однако
целесообразно:  целесообразно
приводиться:  приводится
сориентировать:  сориентировать
малый:  малые меньшей наименьших
связь:  связь
зачёт:  зачётов
понижение:  понижением понижение
матричный:  матричные матричных матричным матричного матричное матричный
всякий:  всяких всякий
фактически:  фактически
убрать:  убрать
математическоеожидание:  математическоеожидание
например:  например
однородный:  однородные однородным
решенияопределённый:  решенияопределенных
дать:  данной
вычислить:  вычислить
нормальный:  нормальное
школа:  школа
очень:  очень
сказать:  сказали скажу
интегральнаятеорема:  интегральнаятеоремы
действительность:  действительности
хотя:  хотя
корнимногочлен:  корнимногочлена
логарифмический:  логарифмическая
вернуться:  вернитесь вернёмся
испытанияй:  испытанияи
интегралыть:  интегралыв
неоднородный:  неоднородные
необходимо:  необходимо
начать:  начнём начать
перегруппировка:  перегруппировка
правило:  правило правила правилу
основной:  основные
помощь:  помощью
бернулли:  бернулли
полярный:  полярные полярной полярных
коэффициентковариация:  коэффициентковариации
победитель:  победителя
ряд:  ряд ряды ряда рядов
мерзлота:  мерзлоте
вариационный:  вариационный
упаковывание:  упаковывание
вопрос:  вопросы вопрос
кратное:  кратные
перенос:  перенос
системудифференциальный:  системудифференциальных
казаться:  кажется
блог:  блог
доверительный:  доверительные
получить:  получена получено полученный получили получи
высокий:  высших высшей высшая
обыденный:  обыденна
свет:  света
цивилизация:  цивилизации
среднееквадратический:  среднееквадратическое
коротко:  коротко
летописец:  летописцы
единственный:  единственной
пространство:  пространстве
алгоритм:  алгоритм
открытие:  открытие
вынести:  вынесли вынести
лопиталя:  лопиталя
читатель:  читателя
последовательность:  последовательностей
удобный:  удобный
комбинационный:  комбинационная
должный:  должно
курс:  курс
крайне:  крайне
оба:  обе обоих
квадратичный:  квадратичные
смешанноепроизведение:  смешанноепроизведение
объём:  объем
проверить:  проверить
поляформула:  поляформула
сообщить:  сообщите
линия:  линиями линии линия
фехнера:  фехнера
сессия:  сессии
аналитический:  аналитическая аналитической
выражаться:  выражается выражаясь
поскольку:  поскольку
школьный:  школьный
эффективный:  эффективные
левый:  левой левую
единичный:  единичную
мы:  нам нами
центр:  центр
принцип:  принципы
образ:  образом
гипергеометрическоераспределение:  гипергеометрическоераспределение
вывод:  вывода
любить:  любит
условный:  условные
непрерывнаяслучайный:  непрерывнаяслучайная
мучиться:  мучаюсь
эллипс:  эллипс
счастие:  счастья
раз:  раза
клинопись:  клинопись
доказательство:  доказательство
сложно:  сложно
прямо:  прямо
ноль:  ноль
длина:  длина
процесс:  процессе
возможность:  возможность
сайт:  сайта сайты сайт
мочь:  могут мог
знакопостоянство:  знакопостоянства
уютный:  уютно
подробно:  подробно
равномерный:  равномерная равномерное
проводить:  проводить проводим
заключительный:  заключительном
треугольный:  треугольная
градиент:  градиент
писать:  пишем
дополнение:  дополнений
определение:  определения определению
картина:  картина
трудность:  трудности трудностей
точный:  точные
использовать:  используйте использовать используем
пожалуйста:  пожалуйста
даламбер:  даламбера
перенести:  перенесём перенесёте
приемлемый:  приемлемо
сторона:  сторону стороны
теорема:  теоремы
комбинаторика:  комбинаторике
стандартный:  стандартный стандартная
случайнаявеличина:  случайнаявеличина
повторнойя:  повторнойи
иной:  иного
построение:  построение
сдавать:  сдавали
усложнить:  усложним
проверка:  проверку проверка
бесконечно:  бесконечно
знак:  знаков знака
статья:  статью статьи
линейнойкорреляционный:  линейнойкорреляционной
себя:  собой
простой:  простого
квадрат:  квадратов
ранг:  ранг
время:  время
составить:  составили
кривая:  кривой
студент:  студентами студентов
форма:  формы
равный:  равны
каждый:  каждом каждый
тяжестиплоска:  тяжестиплоской
видеть:  видели
сразу:  сразу
нулевой:  нулевая
распределениякритерия:  распределениякритерий
относительно:  относительно
функциюкомплексный:  функциюкомплексной
напоминать:  напоминаю
область:  область области
предстоять:  предстоит
третий:  третий
построить:  построить
майя:  майя
несобственный:  несобственные
просто:  просто
заодно:  заодно
мода:  мода
три:  тремя трёх
свойстваэлементарный:  свойстваэлементарных
провести:  проведём провести
приём:  приём
ещё:  ещё
настоящий:  настоящей
задание:  заданиям задания задание
подобрать:  подберу подобрать
внимание:  внимание
калькулятор:  калькулятор
лейбниц:  лейбница
научиться:  научиться научится
привести:  приведем привести
неравенство:  неравенства
поток:  поток
алгебраический:  алгебраических
работёнка:  работёнки
касательная:  касательная
ответ:  ответ ответы
задачис:  задачис
разобраться:  разобраться
медиана:  медиана
функциия:  функциии
записать:  записать
устроить:  устроены
степенной:  степенного степенные
возможно:  возможно
картинка:  картинка
функцийдвуха:  функцийдвух
оказаться:  оказался
направлениюй:  направлениюи
определённый:  определенный определенного
выборка:  выборке
неожиданный:  неожиданное
подобный:  подобных подобным
гостевой:  гостевая
грамотно:  грамотно
устать:  устали
убирать:  убираем
переписать:  перепишем
действительно:  действительно
распределение:  распределения распределение
экстремум:  экстремумы
кроме:  кроме
горнера:  горнера
производныефункция:  производныефункции
средний:  средняя
операция:  операций
функцийнесколький:  функцийнескольких
случайно:  случайно
подготовка:  подготовки
возникнуть:  возникнуть
внутригрупповаяй:  внутригрупповаяи
фраза:  фразой фразы
солнцестояние:  солнцестояния
алгебра:  алгебры
получать:  получаем
плюс:  плюс
уместно:  уместно
математик:  математика
функцийв:  функцийв
переменный:  переменных переменной
упрощение:  упрощения
условие:  условия условию
ознакомиться:  ознакомиться
любопытный:  любопытна
несовместный:  несовместные
гугл:  гугл
независимыеслучайный:  независимыеслучайные
множественнойлинейный:  множественнойлинейной
добавить:  добавить
выполнение:  выполнения
существовать:  существует
анализ:  анализ анализа
сойтись:  сойдётся
искать:  ищем
прямоугольник:  прямоугольников
непрерывность:  непрерывность
эксцессэмпирический:  эксцессэмпирического
забывать:  забываем
подставить:  подставить подставим
предварительный:  предварительных
типовой:  типовое
функциис:  функциис
зеркало:  зеркало
различный:  различных
криволинейный:  криволинейные
значит:  значит
второй:  втором второго
сохраниться:  сохранившийся
деньга:  деньги
пирсон:  пирсона
реальный:  реальной
библиотека:  библиотека
межгрупповой:  межгрупповая
ортогональный:  ортогональное
год:  года
дискретнойслучайный:  дискретнойслучайной
детский:  детского
задачипо:  задачипо
чистовой:  чистовой чистового
востребовать:  востребованную
наименьшеезначение:  наименьшеезначения
нсв:  нсв
однообразный:  однообразная
сила:  силы
приблизить:  приближенные
расплодить:  распложена
расшифровать:  расшифруют
системылинейный:  системылинейных
нужно:  нужно
армагеддон:  армагеддон
неделя:  недели
образец:  образец
низкий:  низкий
примечание:  примечание
партизан:  партизан
упасть:  упал
зависимый:  зависимые
откопать:  откопают
нечего:  нечего
зависимость:  зависимость
отклонение:  отклонение
крамер:  крамера
избавиться:  избавиться
отрезка:  отрезке
материал:  материалы материалов
другой:  другие
таблица:  таблицы
произведение:  произведение
вполне:  вполне
случайный:  случайных случайные
замкнутый:  замкнутому
пропускать:  пропускать
освоение:  освоения
дуга:  дуги
очевидный:  очевидно
отрезкать:  отрезкав
делиться:  делятся
календарь:  календарь
сухой:  сухие
дивергенция:  дивергенция
парабола:  парабола
наступить:  наступил
форум:  форуме форум
показатель:  показатели
характерный:  характерные
наш:  наш нашу
оформление:  оформления оформлении
короче:  короче
прорешать:  прорешать
площадьс:  площадьс
выполнять:  выполняем
функциидвуха:  функциидвух
запретить:  запрещено
большинство:  большинстве
статистический:  статистические статистическая
ехать:  едет
сервер:  сервер
емелин:  емелин
умножать:  умножаем
разобрать:  разобрали
зимний:  зимнего
строка:  строки
убыванией:  убываниеи
вычисленияопределенный:  вычисленияопределенных
повышенный:  повышенной
возрастание:  возрастание
эмпирический:  эмпирические
детерминация:  детерминации
также:  также
интегрирование:  интегрирование
глядеть:  глядишь
передавать:  передаю
задачин:  задачина
замечательный:  замечательные
рациональный:  рациональные
системый:  системыи
удовлетворяетлить:  удовлетворяетли
шаман:  шаманом
найтись:  нашлось
этап:  этап
находка:  находкой
выполнить:  выполнить
дифференциальныеуравнение:  дифференциальныеуравнения
иррациональный:  иррациональных
интервальный:  интервальный
тригонометрический:  тригонометрических
постоянный:  постоянных
столкнуться:  столкнуться
квадратичнуюформ:  квадратичнуюформу
стокс:  стокса
схема:  схема
карта:  карта
боль:  боли
параметрический:  параметрической параметрическом
итак:  итак
мера:  мере
тибетский:  тибетские
гипербола:  гипербола
особенный:  особенные
вообще:  вообще
равно:  равно
дробовик:  дробовик
они:  ними
оценкия:  оценкии
неявный:  неявной
академичный:  академично
встречаться:  встречается
несобственныхинтеграл:  несобственныхинтегралов
вероятностибиномиальный:  вероятностибиномиального
перестановочный:  перестановочно
подстановка:  подстановки
остановиться:  остановимся
переносить:  переносим
большой:  побольше
вероятностия:  вероятностии
логика:  логики
род:  рода
заданав:  заданав
скалярный:  скалярное
спирмена:  спирмена
гаусс:  гаусса
вагон:  вагоне
всё:  всё
значимость:  значимости
честно:  честно
тип:  тип
тройной:  тройные
систематизировать:  систематизируем
достигнуть:  достичь
особый:  особых
деление:  деления
являться:  является
контуруформула:  контуруформула
рассказывать:  рассказывать
точно:  точно
залечь:  залёг
экстремальный:  экстремальные
график:  график
разрешить:  разрешить
упаковывать:  упаковываем
дело:  деле
её:  её
небольшой:  невелика
св:  св
парный:  парной
день:  дня
нормаль:  нормали
иметь:  имеет
определитель:  определитель
приводить:  привожу
встретиться:  встретятся
желать:  желающие
выпуклость:  выпуклость
примерный:  примерный
тишина:  тишину
сборник:  сборники
финиш:  финише
верно:  верно
показательный:  показательное
монах:  монахи
персонаж:  персонаж
либо:  либо
свободный:  свободную
независимый:  независимые
менее:  менее
автор:  автора автор
сложность:  сложности
диффура:  диффурами
часто:  часто
значенияй:  значенияи
фишка:  фишки
один:  одному
перейти:  перейдём
весьма:  весьма
трафарет:  трафарет
сдача:  сдачи
нужный:  нужной
начало:  началу
получаться:  получается
кстати:  кстати
появиться:  появиться
аналог:  аналог
вычисление:  вычисление
находить:  находим
переживать:  переживайте
классическоеопределение:  классическоеопределение
инормаль:  инормаль
представлять:  представляет
статистика:  статистика
корреляция:  корреляции
прежде:  прежде
причёсывать:  причёсываем
вперёд:  вперёд
записывать:  записывать
бэ:  бэ
биномиальный:  биномиальное
потренироваться:  потренироваться
заочник:  заочников
пирамида:  пирамида
линиюв:  линиюв
видимо:  видимо
незнакомец:  незнакомец
самостоятельный:  самостоятельного
ограничиться:  ограничиться
отношение:  отношении
делимый:  делим
повторять:  повторяем
