вектор:  векторы векторов
прямоугольник:  прямоугольниками прямоугольников
таковой:  таковых
исследовать:  исследуемая исследовать
перебор:  перебора перебор
проводить:  проводит проводить
счёт:  счёт
дискретный:  дискретным дискретны дискретный дискретном дискретного
заключить:  заключены
вращение:  вращения
дифференциальный:  дифференциальные
уравненияс:  уравненияс
линия:  линию линий линиями линии линия
именно:  именно
онлайн:  онлайн
разобрать:  разберём разобрали
округлять:  округляют округляем округлять
геометрия:  геометрии геометрия
использоваться:  используется
копирование:  копирование
рассмотреть:  рассмотреть рассмотрены
решить:  решить
разрыв:  разрыва
неоднократно:  неоднократно
выражение:  выражения
работа:  работа работе работы
сумма:  сумма сумму
производный:  производные производная производной производную
прямой:  прямой прямую прямая
дуприближённо:  дуприближённо
представительный:  представительна
предел:  предел пределах пределы пределов
новый:  новому
произвольныйтройный:  произвольныйтройной
модель:  модели модель
около:  ок
конкретный:  конкретной
асимптота:  асимптоты
дизайн:  дизайна
вычисленияопределенный:  вычисленияопределенных
больший:  большей наибольшее большим большая
это:  это
событие:  события
отблагодарить:  отблагодарить
торт:  торт
который:  которую которых которые которого который которая
повторный:  повторные
байес:  байеса
колонка:  колонки колонке
исходный:  исходного исходные
числовой:  числовые
экселе:  экселе
простой:  проще
различный:  различны различных
дисперсия:  дисперсию дисперсия дисперсии
решать:  решать
производныенеявно:  производныенеявно
таблица:  таблицу таблицы таблица таблице
эмпирический:  эмпирическая эмпирические эмпирическую эмпирической
значение:  значение значения значений значению
экстремальный:  экстремальной экстремальные
рука:  рукой
решение:  решений решением решение решения
непрерывный:  непрерывной непрерывна непрерывная непрерывны непрерывных
поляй:  поляи
точность:  точности
интеграл:  интегралы интеграла интеграл интеграле интегралов
огива:  огива огивы
опечатка:  опечатку
интервал:  интервалах интервалы интервалом интервалами интервал интервалу интервалов интервалам интервала
маленький:  маленькое
торговый:  торговую торговых
результат:  результат результаты результате результатам
унылый:  унылые
случай:  случаях случай случаев случае
математический:  математические математическая математической
теория:  теория теории
связать:  связано
близкий:  ближайшего
обработать:  обработать
вариационный:  вариационные вариационный вариационных вариационного
определять:  определяем
формула:  формулы формула
данный:  данном данный
тетрадь:  тетрадь
поступать:  поступают
статья:  статье
фнп:  фнп
подсчёт:  подсчёт
канонический:  каноническому
простейшее:  простейшие
главный:  главный главную
любимый:  любимый
гипотеза:  гипотезы гипотез гипотеза
относительный:  относительная относительных относительные
дифференциал:  дифференциалах дифференциала
двумерный:  двумерная
методомоперационный:  методомоперационного
нередко:  нередко
многие:  многие
задать:  заданной задайте
распределение:  распределении распределения распределение
инструкция:  инструкция
конец:  конце концы конца
тело:  тела
циркуляция:  циркуляция
часть:  частям
бесповторный:  бесповторной
малый:  малой малые наименьших меньших
гистограмма:  гистограмму гистограммы гистограмма
центральный:  центральных
двойной:  двойные двойной
встреча:  встреч
ошибка:  ошибку
плоскость:  плоскости плоскость
несобство:  несобств
заканчивать:  заканчивая
интервальный:  интервальное интервального интервальный
л:  л
общий:  общим общая общего
обойтись:  обойтись
нелинейный:  нелинейная
применить:  применить
измерение:  измерения
дать:  дала данные данной данная
соответствовать:  соответствующим
преобразованиеквадратичный:  преобразованиеквадратичной
определителяй:  определителяи
ясный:  ясен
число:  число числе числами числа
вогнутостья:  вогнутостьи
посему:  посему
многий:  многих
большой:  большом большого большой большое велик
вид:  виде виды виду
график:  графиков график
закон:  законы
варьироваться:  варьируются варьируется
функциональный:  функциональные
ед:  ед
графический:  графическое
потерять:  потеряно
взять:  взять возьмите
касательный:  касательных
строить:  строим строят строить
самый:  самым самое самая
качество:  качестве
последующий:  последующих
последний:  последнем последний
профессия:  профессию
условие:  условии
действие:  действий действия
построение:  построением построение построения
обводить:  обводим
устный:  устные
геометрический:  геометрическая геометрическое
абсолютный:  абсолютная
краткий:  краткая краткое
аналог:  аналогом аналог
объём:  объёму объёме объёма объемом объем
типовыхзадача:  типовыхзадач
графика:  графика графики
важный:  важного важнейший важная
умножение:  умножения
готовый:  готовый готовых
вероятность:  вероятностей вероятность вероятности
соседний:  соседние
встречаться:  встречаются встречались
совокупность:  совокупность совокупности
система:  система систему системе системы
частный:  частные частное
функция:  функций функцию функции функция
ранговойкорреляция:  ранговойкорреляции
группировка:  группировок группировка группировку
тот:  тому
условнаясходимость:  условнаясходимость
получать:  получая получаем
сложенияй:  сложенияи
уравненийв:  уравненийв
сказать:  сказано скажешь
товар:  товар товара
исследование:  исследования исследование
накопить:  накопленные
правый:  правый правой правого правые
регрессия:  регрессии регрессия
величина:  величин величина величины
свой:  свой своего свои
александр:  александр
половина:  половину
частота:  частот частоты частота частотами частоту
цена:  ценами цена цены цен
статистический:  статистический статистические статистическая
иметь:  имеют
пройти:  пройденных
типично:  типично
размах:  размах
вписываться:  вписываются
грин:  грина
суть:  сути
полный:  полное полных полной
линейный:  линейные линейная линейных линейной
исчисление:  исчисления
физический:  физические
дичь:  дичь
эйлер:  эйлера
подходящий:  подходящие подходящего
закрывать:  закрывают
согласие:  согласия
микрограмм:  микрограммами
запятая:  запятой
зачастую:  зачастую
гораздо:  гораздо
локальный:  локальная
начинать:  начиная начинаем
популярный:  популярная
ден:  ден
ожидание:  ожидание
придерживаться:  придерживаться
математика:  математики математике
такой:  таким такое такого таких такая такую
лаплас:  лапласа
перегиб:  перегиба
предыдущий:  предыдущем
сам:  самими самой
сходимость:  сходимости сходимость
дуоперационный:  дуоперационным
представить:  представьте представить
равноинтервальный:  равноинтервальную равноинтервальная
монстр:  монстры
невозможно:  невозможно
арифметический:  арифметическую
базис:  базисах базис базису
отстоять:  отстоит
поверхность:  поверхности
составить:  составить
знакочередоваться:  знакочередующиеся
вычисление:  вычислений вычисления вычисление
экономический:  экономическим экономических
задача:  задачи задаче задач задачах
навскидку:  навскидку
векторный:  векторного векторное
плотность:  плотность плотностям плотностей плотности
несколько:  нескольких
подсчитываться:  подсчитываются
константин:  константина
ду:  ду
заметно:  заметно
принцип:  принцип принципе
далее:  далее
зависимостьвектор:  зависимостьвекторов
теоретически:  теоретически
линейныйкоэффициент:  линейныйкоэффициент
делать:  делать
нахождение:  нахождении
коэффициент:  коэффициент
день:  день
неопределённый:  неопределенный неопределенном
бесконечность:  бесконечности
умолчание:  умолчанию
сначала:  сначала
метод:  методы метод методом
дробь:  дробей
пожалуй:  пожалуй
тема:  теме
страница:  страницу
магазин:  магазинах
обычный:  обычные
собственный:  собственные
упрощаться:  упрощаются
практически:  практически
аба:  абы
признак:  признак признаки
произвольный:  произвольных
смотреть:  смотрим
данные:  данных
обвести:  обвёл
сделать:  сделав
сложный:  сложной сложных сложные
единичный:  единичной единичным
ось:  оси
доступно:  доступно
пугаться:  пугаемся
искать:  искать
программный:  программные программного
вычёркивать:  вычёркиваем вычёркивать
фурье:  фурье
урок:  урока уроке
поле:  поля
поэтому:  поэтому
разложение:  разложением разложение
нужный:  нужным нужной
свойство:  свойства
практика:  практике
содержание:  содержанием
импровизированный:  импровизированной
дожить:  дожил
задавать:  задаваемые
дальнейший:  дальнейшего
попадать:  попадает
генеральный:  генеральной
икс:  икс
кусок:  кусок
ипример:  ипримеры
уравнение:  уравнению уравнений уравнения уравнение
точка:  точки точках точками точке
физика:  физику
множество:  множества
найти:  найти
оценка:  оценки оценка
проблема:  проблем проблеме
переход:  переход
вариация:  вариации
получиться:  получилось
коль:  коль
асимметрия:  асимметрия
указывать:  указывать
требоваться:  требуется требуются
комплексный:  комплексными комплексные комплексного комплексный
основа:  основы
поверхностный:  поверхностные
слишком:  слишком
книга:  книга книги
заметка:  заметку
достоинство:  достоинством
кош:  коши
координата:  координат координаты координатах
фигура:  фигуры фигура
пуассон:  пуассона
сводиться:  сводящиеся
чайник:  чайников
замена:  замены
преобразование:  преобразований преобразования
характер:  характер
вычисленияс:  вычисленияс
целесообразно:  целесообразно
пакет:  пакет
связь:  связь
кой:  кои
появляться:  появляется
понижение:  понижением понижение
матричный:  матричные матричных матричный
стык:  стык
убывать:  убывает
прибавлять:  прибавлять
заметить:  заметили
навык:  навыки
удобный:  удобные удобнее удобный
математическоеожидание:  математическоеожидание
например:  например
однородный:  однородные однородным
решенияопределённый:  решенияопределенных
записывать:  записываем записывать
вычислить:  вычислить
напрашиваться:  напрашиваются
расчётный:  расчётную
нормальный:  нормальное
школа:  школа
интегральнаятеорема:  интегральнаятеоремы
корнимногочлен:  корнимногочлена
логарифмический:  логарифмическая
матрица:  матрицу матрицы матрицами
обязательный:  обязательный
испытанияй:  испытанияи
интегралыть:  интегралыв
автоматизировать:  автоматизируем
неоднородный:  неоднородные
начать:  начнём начал начать
перегруппировка:  перегруппировка
проверять:  проверяем
правило:  правило правила
открытый:  открытыми
основной:  основные
черновой:  черновой
чай:  чая
ручной:  ручные ручной
помощь:  помощью
бернулли:  бернулли
встретиться:  встретилась встретились встретится
полярный:  полярные полярной полярных
коэффициентковариация:  коэффициентковариации
фёдор:  фёдора
штука:  штук
ряд:  ряд ряды ряда рядов
средний:  средней средняя среднюю средние
уровень:  уровня
обратный:  обратная обратную
предпосылка:  предпосылкой
думать:  думаю
вопрос:  вопросы вопрос
кратное:  кратные
количество:  количеством количество
учиться:  учимся
кухня:  кухню
партия:  партии
системудифференциальный:  системудифференциальных
мода:  моды мода
блог:  блог
доверительный:  доверительные
случайный:  случайной случайных случайные
первый:  первой первого
высокий:  высших высшей высшая
делить:  делить
рассчитывать:  рассчитываем
тон:  тоном
откладываться:  откладываются
помимо:  помимо
экселя:  экселя
среднееквадратический:  среднееквадратическое
абзац:  абзацев
успеть:  успела
абсцисса:  абсцисс
пространство:  пространстве
услуга:  услугу
пример:  примеры пример
классический:  классическом
лопиталя:  лопиталя
сурово:  сурово
называться:  называется
последовательность:  последовательностей
комбинационный:  комбинационная
должный:  должно должен
курс:  курс курсе
квадратичный:  квадратичные
обычно:  обычно
смешанноепроизведение:  смешанноепроизведение
ордината:  ординат
столбик:  столбиком
вместе:  вместе
поляформула:  поляформула
чертёж:  чертежами чертёж
проверить:  проверить
сообщить:  сообщите
фехнера:  фехнера
аналитический:  аналитическая аналитической
поскольку:  поскольку
школьный:  школьный
высота:  высота
список:  списка
левый:  левой левого
мы:  нам нами
эффективный:  эффективные
центр:  центр
изучать:  изучаемых
образ:  образом
гипергеометрическоераспределение:  гипергеометрическоераспределение
условный:  условные
непрерывнаяслучайный:  непрерывнаяслучайная
эллипс:  эллипс
ибо:  ибо
прямо:  прямо
длина:  длина длины длину длинам длин
разброс:  разброс разброса
поступить:  поступившего
сайт:  сайта сайты сайт
немного:  немного
мочь:  могут
один:  одна
знакопостоянство:  знакопостоянства
понятие:  понятие
хороший:  лучшего хорошим
равномерный:  равномерная равномерное
вычеркнуть:  вычеркнул
каждый:  каждому каждый каждую
считаться:  считается
треугольный:  треугольная
градиент:  градиент
частичный:  частичный частичных частичного частичным частичные
определение:  определения определению
мой:  моей
предлагать:  предлагают
убийственно:  убийственно
честной:  честное
десятка:  десятками десятки
использовать:  используйте использует использовать
овал:  овалами
пожалуйста:  пожалуйста
даламбер:  даламбера
влево:  влево
предложить:  предложат предложенных предложенные
ширина:  ширина
теорема:  теоремы
факт:  факт
затем:  затем
комбинаторика:  комбинаторике
случайнаявеличина:  случайнаявеличина
повторнойя:  повторнойи
попасть:  попавшие попали
денежный:  денежных
вспоминать:  вспоминаем
следовать:  следует
бесконечно:  бесконечно
знак:  знаков
лабораторный:  лабораторной
отношение:  отношению отношении
давать:  даёт
линейнойкорреляционный:  линейнойкорреляционной
указание:  указания
подынтервал:  подынтервалы
делиться:  делится
обеспечение:  обеспечения
себя:  собой
редкий:  редкая
массив:  массив
подсчитывать:  подсчитываем
время:  время времени
ранг:  ранг
квадрат:  квадратов
вариант:  варианта варианты вариант
кривая:  кривой
форма:  формы
тяжестиплоска:  тяжестиплоской
прийтись:  пришлось
отметить:  отметить
крайний:  крайних крайние крайними
сразу:  сразу
распределениякритерия:  распределениякритерий
функциюкомплексный:  функциюкомплексной
сантиметр:  сантиметры
напоминать:  напоминаю
область:  область области
проверка:  проверка
шкала:  шкалу
носить:  носит
замерять:  замерял
взвешивать:  взвешивал
ивр:  ивр
построить:  построить построенный построим построенной
несобственный:  несобственные
просто:  просто
окидывать:  окидываем
получить:  получены полученные получи
свойстваэлементарный:  свойстваэлементарных
прибавить:  прибавили
ещё:  ещё
бонус:  бонус
принимать:  принимает
считать:  считать считаю
логарифм:  логарифм
лейбниц:  лейбница
привести:  приведу приведённого привести
калькулятор:  калькулятор калькулятора калькуляторе
научиться:  научиться
теоретический:  теоретическую
выборка:  выборка выборке выборки
обывательский:  обывательское
сверка:  сверки
нестандартный:  нестандартную
составлять:  составлять
неравенство:  неравенства
пробегать:  пробегает
поток:  поток
тематический:  тематических
касательная:  касательная
задачис:  задачис
приблизить:  приблизили приближенные
карандаш:  карандаш
недавно:  недавно
разбить:  разбить
медиана:  медиана медианы
функциия:  функциии
частый:  чаще
степенной:  степенного степенные
равный:  равна
функцийдвуха:  функцийдвух
направлениюй:  направлениюи
приближать:  приближает
определённый:  определенный определенного
гостевой:  гостевая
скоро:  скоро
кумулять:  кумуляте
совпадать:  совпадающие
середина:  середины
кроме:  кроме
экстремум:  экстремумы
перечисленный:  перечисленных
горнера:  горнера
км:  км
производныефункция:  производныефункции
кумулят:  кумулята кумуляты
единица:  единице единицах
ботинок:  ботинки
функцийнесколький:  функцийнескольких
прилагаться:  прилагается
внутригрупповаяй:  внутригрупповаяи
пара:  пару
алгебра:  алгебры
плюс:  плюс
соединять:  соединяющая
ручка:  ручка
смерть:  смерть
математик:  математика
функцийв:  функцийв
переменный:  переменных переменной
точный:  точное
убеждаться:  убеждаемся
несовместный:  несовместные
недвижимость:  недвижимость
независимыеслучайный:  независимыеслучайные
множественнойлинейный:  множественнойлинейной
довольно:  довольно
существовать:  существует
анализ:  анализ анализа
размерность:  размерность
намного:  намного
некоторый:  некоторого некоторых
минус:  минус
непрерывность:  непрерывность
эксцессэмпирический:  эксцессэмпирического
ютуба:  ютуб
накопиться:  накопиться
город:  города
небольшой:  небольшое
объект:  объектов
функциис:  функциис
совпасть:  совпали
среди:  среди
зеркало:  зеркало
криволинейный:  криволинейные
относить:  относить
деньга:  деньги
пирсон:  пирсона
причислить:  причислить
библиотека:  библиотека
три:  трёх
ответ:  ответы
межгрупповой:  межгрупповая
ортогональный:  ортогональное
определяться:  определяется
дискретнойслучайный:  дискретнойслучайной
задачипо:  задачипо
видео:  видео
востребовать:  востребованную
наименьшеезначение:  наименьшеезначения
нсв:  нсв
наблюдение:  наблюдений
сила:  силы
вычислимый:  вычислим
выяснять:  выясняем
промежуточный:  промежуточными
системылинейный:  системылинейных
нужно:  нужно
какой:  какое
быстро:  быстро
графически:  графически
упасть:  упал
зависимый:  зависимые
буквально:  буквально
зависимость:  зависимость
отклонение:  отклонение
крамер:  крамера
отрезка:  отрезке
материал:  материалы материала материалов
другой:  другие другого другим
информация:  информация
произведение:  произведение
вполне:  вполне
замкнутый:  замкнутому
очевидный:  очевидно
сколько:  сколько
дуга:  дуги
отрезкать:  отрезкав
притаиться:  притаилась
отмерять:  отмеряем
дивергенция:  дивергенция
учебный:  учебном
парабола:  парабола
строго:  строго
форум:  форуме форум
показатель:  показатели
наш:  наш нашей нашем
наслаждаться:  наслаждайтесь
площадьс:  площадьс
статистика:  статистике статистика
отделение:  отделений
запретить:  запрещено
большинство:  большинстве
функциидвуха:  функциидвух
ситуация:  ситуации
емелин:  емелин
известный:  известных
площадь:  площадь
допустимый:  допустимо
причина:  причине
разбиение:  разбиение
убыванией:  убываниеи
одинаковый:  одинаковые
повышенный:  повышенной
детерминация:  детерминации
возрастание:  возрастание
также:  также
интегрирование:  интегрирование
обязательно:  обязательно
задачин:  задачина
замечательный:  замечательные
следующий:  следующие
разнообразить:  разнообразить
рациональный:  рациональные
системый:  системыи
удовлетворяетлить:  удовлетворяетли
найтись:  нашлось
состоять:  состоящая
разный:  разной разные
нарочно:  нарочно
дифференциальныеуравнение:  дифференциальныеуравнения
всякий:  всякий
заполнить:  заполним
несобственныйинтеграл:  несобственныйинтеграл
иррациональный:  иррациональных
тригонометрический:  тригонометрических
постоянный:  постоянных
промежуток:  промежутки промежутка
стокс:  стокса
квадратичнуюформ:  квадратичнуюформу
характеристика:  характеристики характеристик
схема:  схема
тактика:  тактика
карта:  карта
размер:  размеры
параметрический:  параметрической параметрическом
помидор:  помидоры
гипербола:  гипербола
быть:  будут
равно:  равно
взгляд:  взглядом
выгода:  выгоду
дробовик:  дробовик
они:  ними
оценкия:  оценкии
неявный:  неявной
снять:  снять
несобственныхинтеграл:  несобственныхинтегралов
вероятностибиномиальный:  вероятностибиномиального
вероятностия:  вероятностии
логика:  логики
спирмена:  спирмена
скалярный:  скалярное
род:  рода
гаусс:  гаусса
заданав:  заданав
порядок:  порядка порядков
всё:  всё
затруднительно:  затруднительно
значимость:  значимости
сеть:  сеть
полигон:  полигон
наглядный:  наглядное
округлить:  округлёнными
изобразить:  изобразим
тройной:  тройные
масса:  масса
логично:  логично
терминатор:  терминатора
деление:  деления
являться:  является
десятичный:  десятичный
точно:  точно
скорый:  скорых
контуруформула:  контуруформула
иной:  иной
номер:  номер
очередь:  очереди
выборочный:  выборочная
лишь:  лишь
весь:  вся всей
её:  её
занятие:  занятие
парный:  парной
св:  св
второй:  второго
нормаль:  нормали
ваш:  вашей
определитель:  определитель
выпуклость:  выпуклость
примерный:  примерный
четыре:  четырёх
элемент:  элементы
рекомендательный:  рекомендательный
достаточно:  достаточно
сборник:  сборники
похожий:  похожа
показательный:  показательное
либо:  либо
независимый:  независимые
менее:  менее
автор:  автора автор
сложность:  сложности
признаться:  признаться
диффура:  диффурами
студент:  студентам
подход:  подход
часто:  часто
оптимальный:  оптимальное
значенияй:  значенияи
отличаться:  отличаются
соответствующий:  соответствующие
изучение:  изучения
этот:  эта
весьма:  весьма
дело:  дело
усложнить:  усложнил
получаться:  получается
любой:  любом
черновик:  черновик
молоко:  молока
приличный:  приличном
находить:  находим
округление:  округлением
ломаный:  ломаная
нумерация:  нумерацию
классическоеопределение:  классическоеопределение
инормаль:  инормаль
представлять:  представляет
грамм:  грамм
корреляция:  корреляции
стерджес:  стерджеса
биномиальный:  биномиальное
слово:  слово
вписаться:  вписалась
представление:  представление
провести:  провести
пирамида:  пирамида
заочник:  заочников
помнить:  помните
внутренний:  внутренние
линиюв:  линиюв
выбрать:  выбрав
делимый:  делим
говорить:  говоря
шутка:  шутка
понимание:  понимания
повторять:  повторяем
матстат:  матстату
целое:  целого
задание:  задание
