приращение:  приращение приращения
вектор:  векторы векторов
мучиться:  мучились
переписать:  перепишите переписать
вращение:  вращения
дифференциальный:  дифференциальные
уравненияс:  уравненияс
именно:  именно
онлайн:  онлайн
смысл:  смысл
геометрия:  геометрии геометрия
копирование:  копирование
рассмотреть:  рассмотреть рассмотрим рассмотренной рассмотренных
решить:  решить
разрыв:  разрыва
работа:  работа
выражение:  выражения выражение
сумма:  сумма сумму суммы
производный:  производные производная производной производную
прямой:  прямой прямую прямая
дуприближённо:  дуприближённо
новый:  новому новыми нового
предел:  предел пределы пределов
произвольныйтройный:  произвольныйтройной
модель:  модели модель
небольшой:  небольшой небольшими небольшие
ниже:  ниже
асимптота:  асимптоты
час:  часов
дизайн:  дизайна
антиквариат:  антиквариат
это:  это этим
рулить:  рулит
событие:  события
отблагодарить:  отблагодарить
микрокалькулятор:  микрокалькуляторе микрокалькулятора микрокалькулятор
повторный:  повторные
байес:  байеса
числовой:  числовые
простой:  проще простые простой
дисперсия:  дисперсию дисперсия дисперсии
решать:  решать
производныенеявно:  производныенеявно
рассматривать:  рассматриваемое рассматриваемому рассматриваемой
пример:  примере примеры пример примеру примеров примерах
значение:  значение значения значений значению
таблица:  таблицу таблицы таблица таблице
решение:  решений решении решением решение решения
поляй:  поляи
интеграл:  интегралы интеграла интеграл интеграле интегралов
приблизить:  приближенном приближенных приближенный приближенного приближенное приближенные
находиться:  находится
опечатка:  опечатку
оценить:  оценить
получиться:  получились получится получилось получилась
результат:  результат результате
популярный:  популярному
приложение:  приложениям
теория:  теория теории
находить:  находить находим
отличный:  отличное
математический:  математические математическая математической математическими
переформулировать:  переформулировать
состоять:  состоит
обозначать:  обозначал
предлагаться:  предлагаются предлагается
речь:  речь
формула:  формулы формулам формула формулу формуле
данный:  данном данное данного
задание:  заданий задании задания заданием заданию задание
тетрадь:  тетрадь
игрек:  игрека
статья:  статье статью статьи
фнп:  фнп
колобок:  колобок колобка
хороший:  хорошее
прийтись:  придётся придется
канонический:  каноническому
простейшее:  простейшие
два:  две двух
округлить:  округлить округлён
гипотеза:  гипотезы гипотез гипотеза
близкий:  ближайшую ближе
дифференциал:  дифференциалах дифференциала дифференциалом дифференциал
двумерный:  двумерная
больший:  наибольшее
подбирать:  подбираем
методомоперационный:  методомоперационного
задать:  заданной задайте
конец:  конце
погрешность:  погрешность погрешности
часть:  частям частей часть частью
эксель:  эксель
многие:  многие
тело:  тела
циркуляция:  циркуляция
бесповторный:  бесповторной
непосредственно:  непосредственно
двойной:  двойные двойной
ошибка:  ошибку
вычислить:  вычислили вычисленному вычислить вычисленное
плоскость:  плоскости плоскость
несобство:  несобств
подводный:  подводные
перевести:  перевести
л:  л
общий:  общим общая
нелинейный:  нелинейная
применить:  применить
процент:  процента процентах процентами процентов
преобразованиеквадратичный:  преобразованиеквадратичной
стандартный:  стандартном стандартным
определителяй:  определителяи
число:  число числами числа
вогнутостья:  вогнутостьи
важно:  важно
голова:  головой голову
напрашиваться:  напрашивается
вид:  виде виды вид виду
согласно:  согласно
предварительный:  предварительного
закон:  законы
дифференцирование:  дифференцированием
выяснить:  выяснить
отвёртка:  отвертками
функциональный:  функциональные
особенность:  особенность
спокойно:  спокойно
формулировка:  формулировки
взять:  взять возьмите
касательный:  касательных
качество:  качестве
знакомый:  знакомую
профессия:  профессию
личный:  личного
тот:  той ту
геометрический:  геометрическая геометрический геометрическое
абсолютный:  абсолютная абсолютную абсолютной
графика:  графика графики
типовыхзадача:  типовыхзадач
выполнить:  выполнен
пункт:  пункт пункта
насколько:  насколько
один:  одной
умножение:  умножения
составить:  составлена составить
вероятность:  вероятностей вероятность вероятности
встречаться:  встречаются встречается встречающиеся
разный:  разными
ранговойкорреляция:  ранговойкорреляции
система:  система систему системе системы
частный:  частные частный частное
функция:  функций функцию функции функциями функция
непрерывный:  непрерывная непрерывных
группировка:  группировок группировка
условнаясходимость:  условнаясходимость
сложенияй:  сложенияи
уравненийв:  уравненийв
короткий:  короткой
самый:  самые самое
регрессия:  регрессии регрессия
величина:  величин величине величина величины
александр:  александр
остаться:  остался осталась
корень:  корни корень корнями
грин:  грина
полный:  полное полных полного полной полный
распространить:  распространенную
исчисление:  исчисления
линейный:  линейные линейная линейных линейной
который:  которые которых который которой которое
вниз:  вниз
градус:  градусах градусам градусами градусов градусы
суть:  сути
эйлер:  эйлера
приходить:  приходит
правый:  правой
применительно:  применительно
раскопать:  раскопал
обычный:  обычных обычного
согласие:  согласия
локальный:  локальная
запятая:  запятой
отрицательный:  отрицательным
ожидание:  ожидание
сколько:  сколько
математика:  математики математике
лаплас:  лапласа
перегиб:  перегиба
такой:  таким такие такое
представить:  представить представлено
присутствовать:  присутствуют
сходимость:  сходимости сходимость
дуоперационный:  дуоперационным
исследовать:  исследовать
жёсткий:  жёстким
знать:  знают
дискретный:  дискретный
базис:  базисах базис базису
вертолёт:  вертолета
поверхность:  поверхности
знакочередоваться:  знакочередующиеся
задача:  задачи задачу задаче задачах задача
вычисление:  вычислений вычислениях вычисления вычислении вычисление
векторный:  векторного векторное
несколько:  нескольких
страница:  странице страницу страницы
ду:  ду
доля:  доли
поделать:  поделать
наиболее:  наиболее
далее:  далее
зависимостьвектор:  зависимостьвекторов
линейныйкоэффициент:  линейныйкоэффициент
ограничиться:  ограничимся
обладать:  обладает
длинный:  длинные
мысль:  мысль
нахождение:  нахождении нахождения
затруднение:  затруднение
практикум:  практикум
иной:  иную
коэффициент:  коэффициент
неопределённый:  неопределенный неопределенном
гость:  гость
сначала:  сначала
метод:  методы методами методом метод
дробь:  дробей
пожалуй:  пожалуй
собственный:  собственные
предложить:  предложено предложенной
ваш:  ваш вашего ваши
несобственныйинтеграл:  несобственныйинтеграл
признак:  признак признаки
произвольный:  произвольных
смотреть:  смотрим смотрите
данные:  данных
сложный:  сложной сложного сложных сложны сложные
округление:  округления
предок:  предки
доступно:  доступно
параграф:  параграфы параграфа параграфе
повториться:  повторюсь
фурье:  фурье
учиться:  учимся
поле:  поля
поэтому:  поэтому
разложение:  разложением разложение
задавать:  задаваемые
урок:  урока уроке
свойство:  свойства
разделить:  разделить
практика:  практике
вместо:  вместо
справка:  справки
менять:  меняет
допустить:  допустить
исследование:  исследование
случай:  случая случаев случае
весь:  всем
ипример:  ипримеры
уравнение:  уравнению уравнений уравнения уравнение
точка:  точки точке
арксинус:  арксинусом
особый:  особое особых
множество:  множества
первый:  первую первая первом первого
оценка:  оценки оценка
мочь:  можете могут
переход:  переход
вариация:  вариации
требоваться:  требуется требовалось
асимметрия:  асимметрия
найти:  найти найдём найдем найденное
комплексный:  комплексными комплексные комплексного комплексный
основа:  основы
поверхностный:  поверхностные
интересный:  интересны
интервал:  интервалы
книга:  книга книги
главный:  главную
кош:  коши
основной:  основной основные
координата:  координат координаты координатах
фигура:  фигуры
представимый:  представим
очередь:  очередь
пуассон:  пуассона
сводиться:  сводящиеся
чайник:  чайников
собственно:  собственно
преобразование:  преобразований преобразования
замена:  замены
алгоритм:  алгоритма алгоритм алгоритмом
вычисленияс:  вычисленияс
краткость:  краткости
лисий:  лисьи
клавиша:  клавиши
шаблонный:  шаблонно
малый:  малые наименьших
модуль:  модуля
связь:  связь
маленький:  меньше поменьше малы
понижение:  понижением понижение
показывать:  показывает
матричный:  матричные матричных матричный
фигурировать:  фигурируют
утомиться:  утомился
фактически:  фактически
корпус:  корпус
заметить:  заметили
математическоеожидание:  математическоеожидание
дать:  данной дан данная дана
однородный:  однородные однородным
решенияопределённый:  решенияопределенных
нужный:  нужный нужна нужную нужной
например:  например
записывать:  записываем
помощь:  помощь помощью
нормальный:  нормальное
школа:  школа
очень:  очень
вернуться:  вернемся
интегральнаятеорема:  интегральнаятеоремы
куча:  кучи
удобный:  удобнее удобный удобен
хотя:  хотя
корнимногочлен:  корнимногочлена
логарифмический:  логарифмическая
курс:  курса курс курсе
матрица:  матрицу матрицы матрицами
условие:  условие условию
этап:  этапе
испытанияй:  испытанияи
интегралыть:  интегралыв
идти:  шла
сбежаться:  сбежались
точный:  точным точное точного
неоднородный:  неоднородные
необходимо:  необходимо
перегруппировка:  перегруппировка
замечать:  замечаем
правило:  правило правила
тангенс:  тангенса тангенс
пойти:  пойдёт
страждущий:  страждущих
остановиться:  остановится
бернулли:  бернулли
полярный:  полярные полярной полярных
коэффициентковариация:  коэффициентковариации
сестра:  сестра
ряд:  ряд ряды ряда рядов
серьёзный:  серьёзную
вариационный:  вариационный
уровень:  уровня уровне
обратный:  обратная обратную
второй:  второй вторая второго
думать:  думаю
вопрос:  вопросы вопрос
кратное:  кратные
нырять:  ныряйте
системудифференциальный:  системудифференциальных
готовый:  готовая готовых готово
съесть:  съели съесть
пятёрка:  пятерке
блог:  блог
соответствовать:  соответствующая
доверительный:  доверительные
высокий:  высших высшей высокой высшая
познавательный:  познавательный
среднееквадратический:  среднееквадратическое
политехнический:  политехнического
пространство:  пространстве
уметь:  уметь
абсолютно:  абсолютно
лопиталя:  лопиталя
подбор:  подбором подбор
последовательность:  последовательностей
комбинационный:  комбинационная
должный:  должно
непедагогичный:  непедагогично
квадратичный:  квадратичные
обычно:  обычно
начинающий:  начинающим
смешанноепроизведение:  смешанноепроизведение
объём:  объем
транспорт:  транспорт
проверить:  проверить
поляформула:  поляформула
тригонометрический:  тригонометрической тригонометрическая тригонометрических
сообщить:  сообщите
перейти:  перейдем
сделать:  сделать сделано
линия:  линиями линии линия
фехнера:  фехнера
попытаться:  попытаюсь
аналитический:  аналитическая аналитической
вычислительный:  вычислительной
поскольку:  поскольку
школьный:  школьный школьная
эффективный:  эффективные
мы:  нам нами
центр:  центр
образ:  образом
гипергеометрическоераспределение:  гипергеометрическоераспределение
условный:  условные
непрерывнаяслучайный:  непрерывнаяслучайная
другой:  других другие
различный:  различными различных
эллипс:  эллипс
делать:  делать
обратить:  обратите обратит обратили
длина:  длина
материал:  материал материалы материалов
сайт:  сайта сайты сайт
немного:  немного
знакопостоянство:  знакопостоянства
агрегат:  агрегата
равномерный:  равномерная равномерное
иначе:  иначе
треугольный:  треугольная
заметный:  заметными
градиент:  градиент
похожий:  похожей
определение:  определения определению
полагать:  полагаем
использовать:  используйте используя использовать используем
пожалуйста:  пожалуйста
даламбер:  даламбера
приближение:  приближение
сторона:  сторону
теорема:  теоремы
аргумент:  аргументов аргумента аргументом
комбинаторика:  комбинаторике
случайнаявеличина:  случайнаявеличина
повторнойя:  повторнойи
построение:  построение
естественно:  естественно
следовать:  следует
бесконечно:  бесконечно
знак:  знаков знак
сложность:  сложностей сложности
линейнойкорреляционный:  линейнойкорреляционной
водиться:  водился
действие:  действия
обеспечить:  обеспечил
туда:  туда
записать:  записано
скалькулировать:  скалькулированное
квадрат:  квадратов
ранг:  ранг
подчистить:  подчищены
время:  время времена времени
кривая:  кривой
форма:  формы
тяжестиплоска:  тяжестиплоской
отметить:  отметить
наивный:  наивная
хвостик:  хвостиком
сразу:  сразу
распределениякритерия:  распределениякритерий
функциюкомплексный:  функциюкомплексной
возвести:  возведите
дальнейший:  дальнейшее
относительный:  относительную относительная относительной
область:  область области
проверка:  проверка
коротенький:  коротенький
радиан:  радианы
построить:  построить
рабочий:  рабочую рабочая
несобственный:  несобственные
просто:  просто
видеть:  видим видел видите вижу
мода:  мода
свойстваэлементарный:  свойстваэлементарных
получить:  получены получи
размер:  размером
ещё:  ещё
считать:  считать
сохраняться:  сохраняется
внимание:  внимание
калькулятор:  калькулятор калькулятора калькуляторе
лейбниц:  лейбница
проситься:  просится
научиться:  научиться
релаксация:  релаксации
стереться:  сотрутся
год:  году
неравенство:  неравенства
наш:  наше наш нашей наши
вышеупомянутый:  вышеупомянутом
поток:  поток
быть:  буду будут будем
сформулировать:  сформулировано
похоже:  похоже
касательная:  касательная
ответ:  ответ ответы
задачис:  задачис
предыдущий:  предыдущего предыдущих
буква:  букву
эквивалентный:  эквивалентное
посмотреть:  посмотрите
медиана:  медиана
обращать:  обращаю
принять:  принять
расчёт:  расчётах
функциия:  функциии
возможно:  возможно
степенной:  степенного степенные
функцийдвуха:  функцийдвух
направлениюй:  направлениюи
определённый:  определенный определенного
выборка:  выборке
читатель:  читателей
единственный:  единственное
гостевой:  гостевая
камень:  камни
перевод:  перевода
двойка:  двойке
действительно:  действительно
богатство:  богатство
просмотреть:  просмотреть
распределение:  распределения распределение
кроме:  кроме
экстремум:  экстремумы
тысячная:  тысячные
постараться:  постараюсь
горнера:  горнера
отмечаться:  отмечалось
производныефункция:  производныефункции
средний:  средняя
говорить:  говорить говоря
понятно:  понятно
единица:  единице
функцийнесколький:  функцийнескольких
домножения:  домножения
случайно:  случайно
ориентир:  ориентир
возникнуть:  возникнуть возник
переводить:  переводим
заслать:  зашли
внутригрупповаяй:  внутригрупповаяи
конный:  конная
пара:  пару
алгебра:  алгебры
сила:  силами силы
далеко:  далеко
придерживаться:  придерживаемся
математик:  математика
функцийв:  функцийв
переменный:  переменных переменная переменной
иллюстрировать:  иллюстрирует
нудноватый:  нудноватый
освещёный:  освещёны
несовместный:  несовместные
средство:  средств
половина:  половины
независимыеслучайный:  независимыеслучайные
множественнойлинейный:  множественнойлинейной
оправдать:  оправдать
существовать:  существует
анализ:  анализ анализа
следовательно:  следовательно
намного:  намного
начинать:  начинаем
прямоугольник:  прямоугольников
непрерывность:  непрерывность
эксцессэмпирический:  эксцессэмпирического
отклониться:  отклонился
рассчитывать:  рассчитывать
город:  города
функциис:  функциис
лёгкий:  легче
зеркало:  зеркало
криволинейный:  криволинейные
пирсон:  пирсона
библиотека:  библиотека
три:  трёх
межгрупповой:  межгрупповая
ортогональный:  ортогональное
трудность:  трудностей
дискретнойслучайный:  дискретнойслучайной
задачипо:  задачипо
комната:  комнату
востребовать:  востребованную
наименьшеезначение:  наименьшеезначения
нсв:  нсв
начать:  начните начать
вычислимый:  вычислим
запросто:  запросто
протяжение:  протяжении
большой:  велики
очевидный:  очевидную
старший:  старшая
согласный:  согласен
разница:  разницы
иллюстрация:  иллюстрация
вариант:  вариант
системылинейный:  системылинейных
смело:  смело
нужно:  нужно
вроде:  вроде
повозка:  повозка
любить:  люблю
анализировать:  анализируя
образец:  образец
какой:  какое
упасть:  упал
примечание:  примечание
чистовой:  чистового
прибавиться:  прибавилась
аккуратный:  аккуратным
зависимый:  зависимые
прочитать:  прочитать
зависимость:  зависимость
отклонение:  отклонение
крамер:  крамера
рассчитываться:  рассчитываются
отрезка:  отрезке
произведение:  произведение
вполне:  вполне
физика:  физики
случайный:  случайных случайные
кто:  кому
важный:  важный важное
замкнутый:  замкнутому
древний:  древние
освоение:  освоения
начало:  начале
распечатать:  распечатал
дуга:  дуги
отрезкать:  отрезкав
дивергенция:  дивергенция
левый:  левую
правда:  правда
парабола:  парабола
строго:  строго
форум:  форуме форум
показатель:  показатели
следующий:  следующий следующей
мизерный:  мизерной
оформление:  оформления
оказать:  окажет
приближённо:  приближенно
отличие:  отличие
площадьс:  площадьс
функциидвуха:  функциидвух
ранее:  ранее
большинство:  большинстве
подробный:  подробнее
статистический:  статистические статистическая
таков:  такова
кубический:  кубический
емелин:  емелин
широко:  широко
причина:  причине
закономерность:  закономерность
убыванией:  убываниеи
вычисленияопределенный:  вычисленияопределенных
повышенный:  повышенной
возрастание:  возрастание
эмпирический:  эмпирические
детерминация:  детерминации
также:  также
интегрирование:  интегрирование
подсчитать:  подсчитать
задачин:  задачина
замечательный:  замечательные
рациональный:  рациональные
системый:  системыи
удовлетворяетлить:  удовлетворяетли
найтись:  нашлось
нелады:  нелады
полезный:  полезный
разбираться:  разбираться
потребоваться:  потребуется
дифференциальныеуравнение:  дифференциальныеуравнения
приходиться:  приходится
иррациональный:  иррациональных
некоторый:  некоторых
располагаться:  располагается
интервальный:  интервальный
отдохнуть:  отдохнул
постоянный:  постоянных
квадратичнуюформ:  квадратичнуюформу
стокс:  стокса
заменять:  заменяя
схема:  схема
карта:  карта
институт:  института
нацело:  нацело
параметрический:  параметрической параметрическом
итак:  итак
обозначаться:  обозначается
гипербола:  гипербола
среднее:  среднем
запретить:  запрещено
равно:  равно
степень:  степень
парта:  парту
радиолюбитель:  радиолюбители
дробовик:  дробовик
они:  ними
оценкия:  оценкии
неявный:  неявной
обозначение:  обозначение обозначения
несобственныхинтеграл:  несобственныхинтегралов
вероятностибиномиальный:  вероятностибиномиального
сам:  самом
заглядывать:  заглядывать
местный:  местного
произойти:  произошло
вероятностия:  вероятностии
логика:  логики
дно:  дну
род:  рода
заданав:  заданав
скалярный:  скалярное
спирмена:  спирмена
гаусс:  гаусса
компьютер:  компьютер
выраженный:  выражен
тип:  типе
порядок:  порядка порядков
всё:  всё
значимость:  значимости
технический:  технических
честно:  честно
тройной:  тройные
возникать:  возникает
деление:  деления
являться:  является
хитрость:  хитрости
заключительный:  заключительный
контуруформула:  контуруформула
аплодисменты:  аплодисменты
точно:  точно
экстремальный:  экстремальные
график:  график
близко:  близко
дело:  деле дело
её:  её
св:  св
парный:  парной
успешный:  успешного
нормаль:  нормали
иметь:  имеет
целый:  целую
определитель:  определитель
извлекаться:  извлекался
выпуклость:  выпуклость
примерный:  примерный
элемент:  элементы
достаточно:  достаточно
сборник:  сборники
показательный:  показательное
версия:  версия
рассмотрение:  рассмотрением
рекомендовать:  рекомендую
независимый:  независимые
выбросить:  выбросили
менее:  менее
принципиально:  принципиально
автор:  автора автор
физмат:  физмате
зет:  зет
диффура:  диффурами
часто:  часто
формальный:  формальным
значенияй:  значенияи
относиться:  относится
изучение:  изучения
привести:  привести
этот:  эта
справедливый:  справедлива
весьма:  весьма
глупый:  глупая
работать:  работаем
получаться:  получается
всякий:  всякие
кстати:  кстати
классическоеопределение:  классическоеопределение
инормаль:  инормаль
статистика:  статистика
корреляция:  корреляции
представлять:  представляет
точность:  точность
биномиальный:  биномиальное
вышесказанный:  вышесказанному
интуитивно:  интуитивно
дойти:  дошла
заочник:  заочников
пирамида:  пирамида
вышеприведённый:  вышеприведенный
линиюв:  линиюв
фантастически:  фантастически
самостоятельный:  самостоятельного
отношение:  отношении
повторять:  повторяем
второе:  второе
