разница:  разницей разница
частный:  частным частное частные
присущий:  присущий
третий:  третьим третий
новый:  новых новой новому
сколь:  сколь
нижеследующий:  нижеследующей
математический:  математических математическая математического математическому математические математическом математической
неоднократно:  неоднократно
чередоваться:  чередующихся
производный:  производные производная производной производную
предел:  предел пределы пределов пределом предела пределе пределу пределах
слагаемое:  слагаемые слагаемых
графомания:  графомания
микроскопический:  микроскопической
числовой:  числовые числовой числовыми числовая числовых
производныенеявно:  производныенеявно
значение:  значение значениям значению значения
обозначать:  обозначают
небольшой:  небольшого
формула:  формулы формулой формуле формула формулу
время:  времён
безудержный:  безудержных
канонический:  каноническому
стремиться:  стремиться стремится
два:  две двумя двух
дифференциал:  дифференциалах дифференциала
самый:  самых самым самый
больший:  наибольшее большими наибольшим
многие:  многие
отдельный:  отдельных
подробный:  подробные
правильность:  правильность
любой:  любому любой любая любую любом
избавляться:  избавляемся
револьвер:  револьвер
число:  число числами числу чисел числа
вогнутостья:  вогнутостьи
становиться:  становится
строгий:  строгое
случай:  случай случая случае
упрощать:  упрощаем
лишний:  лишнее
профессия:  профессию
пусть:  пусть
умножение:  умножения
составить:  составлена составило
система:  система системе систему системы
группировка:  группировок группировка
он:  нему нём
условнаясходимость:  условнаясходимость
александр:  александр
душа:  душу
конечный:  конечный конечное конечному
неожиданный:  неожиданные
который:  которые которому который которая которое которого которых которой
последовательность:  последовательностями последовательностью последовательности последовательностей последовательность
линейный:  линейные линейная линейных линейной
схожий:  схожая
согласие:  согласия
эквивалентность:  эквивалентности эквивалентность
арифметический:  арифметической арифметическая арифметическую
отметка:  отметку
нечётный:  нечётных нечётной
знать:  знают зная
дуоперационный:  дуоперационным
ленивый:  ленивая
пример:  примером пример примеру примера примеров примерам примере примерах примеры
пригодиться:  пригодится
класс:  классах классе
базис:  базисах базису базис
никто:  никто
прорешать:  прорешанных
пригласить:  пригласим
зависимостьвектор:  зависимостьвекторов
домножать:  домножаем
неделя:  неделя
снова:  снова
оно:  оно
сначала:  сначала
метод:  методы методом метод
страница:  страницу
числитель:  числителе числитель числителя
смотреть:  смотрим смотрит смотрите
данные:  данных
интеграл:  интеграл интегралов интегралы интеграла интеграле
урок:  урока уроков урок уроке
похожий:  похожее похожие похожий похожи
разложение:  разложением разложение
расходиться:  расходится расходящейся
синус:  синус
икс:  икс
уравнение:  уравнению уравнения уравнение уравнений
личность:  личности
переход:  переход
экстравагантный:  экстравагантные
плавно:  плавно
раздел:  разделов
знакочередование:  знакочередование
желательно:  желательно
оставить:  оставив
затрагивать:  затрагивает
виноватый:  виновата
малый:  малые малых малую малой наименьших малая
связь:  связь
произведение:  произведении произведения произведение произведений
нормальный:  нормальное
интегральнаятеорема:  интегральнаятеоремы
корнимногочлен:  корнимногочлена
логарифмический:  логарифмическая
оформлять:  оформляем
начать:  начнём начать начните
основной:  основные
применяться:  применяется
соответствовать:  соответствующей
бернулли:  бернулли
единица:  единицу единице единиц
полярный:  полярные полярных полярной
рассмотреть:  рассмотрим рассмотренном рассмотренных
ряд:  ряды ряда ряд рядов
уровень:  уровня уровне
панк:  панки
определённый:  определённого определённом определенный определенного
значительно:  значительно
попросту:  попросту
доверительный:  доверительные
среднееквадратический:  среднееквадратическое
коротко:  коротко
неопределённость:  неопределённость неопределённости
комбинационный:  комбинационная
распространить:  распространена распространённая распространённые
смешанноепроизведение:  смешанноепроизведение
функция:  функции функция функций функцию функциях
дисперсия:  дисперсия дисперсии дисперсию
рассчитываться:  рассчитывается
флудёр:  флудером
школьный:  школьный
раскрутить:  раскрутить
образ:  образом
выбирать:  выбираем
чудовище:  чудовище
непрерывнаяслучайный:  непрерывнаяслучайная
другой:  других другая другому другие
четыре:  четыре
единственно:  единственно
длина:  длина
материал:  материал материалов материалы
мочь:  могут
знакопостоянство:  знакопостоянства
дрожжи:  дрожжах
градиент:  градиент
сердце:  сердцах
расположить:  расположен расположено
линия:  линия линии линиями
вспомнить:  вспомним
ясно:  ясно
комбинаторика:  комбинаторике
случайнаявеличина:  случайнаявеличина
свой:  своего своей свои свой своему
бесконечно:  бесконечно
сообщество:  сообщества
форма:  формы
факториал:  факториалами факториалы факториал
статья:  статьи статья статье статью
матана:  матану матана
обратный:  обратную обратная
модуль:  модулей модуля
целое:  целое
готовый:  готовых готово
конкретный:  конкретном конкретному конкретный
просто:  просто
приём:  приём приёмы
ещё:  ещё
знакочередоваться:  знакочередующейся знакочередующиеся
спать:  спать
быть:  буду будут
соперник:  соперника
тема:  тема
чистосердечный:  чистосердечного
частый:  чаще
мигалка:  мигалкой мигалка мигалки
высокий:  высокого высших высшей высшая
данный:  данного данную данном
непрерывный:  непрерывных непрерывная
перечисленный:  перечисленных
производныефункция:  производныефункции
средний:  средняя средних
замечательный:  замечательную замечательный замечательные
обязать:  обязан
дискретность:  дискретности
область:  области область
последний:  последние последнем последний последним
подобрать:  подобрать
плюс:  плюс
математик:  математика
переменный:  переменных переменной переменная
несовместный:  несовместные
буква:  буквы букве
независимыеслучайный:  независимыеслучайные
посвящёный:  посвящёна
модель:  модель модели
непрерывность:  непрерывность
минус:  минус
основательный:  основателен
присвоить:  присвоить
содержать:  содержит
способ:  способами способ
танец:  танец
добавляться:  добавляется
список:  список
функциис:  функциис
угодный:  угодно
полный:  полной полных полное
зеркало:  зеркало
уменьшать:  уменьшать
значит:  значит
пирсон:  пирсона
член:  члены члена член членом членов члену
вопрос:  вопрос вопросы
аналогичный:  аналогичные аналогичная
межгрупповой:  межгрупповая
ортогональный:  ортогональное
инцидент:  инцидент
располагаться:  располагаются располагается
нсв:  нсв
ясность:  ясности
убывать:  убывающая убывающей убывающую
бесконечный:  бесконечное бесконечен бесконечный
оформить:  оформим
вроде:  вроде
отличие:  отличия отличие
почленный:  почленное
упасть:  упал
ход:  ходе ходом
некоторый:  некоторому некоторым
отрезка:  отрезке
величина:  величина величин величинах величины
важный:  важный важным
внимательно:  внимательно
запись:  запись
летний:  летних
она:  неё
детерминация:  детерминации
действительный:  действительному действительное
заглянуть:  заглянем
цифра:  цифр
принципиальный:  принципиальные
следующий:  следующие следующим следующая следующий
дифференциальныеуравнение:  дифференциальныеуравнения
название:  названия названием
сеть:  сети
надёжный:  надёжен
прямой:  прямая прямой прямую
свойственный:  свойственны
постоянный:  постоянных
стокс:  стокса
схема:  схема схеме
соответствие:  соответствие
окрестность:  окрестность окрестности
дробовик:  дробовик
сущность:  сущности
получить:  получен получено получить полученная получи
математика:  математике математики
векторный:  векторное векторного
сам:  самом самим сама самой
зайти:  зайти
подготовить:  подготовленные
нечто:  нечто
вероятностия:  вероятностии
совладать:  совладать
скалярный:  скалярное
задание:  заданиях
наш:  нашем наше наш нашего
понятный:  понятен
значимость:  значимости
мысленно:  мысленно
функциональный:  функциональных функциональные
знатный:  знатной
анализ:  анализа анализ
её:  её
парный:  парной
показательный:  показательные показательное показательными
ободряюще:  ободряюще
несколько:  несколько
найти:  найдём найти
сборник:  сборники сборнику
параметрический:  параметрическом параметрической
делать:  делаем
часто:  часто
человек:  человек людям людей
ограниченный:  ограниченной ограниченные
увлекательный:  увлекательное увлекательный
получаться:  получается получаются
энный:  энным энный энного
какой:  какие
надеяться:  надеюсь
почерк:  почерк
решение:  решение решением решения решений
место:  место местами
проиллюстрировать:  проиллюстрировано
форум:  форум форуме
книга:  книги книга
дежурный:  дежурных
провести:  провести проведём
случаем:  случаем
теоретический:  теоретического
вынести:  вынести вынесем
проанализировать:  проанализируем
водопой:  водопою
вектор:  векторы векторов
заработать:  заработать
справедливый:  справедлив справедливы справедлива
наподобие:  наподобие
вращение:  вращения
именно:  именно
копирование:  копирование
давать:  давайте
поезд:  поезде
читать:  читать
разрыв:  разрыва
один:  одного одна одной
выражение:  выражения выражение
четвёртый:  четвертый
совпадать:  совпадает
роль:  роль
отблагодарить:  отблагодарить
являться:  являются является
байес:  байеса
простой:  проще простых
решать:  решать
результат:  результат результате
теория:  теория теории
контрольный:  контрольным контрольный
признание:  признания
проверить:  проверьте проверить
нулевой:  нулевым
вымучивать:  вымучиваем
называть:  называют называемую
двумерный:  двумерная
задать:  заданной задайте задана
тело:  тела
циркуляция:  циркуляция
плоскость:  плоскости плоскость
незаслуженно:  незаслуженно
общий:  общим общая общий общем общего
странно:  странно
стандартный:  стандартном стандартный стандартное
определителяй:  определителяи
мир:  мир
эстет:  эстетов
выносить:  выносим
выступать:  выступает
синий:  синюю
хвост:  хвост
дважды:  дважды
закон:  законы
счётчик:  счётчика
первый:  первым первых первая первом первого первый первые
справа:  справа
дробь:  дроби дробь дробей
рассматривать:  рассматривают рассматриваемая
заменимый:  заменим
качество:  качестве
коррекционный:  коррекционной
волшебный:  волшебный
действие:  действий действия действие
ситуация:  ситуацию ситуация ситуаций
вероятность:  вероятностей вероятность вероятности
заключение:  заключение
уравненийв:  уравненийв
множитель:  множитель множителем
остаться:  остался останутся
переписать:  переписать
грин:  грина
суть:  сути
эйлер:  эйлера
возможный:  возможный возможны
известный:  известной
дискретный:  дискретный дискретного дискретна дискретной
заметно:  заметно
делить:  делённая делить
ладонь:  ладоней
история:  историю
бесконечность:  бесконечности
голова:  голову
произвольный:  произвольных произвольному
сложный:  сложной посложнее сложного сложнее сложные сложных
фурье:  фурье
поле:  поля
гипотеза:  гипотез гипотеза гипотезы
заранее:  заранее
свойство:  свойства
исследование:  исследование исследования
здравый:  здравый
точка:  точки точке
прыгать:  прыгают прыгать
вариация:  вариации
основа:  основы
интервал:  интервалы
кош:  коши
параграф:  параграфа
выше:  выше
чайник:  чайников чайник
вычисленияс:  вычисленияс
разобрать:  разобраны разобрать разберём
появляться:  появляется
матричный:  матричные матричных матричный
сокращение:  сокращения
заметить:  заметили
однородный:  однородные однородным
записывать:  записываем
вычислить:  вычислить
очень:  очень
матрица:  матрицу матрицы матрицами
испытанияй:  испытанияи
интегралыть:  интегралыв
перегруппировка:  перегруппировка
практический:  практической
монитор:  монитора
вглубь:  вглубь
помощь:  помощью помощь
сходиться:  сходящейся
вариационный:  вариационный
элементарный:  элементарных элементарный
добраться:  добраться
исключение:  исключением
блог:  блог
школа:  школы школа
возникнуть:  возникнет
единственный:  единственной единственном
пространство:  пространстве
необыкновенно:  необыкновенно
удобный:  удобный удобное
путь:  путь
курс:  курс курсе курсу
координата:  координаты координат координатах
сообщить:  сообщите
сделать:  сделать
аналитический:  аналитическая аналитической
понижение:  понижение понижением
выражаться:  выражается
центр:  центр
прогрессия:  прогрессий прогрессией прогрессии прогрессия прогрессию
узнать:  узнаем узнать
чётный:  чётных чётной
каждый:  каждому каждый
считаться:  считается
инженерный:  инженерный
быстрый:  быстрее
сторона:  сторону
построение:  построение
характерный:  характерны характерные характерна
линейнойкорреляционный:  линейнойкорреляционной
существенно:  существенно
учёба:  учёбе
разоблачение:  разоблачения
почему:  почему
распределениякритерия:  распределениякритерий
дальнейший:  дальнейшее дальнейшему
уверенный:  уверенным
беспокоиться:  беспокойтесь
аргумент:  аргумента аргументы аргумент
несобственный:  несобственные
абзац:  абзац
выполнять:  выполнять выполняем
выбрать:  выбранной
зрение:  зрения
говорить:  говорил говорят
подойти:  подошло подошли
полностью:  полностью
зайчик:  зайчик
конкуренция:  конкуренцию
касательная:  касательная
ответ:  ответ ответы
задачис:  задачис
разобраться:  разобраться разберёмся
правило:  правила правилу правило
функциия:  функциии
возможно:  возможно
степенной:  степенного степенные
функцийдвуха:  функцийдвух
выборка:  выборке
погулять:  погулять
функцийнесколький:  функцийнескольких
популярный:  популярных
поставить:  поставлено
рост:  роста
деление:  деление деления
множественнойлинейный:  множественнойлинейной
изолировать:  изолированных
распределение:  распределение распределения
задавать:  задаёт задаваемые
этот:  этому
график:  графиках график
задачипо:  задачипо
востребовать:  востребованную
термин:  термин
шестёрка:  шестёрка
приблизить:  приближенные
вконтакте:  вконтакте
скрипка:  скрипка
файл:  файл
примечание:  примечание
микрокалькулятор:  микрокалькулятор
выкладка:  выкладки
зависимый:  зависимые
отклонение:  отклонение
избавиться:  избавиться
таблица:  таблицы
случайный:  случайных случайные
ограничить:  ограничены ограничена
изучать:  изучает
дуга:  дуги
частность:  частности
перебрать:  перебрать
отрезкать:  отрезкав
играть:  играет
дивергенция:  дивергенция
пометка:  пометки
порядковый:  порядковый
уничтожать:  уничтожает
сайт:  сайт сайты сайта
графика:  графики графика
путешествие:  путешествие
ехать:  едет
идти:  идёт
причина:  причине
возрастание:  возрастание
эмпирический:  эмпирические
подставить:  подставим подставьте
найтись:  нашлось
арктангенс:  арктангенса арктангенс
аналогично:  аналогично
потребоваться:  потребуется
обратиться:  обратитесь обратиться
выстрел:  выстрел выстрелом
иррациональный:  иррациональных
определение:  определению определением определение определения
квадратичнуюформ:  квадратичнуюформу
сокращать:  сокращаем
карта:  карта
вычисление:  вычисления вычисление
зажимать:  зажимает
гипербола:  гипербола
пощада:  пощады
равно:  равно
они:  ними
логика:  логики
спирмена:  спирмена
формальный:  формальной
вид:  виду виды виде
номер:  номеров номер номера
патрон:  патрон
определять:  определяет
рекуррентный:  рекуррентной
вовсе:  вовсе
очередь:  очереди
близко:  близко
лишь:  лишь
клавиатура:  клавиатуре
св:  св
второй:  второго второй вторым
сумма:  суммы сумме сумму сумма
коснуться:  коснёмся
предыдущий:  предыдущих предыдущий предыдущие
прокатывать:  прокатывает
отличный:  отличную
достаточно:  достаточно
преобразование:  преобразования преобразований
универсальный:  универсальным
просить:  просит
кузнецов:  кузнецова
диффура:  диффурами
почленно:  почленно
относиться:  относится
пользоваться:  пользуясь
соответствующий:  соответствующие
скобка:  скобок скобки
косинус:  косинуса
множество:  множество множества
использовать:  используем используя использовать используйте
представлять:  представляет
статистика:  статистика
заурядный:  заурядные
биномиальный:  биномиальное
построить:  построенной построить
линиюв:  линиюв
самостоятельный:  самостоятельного
отношение:  отношении
тройка:  троек
продвигаться:  продвигаются
смысл:  смысл
окно:  окно
шаг:  шагом шаге шаг
использоваться:  использоваться
решить:  решить
дуприближённо:  дуприближённо
информация:  информации
асимптота:  асимптоты
событие:  события
бывало:  бывало
повторный:  повторные
зазорно:  зазорно
квадратность:  квадратностью
основание:  основанием
состоять:  состоит
тропа:  тропе
тетрадь:  тетрадь
фнп:  фнп
чат:  чата
простейшее:  простейшие
знаменатель:  знаменателя знаменатель знаменателе
иметь:  имели
часть:  частям части
изучить:  изучите
общество:  обществе
двойной:  двойные двойной
несобство:  несобств
нелинейный:  нелинейная
применить:  применить
квадратный:  квадратные
преобразованиеквадратичный:  преобразованиеквадратичной
заходить:  заходить
комментарий:  комментарии
геометрический:  геометрическая геометрическую геометрической геометрическое
абсолютный:  абсолютная
встречаться:  встречаются встречалась
натуральный:  натуральных натуральному натуральным натуральные натурального
тот:  тому той
сложенияй:  сложенияи
повторяться:  повторяться
фигурировать:  фигурирует
регрессия:  регрессии регрессия
увеличение:  увеличения
исчисление:  исчисления
степень:  степеней степени
локальный:  локальная
константа:  константа
сказать:  сказать
ожидание:  ожидание
лаплас:  лапласа
такой:  таким такие такое такая
перегиб:  перегиба
сходимость:  сходимости сходимость
задача:  задачи задач задачах задача
создавать:  создаёт
ду:  ду
далее:  далее
копирка:  копирку
коэффициент:  коэффициент
неопределённый:  неопределенный неопределенном
прадедушка:  прадедушку
собственный:  собственные
признак:  признак признаки
стягивать:  стягивая
поэтому:  поэтому
практика:  практике
разделить:  разделить
вместо:  вместо
постучаться:  постучался
разумеется:  разумеется
решаться:  решаются
противный:  противном
асимметрия:  асимметрия
скажем:  скажем
главный:  главную
сводиться:  сводящиеся
собственно:  собственно
замена:  замены
пятый:  пятый
маленький:  меньше мала мал
убрать:  убрать
например:  например
решенияопределённый:  решенияопределенных
знакомый:  знакомы
задаваться:  задаётся
показатель:  показателей показатели
тангенс:  тангенса
вверху:  вверху
частенько:  частенько
коэффициентковариация:  коэффициентковариации
четырёхэтажность:  четырёхэтажностью
ограниченность:  ограниченность
достать:  достать
задуматься:  задумаемся
теорема:  теореме теоремы теорема
приводить:  приводить приводим
лопиталя:  лопиталя
называться:  называется
обычно:  обычно
отвлечься:  отвлечёмся
поменять:  поменять поменяет
недопонимание:  недопонимание
поляформула:  поляформула
наверное:  наверное
фехнера:  фехнера
эффективный:  эффективные
пронестись:  пронесёмся
разряд:  разрядов
мелкий:  мелкие
условный:  условные
воспоминание:  воспоминаний
эллипс:  эллипс
продвинуться:  продвинемся
незамысловатый:  незамысловатую
отдыхать:  отдыхают
хороший:  лучшего
количество:  количество
даламбер:  даламбера
обеспечивать:  обеспечивающий
повторнойя:  повторнойи
естественно:  естественно
комплексный:  комплексные комплексного комплексный комплексными
ранг:  ранг
кривая:  кривой
тяжестиплоска:  тяжестиплоской
относительно:  относительно
положительный:  положительных
проверка:  проверка
эквивалентный:  эквивалентной
лейбниц:  лейбница
судьба:  судьба
абракадабра:  абракадаброй
неравенство:  неравенства
палец:  пальцами
поток:  поток
расписать:  распишем расписать
медиана:  медиана
полезный:  полезные
бывать:  бывает
направлениюй:  направлениюи
стильный:  стильный
гостевой:  гостевая
многочлен:  многочлены
устать:  устали
двойка:  двойке
кроме:  кроме
равный:  равен
понятно:  понятно
динамический:  динамическая
вывод:  вывод
главное:  главное
отнюдь:  отнюдь
внутригрупповаяй:  внутригрупповаяи
пара:  пару
алгебра:  алгебры
разогреться:  разогреется
направить:  направлен
невероятно:  невероятно
метание:  метаниях
существовать:  существует
свёрнутый:  свёрнутая
слово:  словом слову
прямоугольник:  прямоугольников
эксцессэмпирический:  эксцессэмпирического
ребро:  рёбрами
оценка:  оценка оценки
криволинейный:  криволинейные
различный:  различных
устранение:  устранения
приближаться:  приближаясь приближаться
библиотека:  библиотека
идея:  идея
сохранить:  сохранил
год:  года
старший:  старшей
наименьшеезначение:  наименьшеезначения
сила:  силы
собраться:  собрался
рассказывать:  рассказывал
системылинейный:  системылинейных
нужно:  нужно
боевой:  боевые
организовать:  организовать
зависимость:  зависимость
интересный:  интересного
возвращать:  возвращает
пять:  пять
замкнутый:  замкнутому
должный:  должен должно
очевидный:  очевидно
хулиган:  хулиганы
единичка:  единичку
немедленно:  немедленно
латинский:  латинские
площадьс:  площадьс
заветный:  заветное
убыванией:  убываниеи
повышенный:  повышенной
статистический:  статистическая статистические
одинаковый:  одинаковых
также:  также
интегрирование:  интегрирование
легко:  легко
рациональный:  рациональные
осмысление:  осмысления
читатель:  читателям
пока:  пока
нуль:  нулю нуля
интервальный:  интервальный
соответственно:  соответственно
арккотангенс:  арккотангенс
рука:  руку
вообще:  вообще
оценкия:  оценкии
неявный:  неявной
несобственныхинтеграл:  несобственныхинтегралов
вероятностибиномиальный:  вероятностибиномиального
род:  рода
гаусс:  гаусса
начинать:  начинайте
впрямь:  впрямь
точно:  точно
экстремальный:  экстремальные
достойный:  достойную
нормаль:  нормали
определитель:  определитель
желать:  желающие
выпуклость:  выпуклость
элемент:  элементы
социальный:  социальной
принципиально:  принципиально
сложность:  сложности
значенияй:  значенияи
отличаться:  отличаются
вывести:  выведено
нужный:  нужной
кстати:  кстати
подсказывать:  подсказывают
жаргон:  жаргоне
классическоеопределение:  классическоеопределение
инормаль:  инормаль
далёкий:  дальше
пирамида:  пирамида
автор:  автор автора
делимый:  делим
приступить:  приступить
выйти:  вышел
оказаться:  окажется
цель:  целях
дифференциальный:  дифференциальные
уравненияс:  уравненияс
онлайн:  онлайн
геометрия:  геометрии геометрия
работа:  работа
рано:  рано
произвольныйтройный:  произвольныйтройной
разложить:  разложить
дизайн:  дизайна
это:  это
вечный:  вечного
поляй:  поляи
опечатка:  опечатку
раскладывать:  раскладывают
выгодный:  выгоднее
неудивительный:  неудивительно
речь:  речь
повезти:  повезло
увеличиваться:  увеличивается
методомоперационный:  методомоперационного
базовый:  базовых
подтолкнуть:  подтолкнуло
бесповторный:  бесповторной
граффити:  граффити
ошибка:  ошибку
л:  л
вокруг:  вокруг
измениться:  изменилось
важно:  важно
поздно:  поздно
большой:  большого большой велика
внизу:  внизу
касательный:  касательных
типовыхзадача:  типовыхзадач
подруга:  подругу
ранговойкорреляция:  ранговойкорреляции
жизненный:  жизненных
жизнь:  жизни
конец:  концу конца
подметить:  подметили
разделаться:  разделаемся
исследовать:  исследовать
порядок:  порядке порядка порядков
поверхность:  поверхности
приключение:  приключений
линейныйкоэффициент:  линейныйкоэффициент
несобственныйинтеграл:  несобственныйинтеграл
забвение:  забвении
доступно:  доступно
причём:  причём
учиться:  учимся
напоминать:  напоминает
ипример:  ипримеры
указывать:  указывая
поверхностный:  поверхностные
фигура:  фигуры
пуассон:  пуассона
подобный:  подобные
успех:  успехов
однако:  однако
малопригодный:  малопригодна
математическоеожидание:  математическоеожидание
дать:  данной
расписаться:  распишется
учебный:  учебная
прояснить:  проясним
ставиться:  ставятся
неоднородный:  неоднородные
необходимо:  необходимо
около:  около
кратное:  кратные
прерывный:  прерывна
системудифференциальный:  системудифференциальных
набить:  набить
уметь:  уметь
сочинять:  сочинять
расти:  растёт растущую
квадратичный:  квадратичные
попадаться:  попадаются
объём:  объем
сократить:  сокращенного
поскольку:  поскольку
гипергеометрическоераспределение:  гипергеометрическоераспределение
подбираться:  подбираются
возможность:  возможность
переписывать:  переписывать
понятие:  понятие
подробно:  подробно
равномерный:  равномерная равномерное
треугольный:  треугольная
исключительно:  исключительно
иной:  иному
непрерывно:  непрерывно
пожалуйста:  пожалуйста
знакомиться:  знакомимся
красный:  красной
записываться:  записывается
следовать:  следует
себя:  собой
пятёрка:  пятёрки
однозначно:  однозначно
квадрат:  квадратов
вариант:  варианта
обычный:  обычный
функциюкомплексный:  функциюкомплексной
даваться:  даётся
мода:  мода
свойстваэлементарный:  свойстваэлементарных
момент:  момента
калькулятор:  калькулятор
научиться:  научиться
происходить:  происходит
исправить:  исправить
оба:  оба
алгоритм:  алгоритмом
злостный:  злостным
формально:  формально
действительно:  действительно
экстремум:  экстремумы
постараться:  постараюсь
горнера:  горнера
своеобразный:  своеобразного
вкус:  вкусом
функцийв:  функцийв
фраза:  фраз
видеть:  видите
минимум:  минимум
довольно:  довольно
тип:  типах
позитивный:  позитивный
вычесть:  вычесть
среди:  среди
искусственный:  искусственный
весёлый:  веселее
пошаговый:  пошаговые
понимать:  понимать
ознакомиться:  ознакомьтесь
три:  трёх
дискретнойслучайный:  дискретнойслучайной
ум:  уме
написать:  написать
знак:  знак
жутко:  жутко
слон:  слонов
заполнить:  заполнены
четвёрка:  четвёрку
крамер:  крамера
круглый:  круглых
вышка:  вышки
банально:  банально
освоение:  освоения
галопом:  галопом
ломать:  ломает
парабола:  парабола
строго:  строго
расписывать:  расписываем
облегчить:  облегчило
пора:  пора
функциидвуха:  функциидвух
запретить:  запрещено
рисунок:  рисунке
емелин:  емелин
симметричный:  симметричную
вычисленияопределенный:  вычисленияопределенных
задачин:  задачина
системый:  системыи
удовлетворяетлить:  удовлетворяетли
вещь:  вещи
сегодня:  сегодня
приходиться:  приходится
участник:  участников
тригонометрический:  тригонометрических
редкий:  редкий
двулик:  двулики
проводить:  проводим
различие:  различием
аналитически:  аналитически
устранить:  устранена
заданав:  заданав
всё:  всё
что:  чём
лекция:  лекции
изобразить:  изобразим
тройной:  тройные
контуруформула:  контуруформула
дело:  деле дело
озарить:  озарила
вне:  вне
друг:  друзей
внутри:  внутри
доказать:  доказать
флуда:  флуда
либо:  либо
рекомендовать:  рекомендую
эн:  эн
независимый:  независимые
паника:  панику
добавить:  добавим
изучение:  изучения
привести:  привести
стук:  стуку
непонимание:  непонимание
студент:  студенты
корреляция:  корреляции
прежде:  прежде
зажать:  зажмите
заряжать:  заряжаю
заочник:  заочников
повторять:  повторяем
фирменный:  фирменные
