вектор:  векторы векторов
разница:  разница
получить:  полученная получи
везде:  везде
одноимённый:  одноимённый одноимённой одноимённая
частный:  частным частной частные частная частное
вращение:  вращения
дифференциальный:  дифференциальные дифференциальное
первый:  первый первое первой первых первом первого
жвачка:  жвачкой
уравненияс:  уравненияс
наличие:  наличии
именно:  именно
онлайн:  онлайн
принять:  принято
несуществование:  несуществованием
смысл:  смысл
геометрия:  геометрии геометрия
приближаться:  приближаемся приближаются приближаться приближается
давать:  давайте
рассмотреть:  рассмотреть рассмотрим
недоразумение:  недоразумений
классифицировать:  классифицировать
решить:  решить
копирование:  копирование
разрыв:  разрыва разрыв разрывов разрывы разрывом
работа:  работа
выражение:  выражения
сумма:  сумма сумму
пройдить:  пройдённый
производный:  производные производная производной производную
прямой:  прямой прямую прямая
дуприближённо:  дуприближённо
неоднократно:  неоднократно
новый:  новому
предел:  предел пределом предела пределы пределе пределов
произвольныйтройный:  произвольныйтройной
модель:  модели модель
ниже:  ниже
асимптота:  асимптоты асимптотами асимптот
роль:  роль
дизайн:  дизайна
напоминать:  напоминают
это:  это
событие:  события
отблагодарить:  отблагодарить
принципиальный:  принципиальная
повторный:  повторные повторном повторным
родственный:  родственны
байес:  байеса
числовой:  числовые
поверхность:  поверхностей поверхности поверхность
дисперсия:  дисперсию дисперсия дисперсии
решать:  решать
производныенеявно:  производныенеявно
пример:  примере примера примеры пример примерах
значение:  значение значения значению
решение:  решений решением решения решение
непрерывный:  непрерывной непрерывна непрерывная непрерывны непрерывных непрерывную
поляй:  поляи
интеграл:  интегралы интеграла интеграл интеграле интегралов
свет:  свет
опечатка:  опечатку
дойти:  дошло
б:  б
теория:  теория теории
математический:  математические математическая математической
опробовать:  опробовать
игрек:  игрек
речь:  речь речи
формула:  формулы формула формулу
данный:  данном данный
смотреть:  см
показать:  показать
замена:  замену замены
геометрический:  геометрической геометрическая геометрический геометрическое
фнп:  фнп
различный:  различного различные различных
произвольный:  произвольном произвольных
называть:  называют
канонический:  каноническому
простейшее:  простейшие простейшим
координата:  координатам координат координаты координатах
избежание:  избежание
гипотеза:  гипотезы гипотез гипотеза
дифференциал:  дифференциалах дифференциала
двумерный:  двумерная
больший:  наибольшее большего
самый:  самых самые самое самый
методомоперационный:  методомоперационного
стрелка:  стрелки
задать:  заданной задайте заданная
многие:  многие
устранимый:  устранимым устранимый
часть:  частям
один:  одну одной одним
тело:  тела
циркуляция:  циркуляция
бесповторный:  бесповторной
непосредственно:  непосредственно
образно:  образно
правильно:  правильно
двойной:  двойные двойной
назвать:  назвал
означать:  означает
ошибка:  ошибку
рамка:  рамки
проводиться:  проводится
плоскость:  плоскости плоскостью плоскость
несобство:  несобств
л:  л
практический:  практические практических практическим
общий:  общим общая общий общей общего
нелинейный:  нелинейная
тип:  типу
имхо:  имхо
увлекательный:  увлекательного
задача:  задачам задачи
преобразованиеквадратичный:  преобразованиеквадратичной
определителяй:  определителяи
итог:  итогу
число:  число числами числа
вогнутостья:  вогнутостьи
многий:  многих
график:  графиков график
вид:  виде видах виды виду
становиться:  становится
закон:  законы
разрываться:  разрываются
функциональный:  функциональные
завершать:  завершающий
взять:  взять взятой взятых возьмём
касательный:  касательных
убедиться:  убедиться
связанный:  связанное
профессия:  профессию
тот:  той те тех ту
абсолютный:  абсолютная
графика:  графика графики
типовыхзадача:  типовыхзадач
пункт:  пункт пункте пункта
умножение:  умножения
ситуация:  ситуацию ситуации ситуация
вероятность:  вероятностей вероятность вероятности
залепить:  залепить
встречаться:  встречаются встречался
ранговойкорреляция:  ранговойкорреляции
система:  система систему системе системы
функция:  функций функцией функцию функции функциях функция
заняться:  заняться
группировка:  группировок группировка
условнаясходимость:  условнаясходимость
сложенияй:  сложенияи
предшествовать:  предшествующего
уравненийв:  уравненийв
обозначить:  обозначена
путать:  путать
цвет:  цвет
высота:  высотах
рисование:  рисования
регрессия:  регрессии регрессия
величина:  величин величина величины
александр:  александр
ось:  ось оси осям
отдельно:  отдельно
правильный:  правильным
окружность:  окружности
термин:  термины
количество:  количества количество
обусловить:  обусловлен
прикладной:  прикладной
грин:  грина
полный:  полное полных полной
координатный:  координатной координатным
исчисление:  исчисления исчисление
линейный:  линейные линейная линейных линейной
эйлер:  эйлера
взаимосвязь:  взаимосвязь
равенство:  равенство
чрезвычайно:  чрезвычайно
вложить:  вложить
согласие:  согласия
локальный:  локальная
ожидание:  ожидание
математика:  математики математике
лаплас:  лапласа
перегиб:  перегиба
такой:  таким такое такая такую
сходимость:  сходимости сходимость
дуоперационный:  дуоперационным
исследовать:  исследовать исследуем
цилиндр:  цилиндр цилиндры
сформулировать:  сформулировать сформулирую
невозможно:  невозможно
дискретный:  дискретный
базис:  базисах базис базису
загнать:  загоним
знакочередоваться:  знакочередующиеся
векторный:  векторного векторное
несколько:  нескольких несколько
рассказать:  рассказать
ду:  ду
идти:  идти шла идёт
далее:  далее
зависимостьвектор:  зависимостьвекторов
линейныйкоэффициент:  линейныйкоэффициент
память:  памяти
коэффициент:  коэффициент
неопределённый:  неопределенный неопределенном
маршрут:  маршрутам маршруте
рассматриваться:  рассматривается
метод:  методы методом метод
дробь:  дробей
данные:  данными данных
собственный:  собственные
геометрически:  геометрически
страница:  страницу
несобственныйинтеграл:  несобственныйинтеграл
признак:  признак признаки
исследование:  исследованию исследование
сложный:  сложной посложнее сложных сложные сложная
аудитория:  аудитории
рядом:  рядом
доступно:  доступно
причём:  причём
фурье:  фурье
учиться:  учимся
поле:  поля
логично:  логично
разложение:  разложением разложение
задавать:  задаваемые
поэтому:  поэтому
свойство:  свойства
практика:  практике
разумеется:  разумеется
момент:  момент моменты
точка:  точка точки точку точках точек точке
простой:  прост простая простую попроще проста
синус:  синус
икс:  икс
ипример:  ипримеры
теоретический:  теоретические
уравнение:  уравнению уравнений уравнения уравнение уравнением
множество:  множества
оценка:  оценки оценка
переход:  переход
вариация:  вариации
знакомый:  знакомый
найти:  найти найдём
асимметрия:  асимметрия
комплексный:  комплексными комплексные комплексного комплексный
есть:  едят
основа:  основы
глаз:  глаза
поверхностный:  поверхностные
открыть:  открыть
интервал:  интервалы
книга:  книга книги
главный:  главную
кош:  коши
завершение:  завершение
фигура:  фигуры
пуассон:  пуассона
гениальный:  гениален
сводиться:  сводящиеся
чайник:  чайников
преобразование:  преобразований преобразования
алгоритм:  алгоритма алгоритм
вычисленияс:  вычисленияс
однако:  однако
малый:  малые наименьших меньшее
связь:  связь
таки:  таки
понижение:  понижением понижение
кусочный:  кусочным
матричный:  матричные матричных матричный
вкладка:  вкладке
пора:  поры
волна:  волнами
столкнуться:  столкнулись
всюду:  всюду
заметить:  заметили
математическоеожидание:  математическоеожидание
качественный:  качественного
дать:  данной данная
однородный:  однородные однородным
решенияопределённый:  решенияопределенных
например:  например
успешно:  успешно
вычислить:  вычислить вычисленный
искусство:  искусства
плохо:  плохо
нормальный:  нормальное
школа:  школа
очень:  очень
делаться:  делается
интегральнаятеорема:  интегральнаятеоремы
некоторый:  некоторой некоторую некоторых некоторые
корнимногочлен:  корнимногочлена
логарифмический:  логарифмическая
матрица:  матрицу матрицы матрицами
бородатый:  бородатые
испытанияй:  испытанияи
интегралыть:  интегралыв
неоднородный:  неоднородные
перегруппировка:  перегруппировка
произойти:  произойдёт
правило:  правило правила
основной:  основные
обывательский:  обывательские
помощь:  помощью
бернулли:  бернулли
стать:  стала станет
полярный:  полярные полярной полярных полярным
коэффициентковариация:  коэффициентковариации
углубляться:  углубляться
ряд:  ряд ряды ряда рядов
вариационный:  вариационный
разрывный:  разрывной
уровень:  уровня
обратный:  обратная обратную
вопрос:  вопросы вопросами вопрос
кратное:  кратные
неопределённость:  неопределённости
стандартно:  стандартно
исключение:  исключением
системудифференциальный:  системудифференциальных
совокупный:  совокупному
блог:  блог
доверительный:  доверительные
соответствовать:  соответствующая
высокий:  высших высшей высшая
убито:  убито
теорема:  теореме теоремы
помимо:  помимо
конец:  конце
линия:  линий линиями линии линия
среднееквадратический:  среднееквадратическое
коротко:  коротко
пространство:  пространстве
оговорка:  оговоркой
лопиталя:  лопиталя
красный:  красные красный
последовательность:  последовательностей
удобный:  удобный
комбинационный:  комбинационная
курс:  курс курсу курсе
квадратичный:  квадратичные
смешанноепроизведение:  смешанноепроизведение
вплотную:  вплотную
нужный:  нужна нужной
объём:  объем
проверить:  проверить проверим
поляформула:  поляформула
сообщить:  сообщите
проверка:  проверки проверка
фехнера:  фехнера
аналитический:  аналитическая аналитической
усвоение:  усвоения
проколоть:  проколотое
киль:  килем
требоваться:  требовалось
поскольку:  поскольку
школьный:  школьный
эффективный:  эффективные
распространяться:  распространяется
центр:  центр
жёсткий:  жёсткие
образ:  образом
гипергеометрическоераспределение:  гипергеометрическоераспределение
целый:  целой целых
условный:  условные
непрерывнаяслучайный:  непрерывнаяслучайная
определение:  определений определения определению
ненулевой:  ненулевых
эллипс:  эллипс
прямо:  прямо
поговорить:  поговорим
длина:  длина
материал:  материал материалы материалов
любой:  любой любом
терпеть:  терпит терпеть
сайт:  сайта сайты сайт
немного:  немного
сократить:  сократить
неустранимый:  неустранимым неустраним
знакопостоянство:  знакопостоянства
понятие:  понятие
мочь:  могут
равномерный:  равномерная равномерное
доопределить:  доопределить
хороший:  лучшего
треугольный:  треугольная
включать:  включает
градиент:  градиент
иметь:  имеющие имеет
изобразить:  изобразить
подстановка:  подстановкой
представление:  представления
использовать:  используйте используем
пожалуйста:  пожалуйста
даламбер:  даламбера
тонкость:  тонкости
принимать:  принимать
художественный:  художественные
комбинаторика:  комбинаторике
ждать:  ждут
факт:  факт
случайнаявеличина:  случайнаявеличина
повторнойя:  повторнойи
выпадать:  выпадает
заморозить:  заморожено
построение:  построение
естественно:  естественно
следовать:  следует
вспоминать:  вспоминаем
преимущественно:  преимущественно
бесконечно:  бесконечно
вдоль:  вдоль
линейнойкорреляционный:  линейнойкорреляционной
действие:  действия
аналогия:  аналогии
квадрат:  квадратов
ранг:  ранг
время:  время времени
кривая:  кривой
форма:  формы
равный:  равны равен
обычный:  обычный
тяжестиплоска:  тяжестиплоской
особо:  особо
отметить:  отметить
статья:  статьи
сразу:  сразу
устранить:  устранить
многообразие:  многообразие
распределениякритерия:  распределениякритерий
непрерывность:  непрерывностью непрерывность непрерывности
похожий:  похожи
функциюкомплексный:  функциюкомплексной
характер:  характере
необычный:  необычные
область:  область области
реализоваться:  реализуется
асимптотический:  асимптотической
целое:  целое
построить:  построить
готовый:  готовых
несобственный:  несобственные
просто:  просто
разобраться:  разберёмся
мода:  мода
выполнять:  выполнять
свойстваэлементарный:  свойстваэлементарных
провести:  проведём
извиваться:  извиваться
ещё:  ещё
пропасть:  пропадёт
таковой:  такового
проходить:  проходят проходящая проходит
внимание:  внимание
краткий:  краткое
зрение:  зрения
калькулятор:  калькулятор
лейбниц:  лейбница
научиться:  научиться
случай:  случае
откуда:  откуда
недосказанность:  недосказанности
цель:  целей
неравенство:  неравенства
повестись:  повелось
наш:  наше наш нашего нашем
поток:  поток
белый:  белая
бросаться:  бросается
занятие:  занятия
касательная:  касательная
ответ:  ответ ответы
задачис:  задачис
предыдущий:  предыдущего
обзор:  обзора
соседний:  соседней
учебный:  учебной
зелёный:  зелёный зелёная
друг:  другом
медиана:  медиана
функциия:  функциии
освежить:  освежить
степенной:  степенного степенные
единый:  единым
функцийдвуха:  функцийдвух
композиция:  композиции
направлениюй:  направлениюи
определённый:  определенный определенного
выборка:  выборке
гостевой:  гостевая
рассматривать:  рассматриваемая рассматриваемой
действительно:  действительно
распределение:  распределения распределение
экстремум:  экстремумы
кроме:  кроме
допустимый:  допустимом
горнера:  горнера
предложение:  предложением
производныефункция:  производныефункции
средний:  средняя
понятно:  понятно
функцийнесколький:  функцийнескольких
удачный:  удачный
второй:  вторая второго
вывод:  вывод
чисто:  чисто
внутригрупповаяй:  внутригрупповаяи
алгебра:  алгебры
удовлетворять:  удовлетворяют
математик:  математика
шаг:  шагов
функцийв:  функцийв
переменный:  переменных переменной
тест:  тест
несовместный:  несовместные
независимыеслучайный:  независимыеслучайные
множественнойлинейный:  множественнойлинейной
довольно:  довольно
существовать:  существует
анализ:  анализ анализа
следовательно:  следовательно
тема:  темы
каждый:  каждой
фут:  футов
прямоугольник:  прямоугольников
эксцессэмпирический:  эксцессэмпирического
природа:  природа
урок:  урока уроки
подставить:  подставить подставим
раскрыть:  раскрыты
функциис:  функциис
зеркало:  зеркало
криволинейный:  криволинейные
значит:  значит
представимый:  представима
иллюстрация:  иллюстрации
пирсон:  пирсона
определить:  определено определена
библиотека:  библиотека
три:  трёх
межгрупповой:  межгрупповая
ортогональный:  ортогональное
дискретнойслучайный:  дискретнойслучайной
подход:  подходе подход
задачипо:  задачипо
точечный:  точечных
востребовать:  востребованную
наименьшеезначение:  наименьшеезначения
нсв:  нсв
сила:  силы
аргумент:  аргументу
приблизить:  приближенные
протяжение:  протяжении
схема:  схему схема
бесконечный:  бесконечный бесконечен
разрез:  разреза
некий:  некая
вариант:  вариант
системылинейный:  системылинейных
нужно:  нужно
тесно:  тесно
обнаружение:  обнаружение
задание:  задания
лоскут:  лоскутом
упасть:  упал
выкладка:  выкладки
каков:  какова
примечание:  примечание
зависимый:  зависимые
зависимость:  зависимость
отклонение:  отклонение
крамер:  крамера
переопределить:  переопределить
художник:  художник
отрезка:  отрезке
другой:  другие
информация:  информация
таблица:  таблицы
конкретный:  конкретное
произведение:  произведение
вполне:  вполне
случайный:  случайных случайные
замкнутый:  замкнутому
семь:  семь
начало:  начале началу
первоисточник:  первоисточник
дуга:  дуги
отрезкать:  отрезкав
играть:  играет
дивергенция:  дивергенция
парабола:  парабола
наглухо:  наглухо
наступить:  наступил
повезти:  повезёт
одеяло:  одеяло
форум:  форуме форум
показатель:  показатели
повторимый:  повторим
отличие:  отличие
думать:  думал
площадьс:  площадьс
функциидвуха:  функциидвух
изучение:  изучении изучения
продвигаться:  продвигаемся
статистический:  статистические статистическая
запретить:  запрещено
скручиваться:  скручивается
емелин:  емелин
синий:  синий синие
замечательный:  замечательный замечательные
убыванией:  убываниеи
вычисленияопределенный:  вычисленияопределенных
повышенный:  повышенной
возрастание:  возрастание
эмпирический:  эмпирические
детерминация:  детерминации
интегрирование:  интегрирование
также:  также
задачин:  задачина
следующий:  следующие следующей
легко:  легко
стягиваться:  стягиваться
рациональный:  рациональные
системый:  системыи
начать:  начать
удовлетворяетлить:  удовлетворяетли
найтись:  нашлось
чертёж:  чертеже
аналогично:  аналогично
сегодня:  сегодня
нуль:  нулю
дифференциальныеуравнение:  дифференциальныеуравнения
обратиться:  обратитесь
разрезать:  разрезает
иррациональный:  иррациональных
интервальный:  интервальный
который:  которой которое
два:  двух
тригонометрический:  тригонометрических тригонометрическую
постоянный:  постоянных
квадратичнуюформ:  квадратичнуюформу
стокс:  стокса
дальнейший:  дальнейшему
карта:  карта
косинус:  косинус
параметрический:  параметрической параметрическом
итак:  итак
гипербола:  гипербола
ясно:  ясно
быть:  будут будем
начертить:  начертить
взгляд:  взглядом
дробовик:  дробовик
они:  ними
оценкия:  оценкии
неявный:  неявной
круговой:  круговой
несобственныхинтеграл:  несобственныхинтегралов
вероятностибиномиальный:  вероятностибиномиального
сам:  самом
отрабатывать:  отрабатываем
вероятностия:  вероятностии
логика:  логики
заданав:  заданав
род:  рода
скалярный:  скалярное
спирмена:  спирмена
гаусс:  гаусса
порядок:  порядка порядков
всё:  всё
проблёмка:  проблемку
значимость:  значимости
тройной:  тройные
полезно:  полезно
возникать:  возникает
деление:  деления
являться:  является
выполнить:  выполнено
окинуть:  окинуть
контуруформула:  контуруформула
иной:  иной
экстремальный:  экстремальные
экспонент:  экспоненту
близко:  близко
очередь:  очереди
лишь:  лишь
дело:  деле дело
её:  её
св:  св
парный:  парной
параллельно:  параллельно
нормаль:  нормали
курить:  курил
определитель:  определитель
желать:  желающие
обещать:  обещанного
выпуклость:  выпуклость
элемент:  элементы
сборник:  сборники
показательный:  показательное
отверстие:  отверстие
либо:  либо
разбор:  разбора
рекомендовать:  рекомендую
независимый:  независимые
великий:  величайшее
автор:  автора автор
маленький:  маленькую
сложность:  сложности
диффура:  диффурами
делать:  делаем
часто:  часто
значенияй:  значенияи
предчувствовать:  предчувствуете
привести:  привести
соответствующий:  соответствующие
перейти:  перейдём
получаться:  получается
кстати:  кстати
разрешиться:  разрешился
вычисление:  вычисление
классическоеопределение:  классическоеопределение
инормаль:  инормаль
место:  место
статистика:  статистика
корреляция:  корреляции
прежде:  прежде
пунктир:  пунктиром
подставлять:  подставляем
условие:  условию
биномиальный:  биномиальное
интуитивно:  интуитивно
вновь:  вновь
заочник:  заочников
пирамида:  пирамида
линиюв:  линиюв
самостоятельный:  самостоятельного
интересный:  интересной
отношение:  отношении
повторять:  повторяем
понимание:  понимания
настать:  настало
подпредельный:  подпредельную
литература:  литературе
оказаться:  окажется
