вектор:  векторы векторов
получить:  полученная получено получи
случайный:  случайную случайная случайной случайное случайных случайные
встретиться:  встретиться
объяснение:  объяснениями
философия:  философии
наподобие:  наподобие
вращение:  вращения
кубик:  кубике кубик кубиков кубиком кубика
дифференциальный:  дифференциальные
первый:  первый первом первого
произведение:  произведению произведение
уравненияс:  уравненияс
именно:  именно
онлайн:  онлайн
разобрать:  разберём разобраны
геометрия:  геометрии геометрия
копирование:  копирование
полезный:  полезен
использовать:  используют используйте используя
рассмотреть:  рассмотреть рассмотрели рассмотрим
решить:  решить
превосходящий:  превосходящее
разрыв:  разрыва
один:  одного одной одна одно одним одному
выражение:  выражения
столетие:  столетию
работа:  работа работе
производный:  производные производная производной производную
прямой:  прямой прямую прямая
дуприближённо:  дуприближённо
сумма:  сумма сумме сумму суммы
пытаться:  пытаемся
предел:  предел пределы пределов
новый:  новому
произвольныйтройный:  произвольныйтройной
модель:  модели модель
нуждаться:  нуждается
ниже:  ниже
информация:  информации
асимптота:  асимптоты
дизайн:  дизайна
позволять:  позволяющие
одномерный:  одномерным одномерной
больший:  большей наибольшее большего
это:  это
источник:  источниках
вычисленияопределенный:  вычисленияопределенных
событие:  события событие событий событию
невозможный:  невозможное
отблагодарить:  отблагодарить
являться:  являются является
кость:  костей костями костью
который:  которую которых которые который которая которое
повторный:  повторные
заходить:  заходит
байес:  байеса
числовой:  числовые
экселе:  экселе
простой:  проще
рассматривать:  рассматриваем
дисперсия:  дисперсию дисперсия дисперсии
решать:  решать
производныенеявно:  производныенеявно
таблица:  таблицу таблицы таблице
значение:  значение значения значений значении значению
решение:  решений решениями решением решение решения
непрерывный:  непрерывной непрерывная непрерывных непрерывные
грань:  граней
поляй:  поляи
точность:  точности
интеграл:  интегралы интеграла интеграл интеграле интегралов
опечатка:  опечатку опечатка
результат:  результат результаты результате
постоянный:  постоянный постоянного постоянна постоянных постоянной
математический:  математические математическая математической математического математическое
теория:  теория теории
находить:  находить
знать:  знает
строка:  строку строкам строки
продолжать:  продолжаем
издание:  изданий
вынесение:  вынесении
игрек:  игрек игрека
принять:  приняла примет примут принять
предлагаться:  предлагаются
взять:  взятые
речь:  речь
формула:  формулы формула
данный:  данном данное
статья:  статье статьи
фнп:  фнп
пособие:  пособия
двумерный:  двумерную двумерная двумерной двумерных
прийтись:  придётся пришлось
канонический:  каноническому
называть:  называют
простейшее:  простейшие
два:  две двумя двух
гипотеза:  гипотезы гипотез гипотеза
дифференциал:  дифференциалах дифференциала
заметить:  заметьте заметили
известно:  известно
задать:  заданной задайте заданы
методомоперационный:  методомоперационного
часть:  частям
тело:  тела
циркуляция:  циркуляция
несовместный:  несовместных несовместные
напрямую:  напрямую
слева:  слева
непосредственно:  непосредственно
бесповторный:  бесповторной
расплатиться:  расплатиться
игреков:  игрековым
двойной:  двойные двойной
означать:  означает
вычислить:  вычислили вычислено вычислены вычислить вычислил
ошибка:  ошибку ошибок
плоскость:  плоскости плоскость
следующий:  следующих следующему следующую следующий следующие следующем
несобство:  несобств
столбец:  столбца столбцам
л:  л
общий:  общим общая общего
настать:  настал
обойтись:  обойтись
нелинейный:  нелинейная
очко:  очков
поздний:  позже
три:  трём трёх
преобразованиеквадратичный:  преобразованиеквадратичной
определителяй:  определителяи
вогнутостья:  вогнутостьи
контролировать:  контролируем
вид:  виде виды виду
выяснить:  выяснить
закон:  законы закон законами законах
функциональный:  функциональные
вводиться:  вводится
испытание:  испытания испытании
случай:  случай случае
пересечение:  пересечении
касательный:  касательных
убедиться:  убедиться убедимся
качество:  качестве
последний:  последнем последняя последних
разбираться:  разбираемся
профессия:  профессию
константа:  константу
условие:  условии условия условиям условию
большой:  большой
получаться:  получаются получается
геометрический:  геометрическая геометрическое
абсолютный:  абсолютная
разный:  разными
типовыхзадача:  типовыхзадач
произвольный:  произвольной произвольных
удобно:  удобно
графика:  графика графики
умножение:  умножения
лампочка:  лампочка лампочки
вероятность:  вероятностей вероятностью вероятность вероятностям вероятностями вероятности
взгляд:  взгляд
система:  система системой систему системе системы
частный:  частные частное
функция:  функций функцию функции функция
квадратичный:  квадратичная квадратичные
включать:  включать
группировка:  группировок группировка
определённый:  определенными определенный определенного
условнаясходимость:  условнаясходимость
констатироваться:  констатируется
сложенияй:  сложенияи
уравненийв:  уравненийв
множитель:  множитель множителя
регрессия:  регрессии регрессия
величина:  величин величину величине величиной величина величины величинами величинах
подготовить:  подготовленных
александр:  александр
урок:  уроках урок уроке
отдельно:  отдельно
иметь:  имеют имеем
остаться:  осталось
загораться:  загораются
птичка:  птичку
количество:  количества количество
учесть:  учтены
грин:  грина
полный:  полное полных полная полной
линейный:  линейные линейная линейных линейной
исчисление:  исчисления
устройство:  устройство
эйлер:  эйлера
игровой:  игровом игровыми
направо:  направо
иксовыя:  иксовые
нужный:  нужны нужных нужной
равенство:  равенство равенства
хаос:  хаоса хаосов хаос
согласие:  согласия
зачастую:  зачастую
локальный:  локальная
понятие:  понятиями понятия понятие
исход:  исходы исходу
копипаста:  копипаст
подсчитать:  подсчитаем подсчитать подсчитана
ожидание:  ожидание ожидания
приветствовать:  приветствует
математика:  математики математике
такой:  таким такому такое такого такими такую
предыдущий:  предыдущем предыдущих
лаплас:  лапласа
выпадение:  выпадения
перегиб:  перегиба
независимый:  независимы независимыми независимых независимые
сходимость:  сходимости сходимость
дуоперационный:  дуоперационным
пример:  примером примерами примеры пример примера
представить:  представьте
справедливость:  справедливости справедливость
дискретный:  дискретный дискретные дискретных дискретной
исследовать:  исследовать
некий:  некую
базис:  базисах базис базису
поверхность:  поверхности
знакочередоваться:  знакочередующиеся
вычисление:  вычислений вычисления вычисление
задача:  задачи задаче задачах
итого:  итого
составить:  составить составим
векторный:  векторного векторное
ду:  ду
зависимый:  зависимыми зависимы зависимой зависимых зависимые
равный:  равными равны равна
соответствовать:  соответствуют соответствует
далее:  далее
зависимостьвектор:  зависимостьвекторов
порождаться:  порождается
линейныйкоэффициент:  линейныйкоэффициент
оно:  оно
коэффициент:  коэффициент коэффициенты
неопределённый:  неопределенный неопределенном
свой:  своими
метод:  методы метод методом
дробь:  дробей
тема:  теме
страница:  страницу
предложить:  предложено предложенные
собственный:  собственные
признак:  признак признаки
несобственныйинтеграл:  несобственныйинтеграл
данные:  данных
обвести:  обвёл
сложный:  сложной сложное сложных сложные
доступно:  доступно
пара:  паре пары пара пар
работать:  работает работающими
правильный:  правильный правильных
фурье:  фурье
поле:  поля
поэтому:  поэтому
логично:  логично
разложение:  разложением разложение
учиться:  учимся
практика:  практике практика
свойство:  свойства свойствам свойств свойство
задавать:  задаваемые задают
разумеется:  разумеется
момент:  момент моменты
иже:  иже
пункт:  пункте пунктов
конкретный:  конкретного конкретное
икс:  икс икса
исследование:  исследование
ипример:  ипримеры
уравнение:  уравнению уравнений уравнения уравнение
точка:  точки точке
возвести:  возведя
составной:  составной
теоретический:  теоретические
образовывать:  образовывать
никакой:  никаких
проблема:  проблем
переход:  переход
вариация:  вариации
коль:  коль
множество:  множества
асимметрия:  асимметрия
найти:  найти найдём найдем
оценка:  оценки оценка
возможный:  возможна возможном возможных возможные возможная возможной
требоваться:  требуется требовалось
основа:  основы
комплексный:  комплексными комплексные комплексного комплексный
слишком:  слишком
поверхностный:  поверхностные
принимать:  принимают принимает
интервал:  интервалы
суммирование:  суммирования
книга:  книга книги
рука:  руках
главный:  главную
кош:  коши
координата:  координат координаты координатах
фигура:  фигуры
выше:  выше
цвет:  цветом
пуассон:  пуассона
соответствующий:  соответствующих соответствующие
сводиться:  сводящиеся
чайник:  чайников
замена:  замены
преобразование:  преобразований преобразования
появиться:  появится появившихся
вычисленияс:  вычисленияс
однако:  однако
малый:  малые наименьшего наименьших меньшее
связь:  связь
маленький:  меньше маленькой
таки:  таки
понижение:  понижением понижение
матричный:  матричные матричных матричный
забивать:  забиваем
разминка:  разминка
математическоеожидание:  математическоеожидание
например:  например
однородный:  однородные однородным
решенияопределённый:  решенияопределенных
небольшой:  небольшая
плохо:  плохо
нормальный:  нормальное
школа:  школа
очень:  очень
интегральнаятеорема:  интегральнаятеоремы
удобный:  удобнее удобный
корнимногочлен:  корнимногочлена
логарифмический:  логарифмическая
число:  чисел числами числа
матрица:  матрицу матрицы матрицами
испытанияй:  испытанияи
интегралыть:  интегралыв
привыкнуть:  привык
учитывать:  учитывать
неоднородный:  неоднородные
начать:  начнём начать
перегруппировка:  перегруппировка
верхний:  верхние
проверять:  проверяем
правило:  правило правила
подчёркивать:  подчёркиваю
основной:  основные
суммироваться:  суммируются
учебный:  учебного
помощь:  помощью
цель:  цели цель
бернулли:  бернулли
комбинация:  комбинаций комбинации
полярный:  полярные полярной полярных
коэффициентковариация:  коэффициентковариации
ряд:  ряд ряды ряда рядов
вариационный:  вариационный
уровень:  уровня
ячейка:  ячейку
компонент:  компонента
обратный:  обратная обратную
должный:  должны
вопрос:  вопросы вопрос
обратиться:  обратиться
кратное:  кратные
появление:  появления
стандартно:  стандартно
системудифференциальный:  системудифференциальных
бросать:  бросаем
блог:  блог
доверительный:  доверительные
коридор:  коридоре
высокий:  высших высшей высшая
теорема:  теореме теоремы теоремам
очередной:  очередном
год:  лет
помимо:  помимо
среднееквадратический:  среднееквадратическое
коробка:  коробку
строгий:  строгие
пространство:  пространстве
алгоритм:  алгоритм
нестандартный:  нестандартными
лопиталя:  лопиталя
последовательность:  последовательностей
комбинационный:  комбинационная
путь:  путь
курс:  курс
драконовский:  драконовское
обычно:  обычно
распространить:  распространена распространённые
смешанноепроизведение:  смешанноепроизведение
условный:  условного условные условных
парадоксальный:  парадоксальное
объём:  объем
единственный:  единственная единственное
чертёж:  чертежами
вместе:  вместе
поляформула:  поляформула
наверное:  наверное
проверить:  проверить
сообщить:  сообщите
сделать:  сделать
линия:  линиями линии линия
фехнера:  фехнера
матожидание:  матожидание матожидания матожиданию
аналитический:  аналитическая аналитической
популярный:  популярные
школьный:  школьный
эффективный:  эффективные
независимо:  независимо
поскольку:  поскольку
мы:  нам
центр:  центр
область:  областей область области
автомат:  автомате автомат автоматами
образ:  образом
гипергеометрическоераспределение:  гипергеометрическоераспределение
подробный:  подробными
непрерывнаяслучайный:  непрерывнаяслучайная
эллипс:  эллипс
сложение:  сложения
обратить:  обратите обратили
прямо:  прямо
поступить:  поступить
единый:  единой
узнать:  узнаем
длина:  длина длину
ходить:  ходить
любой:  любой любая любом
сайт:  сайта сайты сайт
мочь:  могут
знакопостоянство:  знакопостоянства
проводить:  проводить
равномерный:  равномерная равномерное
треугольный:  треугольная
градиент:  градиент
определение:  определения определению
мой:  моей
ранговойкорреляция:  ранговойкорреляции
обозначать:  обозначать
пожалуйста:  пожалуйста
даламбер:  даламбера
факт:  факт факта
запрещать:  запрещает
комбинаторика:  комбинаторике
целый:  целые
случайнаявеличина:  случайнаявеличина
повторнойя:  повторнойи
строгость:  строгости
построение:  построение
записываться:  записывается
вспоминать:  вспоминаем
следовать:  следует
бесконечно:  бесконечно
давать:  даёт
линейнойкорреляционный:  линейнойкорреляционной
действие:  действия
игральный:  игральный игральными игральным
аналогия:  аналогии
игрековый:  игрековые игрековый
ранг:  ранг
другой:  другое другие другая
квадрат:  квадратов квадрат
кривая:  кривой
план:  план
форма:  формы
тяжестиплоска:  тяжестиплоской
отметить:  отметить отметил
сила:  силу силы
сразу:  сразу
распределениякритерия:  распределениякритерий
эксклюзивный:  эксклюзивными
кратко:  кратко
основное:  основном
функциюкомплексный:  функциюкомплексной
дальнейший:  дальнейшее
приглашать:  приглашаю
проверка:  проверка
предстоять:  предстоит
построить:  построить построим
готовый:  готовых готово готовы
несобственный:  несобственные
просто:  просто
совершать:  совершать
заодно:  заодно
мода:  мода
провести:  проведём провести
представление:  представлении
ещё:  ещё
свойстваэлементарный:  свойстваэлементарных
весь:  всём
считать:  считать
внимание:  внимание
краткий:  краткое
зрение:  зрения
лейбниц:  лейбница
калькулятор:  калькулятор калькуляторе
научиться:  научиться
неравенство:  неравенства
вариант:  варианты
искомый:  искомый
поток:  поток
отдельность:  отдельности
исходный:  исходных
сам:  самой
влиять:  влияет
сформулировать:  сформулировано
ехать:  едем
переиздаваться:  переиздаётся
касательная:  касательная
ответ:  ответ
задачис:  задачис
принцип:  принципу
свести:  сведём
друг:  другом
подбрасывание:  подбрасывании
медиана:  медиана
рассмотрение:  рассмотрение
осветить:  освещены
нахождение:  нахождения нахождением
функциия:  функциии
записать:  записать
диффура:  диффуры диффурами
частый:  чаще
возможно:  возможно
степенной:  степенного степенные
функцийдвуха:  функцийдвух
оказаться:  окажется
уверенность:  уверенности
направлениюй:  направлениюи
читатель:  читателей
выборка:  выборке
привести:  привёл привести
формально:  формально
ограничение:  ограничений
гостевой:  гостевая
скоро:  скоро
расчётный:  расчётной
распределение:  распределения распределение
кроме:  кроме
экстремум:  экстремумы
констатировать:  констатирует
горнера:  горнера
производныефункция:  производныефункции
средний:  средняя
красный:  красным
единица:  единице
функцийнесколький:  функцийнескольких
скобка:  скобках
внутригрупповаяй:  внутригрупповаяи
зависеть:  зависит
формулировка:  формулировке
алгебра:  алгебры
получать:  получаем
звать:  зовут
далеко:  далеко
уместно:  уместно
предположим:  предположим
математик:  математика
переменный:  переменных переменную переменной
убеждаться:  убеждаемся
функцийв:  функцийв
требовать:  требуемые
третий:  третье
независимыеслучайный:  независимыеслучайные
множественнойлинейный:  множественнойлинейной
отграничить:  отграничена
анализ:  анализ анализа
зависимость:  зависимости зависимость
суммировать:  суммируя суммировать
непрерывность:  непрерывность
прямоугольник:  прямоугольников
шесть:  шести
получиться:  получиться получился
эксцессэмпирический:  эксцессэмпирического
выпасть:  выпавших
забывать:  забываем забывая
вычесть:  вычесть
функциис:  функциис
этот:  этому этих
критерий:  критерии
зеркало:  зеркало
второй:  втором второго
повлиять:  повлияло
значит:  значит
криволинейный:  криволинейные
различный:  различных
пирсон:  пирсона
большемерный:  большемерная
реальный:  реальной
самостоятельный:  самостоятельное самостоятельного
библиотека:  библиотека
межгрупповой:  межгрупповая
ортогональный:  ортогональное
дискретнойслучайный:  дискретнойслучайной
задачипо:  задачипо
наложить:  наложено
ты:  тобой
востребовать:  востребованную
наименьшеезначение:  наименьшеезначения
термин:  термин
нсв:  нсв
задачка:  задачка
приблизить:  приближенные
вычислимый:  вычислим
знак:  знак
психиатрия:  психиатрия
разница:  разницы
зажечься:  зажглась
системылинейный:  системылинейных
нужно:  нужно
какой:  какое
кухня:  кухне
упасть:  упал
выкладка:  выкладки
отклонение:  отклонение
интересный:  интересного
крамер:  крамера
отрезка:  отрезке
материал:  материалы материалов
предварительно:  предварительно
замкнутый:  замкнутому
очевидный:  очевидно
одинаковый:  одинаковыми одинаковые
ковариация:  ковариации
дуга:  дуги
внимательно:  внимательно
перебрать:  перебрать
запись:  запись
отрезкать:  отрезкав
дивергенция:  дивергенция
парабола:  парабола
форум:  форуме форум
показатель:  показатели
наш:  наш нашей наши
ассоциировать:  ассоциировать
короче:  короче
бросок:  бросок броска
отличие:  отличие отличием
вычисляться:  вычисляются
площадьс:  площадьс
запретить:  запрещено
неверно:  неверно
функциидвуха:  функциидвух
развернуть:  развернутые
статистический:  статистические статистическая
рисунок:  рисунке
энтузиазм:  энтузиазмом
емелин:  емелин
идти:  идёт
она:  неё
широко:  широко
иксовый:  иксовом
детерминация:  детерминации
убыванией:  убываниеи
возрастание:  возрастание
эмпирический:  эмпирические
повышенный:  повышенной
также:  также
интегрирование:  интегрирование
обязательно:  обязательно
задачин:  задачина
отрицательный:  отрицательное
тот:  тех
рациональный:  рациональные
замечательный:  замечательные
найтись:  нашлось
системый:  системыи
расположить:  расположенную
удовлетворяетлить:  удовлетворяетли
выполнить:  выполнить
аналогично:  аналогично
энтузиаст:  энтузиасты
чётвереть:  чётвёртое
пока:  пока
вещь:  вещи
нуль:  нулю
потребоваться:  потребуется
дифференциальныеуравнение:  дифференциальныеуравнения
подбрасывать:  подбрасывать
всякий:  всякий
иррациональный:  иррациональных
торжественный:  торжественный
интервальный:  интервальный
бабушка:  бабушка
эталонный:  эталонный
тригонометрический:  тригонометрических
стокс:  стокса
квадратичнуюформ:  квадратичнуюформу
стандартный:  стандартные
схема:  схема
карта:  карта
близкий:  ближайших
прыжок:  прыжки
параметрический:  параметрической параметрическом
возведение:  возведением
кропотливый:  кропотливое
синий:  синим
пронумеровать:  пронумерованные
некоторый:  некоторое
гипербола:  гипербола
аналитически:  аналитически
вообще:  вообще
равняться:  равняться
быть:  будут будем
равно:  равно
заключительный:  заключительных
присматриваться:  присматриваюсь
дробовик:  дробовик
они:  ними
группа:  группа
оценкия:  оценкии
неявный:  неявной
несобственныхинтеграл:  несобственныхинтегралов
вероятностибиномиальный:  вероятностибиномиального
остановиться:  остановимся
вероятностия:  вероятностии
логика:  логики
спирмена:  спирмена
скалярный:  скалярное
род:  рода
гаусс:  гаусса
заданав:  заданав
порядок:  порядка порядков
всё:  всё
значимость:  значимости
принципиальный:  принципиальным
дедушка:  дедушка
тройной:  тройные
деление:  деления
точно:  точно
контуруформула:  контуруформула
экстремальный:  экстремальные
график:  график
верный:  верное
её:  её
занятие:  занятие
парный:  парной
св:  св
ссылка:  ссылку
нормаль:  нормали
определитель:  определитель
просуммировать:  просуммировать
доказать:  доказать
существовать:  существуют
выпуклость:  выпуклость
палата:  палатами
четыре:  четырёх
элемент:  элементы
сборник:  сборники
достаточно:  достаточно
показательный:  показательное
бывать:  бывают
гмурман:  гмурмана
рекомендовать:  рекомендую
независимость:  независимость
горизонталь:  горизонтали
автор:  автора автор
зет:  зет
сложность:  сложности
добавить:  добавим
часто:  часто
значенияй:  значенияи
заносить:  заносить
справедливо:  справедливо
подарок:  подарка
образовать:  образует
никак:  никак
табличный:  табличная
мера:  меры
весьма:  весьма
игра:  игре
проконтролировать:  проконтролировать
кстати:  кстати
разговор:  разговор
классическоеопределение:  классическоеопределение
инормаль:  инормаль
статистика:  статистика
корреляция:  корреляции
биномиальный:  биномиальное
далёкий:  дальше
достоверно:  достоверно
пригодный:  пригоден
плотность:  плотности
пирамида:  пирамида
случаем:  случаем
заочник:  заочников
объект:  объектом
линиюв:  линиюв
осознанно:  осознанно
наслать:  нашли
справедливый:  справедливы
отношение:  отношении
повторять:  повторяем
устно:  устно
вынести:  вынести
показать:  покажем
задание:  задание
