обязать:  обязана
ось:  осью оси осями осей
часовой:  часовой
шажок:  шажке шажку шажок
производный:  производные производная производной производную
слагаемое:  слагаемое
предел:  предел пределы пределов
виноватый:  виноваты
числовой:  числовые
возиться:  возиться
точнее:  точнее
производныенеявно:  производныенеявно
значение:  значение значения
небольшой:  небольшого небольшое невелико
скорый:  наискорейшего скорых
формула:  формулы формулой формуле формула формулу
смотреть:  см смотрит
особенно:  особенно
отрицательный:  отрицательный
канонический:  каноническому
положительный:  положительными положительной положительным
два:  две двух
дифференциал:  дифференциалах дифференциала
самый:  самых самый самое
больший:  наибольшее большего больший наибольшую
ответственный:  ответственный
стрелка:  стрелки
многие:  многие
один:  одну одно одной
против:  против
любой:  любому любой любую
близкий:  близкой ближайший
число:  число числами числа
вогнутостья:  вогнутостьи
солнышко:  солнышко
становиться:  становится
позволять:  позволяет
стать:  стали стало станет
подниматься:  подниматься
случай:  случай случае
образовать:  образующий образует
убедиться:  убедиться
плохой:  хуже
профессия:  профессию
условие:  условии условиями условие
пусть:  пусть
умножение:  умножения
система:  система системе систему системы
группировка:  группировок группировка
условнаясходимость:  условнаясходимость
направлять:  направляющего направляющие направляющий направляющими
шаг:  шаги шагом шаг
слово:  словами слову
ошибка:  ошибка ошибку ошибок
угол:  угол угла углы углом
александр:  александр
воочию:  воочию
остаться:  осталось оставшиеся
который:  которые который которая которое которую которого которым которых которой
линейный:  линейные линейная линейных линейной
вниз:  вниз
четверть:  четверти четверть
правый:  правой
упрощаться:  упрощается
равенство:  равенство равенстве равенства
быть:  суть будут будем
согласие:  согласия
помогать:  помогал
пункт:  пунктах пункт
рассматривать:  рассматриваемый рассматривать
дуоперационный:  дуоперационным
компактный:  компактная
основать:  основан
сформулировать:  сформулировать
базис:  базисах базису базис
оговорка:  оговорка
несколько:  нескольких несколько несколькими
наиболее:  наиболее
зависимостьвектор:  зависимостьвекторов
снова:  снова
день:  день
сначала:  сначала
метод:  методы методом метод
спустя:  спустя
тема:  теме тему
геометрически:  геометрически
страница:  страницу
математический:  математическая математические математический математической
данные:  данных данным
определять:  определяющие определяющий
кажущийся:  кажущееся
искать:  искать
высекать:  высекает
интеграл:  интеграл интегралов интегралы интеграла интеграле
характеристика:  характеристика
урок:  урока уроке
разложение:  разложением разложение
косинус:  косинусы косинусами
склон:  склон склона склону
исходящий:  исходящий исходящего
ставить:  ставит
величина:  величину величина величин величины
икс:  икс
вывести:  выведем
пожаловать:  пожаловать
уравнение:  уравнению уравнения уравнение уравнений
биссектриса:  биссектрису биссектрисе биссектрисы
переход:  переход
поздравлять:  поздравляю
указывать:  указывать указывает указываем
плавно:  плавно
разбор:  разбор
отыскиваться:  отыскиваются
существо:  существу
очередь:  очередь очереди
забываться:  забывается
доступный:  доступен
перпендикулярно:  перпендикулярно
малый:  малые малому малом наименьших малый
связь:  связь связи
понятие:  понятием понятии понятие
точка:  точку точки точках точка точек точке
градус:  градусам градусов
подчёркивать:  подчёркивая подчёркиваю
плохо:  плохо
простой:  простая проще прост простых простой
нормальный:  нормальное
интегральнаятеорема:  интегральнаятеоремы
некоторый:  некоторой некоторую некоторому некоторых некоторое некоторые
корнимногочлен:  корнимногочлена
логарифмический:  логарифмическая
решить:  решил решить
оформлять:  оформляем
начать:  начнём начать
основной:  основные
нужный:  нужные нужен нужной
функция:  функцией функции функция функций функцию
применяться:  применяется
бернулли:  бернулли
полярный:  полярные полярных полярной
корректный:  корректного
рассмотреть:  рассмотрим рассмотрена
ряд:  ряды ряда ряд рядов
эффективность:  эффективностью
проявить:  проявить
уровень:  уровня
волнистый:  волнистые
ущелие:  ущелий
значительно:  значительно
доверительный:  доверительные
смысл:  смысле смысл смысла
буква:  буквой буква букву
среднееквадратический:  среднееквадратическое
коротко:  коротко
комбинационный:  комбинационная
декартов:  декартовой
листок:  листок
смешанноепроизведение:  смешанноепроизведение
пробел:  пробелы
дисперсия:  дисперсия дисперсии дисперсию
проверка:  проверки проверке проверка
миллион:  миллионы
школьный:  школьный школьные
высота:  высота высотой высоте высоты
мы:  нам нами
принадлежащий:  принадлежащую
образ:  образом
непрерывнаяслучайный:  непрерывнаяслучайная
ибо:  ибо
прямо:  прямо
длина:  длина длины длину
материал:  материал материалом материалу материала материалов материалы
хороший:  лучших лучшего хорошего хорошей
высмотреть:  высмотреть
крутой:  крутой крута
немного:  немного
мочь:  могут могла
знакопостоянство:  знакопостоянства
частный:  частная частное частные частных частной
градиент:  градиент градиента градиентом градиенту
расположить:  расположен
линия:  линия линии линию линиями
вспомнить:  вспомним
разнообразие:  разнообразия
ясно:  ясно
комбинаторика:  комбинаторике
полуось:  полуосью полуосями
случайнаявеличина:  случайнаявеличина
бесконечно:  бесконечно
форма:  формы
равный:  равны равные равна
знание:  знания знаний
отметить:  отметить
статья:  статьи
местность:  местности местность
взгрустнуться:  взгрустнулось
направление:  направлениям направлении направлениях направлением направление направления направлений направлению
задача:  задаче задачами задачи задачах задача
обратный:  обратную обратная
год:  годы
сонаправить:  сонаправленного сонаправленный сонаправлен
готовый:  готовых готов готовой
просто:  просто
получить:  получены полученные полученный получи
приём:  приём приёмом
ещё:  ещё
вычисление:  вычислениями вычисления вычисление
вернуться:  вернёмся вернуться вернитесь
свой:  своих
остриё:  острия
нахождение:  нахождения нахождение
частый:  чаще
мутноватый:  мутноватая
возможный:  возможных
данный:  данного данном данное данный
непрерывный:  непрерывных непрерывная
производныефункция:  производныефункции
средний:  средняя
единица:  единице
область:  области область
предположим:  предположим
далеко:  далеко
обычный:  обычной
математик:  математика
переменный:  переменных переменной
пример:  пример примеров примере примеры
несовместный:  несовместные
нумероваться:  нумеруются
расчёт:  расчёт
независимыеслучайный:  независимыеслучайные
модуль:  модулю
вверх:  вверх
координатный:  координатными координатных координатного координатной координатные
модель:  модель модели
непрерывность:  непрерывность
способ:  способами способом способ
добавляться:  добавляется
функциис:  функциис
полный:  полной полных полное
зеркало:  зеркало
начинать:  начинает
значит:  значит
пирсон:  пирсона
вопрос:  вопрос вопросы
традиция:  традициях
геометрический:  геометрических геометрический геометрическая геометрическим геометрического геометрическое геометрическом
межгрупповой:  межгрупповая
ортогональный:  ортогональное ортогональной
известный:  известный известном известным
высокий:  высокой высших высшей высшая
эквивалентный:  эквивалентный
полчаса:  полчаса
нсв:  нсв
призвать:  призвана
схема:  схему схема
встать:  встанем
придумать:  придумал
быстро:  быстро
упасть:  упал
отрезка:  отрезке
красный:  красный
поверхность:  поверхность поверхности
решение:  решению решение решением решения решений
внимательно:  внимательно
запись:  запись
правило:  правилам правила правило
локальный:  локального локальная
эстетический:  эстетических
короче:  короче
практический:  практическое практическая
квартира:  квартиры
отличие:  отличием отличие
плоский:  плоские
детерминация:  детерминации
перемещаться:  перемещаемся
подъём:  подъёма подъём
проходить:  проходящую проходит
выполнить:  выполнить выполните
дифференциальныеуравнение:  дифференциальныеуравнения
прямой:  прямая прямой прямую
получать:  получать
постоянный:  постоянных постоянными постоянна постоянной постоянный
стокс:  стокса
соответствие:  соответствие
ненадолго:  ненадолго
самостоятельно:  самостоятельно
дробовик:  дробовик
математика:  математике математики
векторный:  векторное векторного векторную
сам:  самом сами само самой
подготовить:  подготовленные
вероятностия:  вероятностии
скалярный:  скалярное
начальный:  начальную
совершенно:  совершенно
наш:  нашем наши наш нашей наша
значимость:  значимости
дать:  дана данному данная данной
ухищрение:  ухищрение
параллельный:  параллельный параллельна
анализ:  анализа анализ
построение:  построения построение
её:  её
парный:  парной
ссылка:  ссылку ссылка
примерный:  примерный
найти:  найдём найдена найдем найти найдут
неожиданный:  неожиданных
сборник:  сборники
верно:  верно
кошмарный:  кошмарном
параметрический:  параметрическом параметрической
отсутствие:  отсутствие
персонаж:  персонаж
независимость:  независимость
молодец:  молодцы
делать:  делаем
часто:  часто
ассоциироваться:  ассоциируются
получаться:  получается
перетекать:  перетекать
находить:  находим
другой:  другая другому другими другие другую
луч:  луча луч лучом
форум:  форум форуме
записывать:  записывать
книга:  книги книга
проявлять:  проявляем проявляйте
представлять:  представляемые представляет
настать:  настало настал
реальный:  реальное
задание:  задание заданий задания
содержательный:  содержательный
вектор:  векторы вектором векторов вектора вектор
вращение:  вращения
именно:  именно
горизонтальный:  горизонтальной
копирование:  копирование
давать:  давайте
разрыв:  разрыва
выражение:  выражения
совпадать:  совпадает совпадающего
использоваться:  используются
подразумевать:  подразумевают
убедительно:  убедительно
жёлтый:  желтая жёлтым
грубо:  грубо
отблагодарить:  отблагодарить
являться:  являются является
байес:  байеса
решать:  решать
таблица:  таблицу таблицы
перечитать:  перечитать
без:  безо
результат:  результат результата результате результаты
теория:  теория теорию теории
несвободный:  несвободный
характеризовать:  характеризует характеризующее
дифференцирование:  дифференцировании
главный:  главный главную
двумерный:  двумерная
выбрать:  выбрал выберем выберите
задать:  заданной задать заданы задайте заданное
приемлемый:  приемлем
тело:  тела
циркуляция:  циркуляция
непосредственно:  непосредственно
выкладка:  выкладкам выкладки
плоскость:  плоскости плоскостью плоскость
отношение:  отношение отношении
пол:  пол
общий:  общим общая общем общего общее
какой:  каком какому каким
определителяй:  определителяи
согласно:  согласно
положение:  положении
гора:  гор гору
закон:  законы
далее:  д далее
затруднение:  затруднения
завершать:  завершающий завершающем завершая завершающим
волшебный:  волшебный
показывать:  показывающий показывает показывать
вероятность:  вероятностей вероятность вероятности
универсальный:  универсальную
ладный:  ладно
заключение:  заключение
уравненийв:  уравненийв
отрезок:  отрезок отрезков
количество:  количества
грин:  грина
эйлер:  эйлера
взаимосвязь:  взаимосвязь
символизировать:  символизирует
знакомый:  знакомых знакомы
дискретный:  дискретный
направить:  направленный направленных направлены направлен
обязательный:  обязательным
знакочередоваться:  знакочередующиеся
сохранить:  сохраню
произвольный:  произвольных произвольную
сложный:  сложной сложные сложных
фурье:  фурье
поле:  поля
гипотеза:  гипотез гипотеза гипотезы
свойство:  свойства
мудрый:  мудрое
момент:  момент
исходный:  исходной
исследование:  исследование
весь:  всем вся всей
рассуждение:  рассуждений рассуждения
первый:  первую первой первого первый первые
проблема:  проблем
вариация:  вариации
тот:  та тому той
слой:  слоями
основа:  основы основах
слишком:  слишком
интервал:  интервалы
кош:  коши
такой:  таком таким такое такого
понятный:  понятный
параграф:  параграфа
выше:  выше
голова:  головы
составлять:  составляет составляющем составляющему
соответствующий:  соответствующих соответствующие
чайник:  чайников
исходить:  исходит исходя исходящим
вычисленияс:  вычисленияс
матричный:  матричные матричных матричный
понадобиться:  понадобятся
заметить:  заметили заметьте
ответ:  ответе ответ ответы
однородный:  однородные однородным
вычислить:  вычислить
очень:  очень
матрица:  матрицу матрицы матрицами
этап:  этапе
испытанияй:  испытанияи
интегралыть:  интегралыв
перегруппировка:  перегруппировка
пространственный:  пространственный пространственную пространственного
теоретический:  теоретическая теоретический
помощь:  помощью
начало:  начало начала начале
понять:  поняли понять
вариационный:  вариационный
отложить:  отложить отложите отложен отложенный
блог:  блог
крутизна:  крутизна крутизне крутизну
предложить:  предложенного предложена
отработать:  отработанным отработаем
пространство:  пространстве
удобный:  удобный
курс:  курс
координата:  координаты координат координатах
меняться:  меняется
описание:  описания
окончательно:  окончательно
сообщить:  сообщите
аналитический:  аналитическая аналитической
понижение:  понижение понижением
определить:  определить
финальный:  финальный
дорожка:  дорожку дорожка
ненулевой:  ненулевой
распространяться:  распространяется
центр:  центр
развернуть:  развёрнутое
производная:  производных
наклон:  наклона наклон
майский:  майское
изобразить:  изобразить изобразил
сверяться:  сверяемся
оставлять:  оставлял
сторона:  сторону сторонам
находиться:  находитесь находимся
осуществляться:  осуществляется
линейнойкорреляционный:  линейнойкорреляционной
синий:  синяя
действие:  действия
туда:  туда
время:  время
оставаться:  остаётся оставаться
кой:  коих коем
подарочный:  подарочный
особо:  особо
почему:  почему
распределениякритерия:  распределениякритерий
приобретать:  приобретает
рабочий:  рабочую
несобственный:  несобственные
следующий:  следующую следующей следующем
искомый:  искомая
зрение:  зрения
изменение:  изменения
черновик:  черновиком черновике
откуда:  откуда
экскурс:  экскурса
сон:  сне
череда:  черёд
единичный:  единичным единичный единичной единичного
определяться:  определяются определяется
касательная:  касательная касательной
ландшафт:  ландшафт ландшафте
задачис:  задачис
функциия:  функциии
возможно:  возможно
степенной:  степенного степенные
функцийдвуха:  функцийдвух
увлекательный:  увлекательной
выборка:  выборке
зависнуть:  зависло
обещать:  обещанный
покинуть:  покинуть
функцийнесколький:  функцийнескольких
удачный:  удачный удачных
рассчитать:  рассчитать
переключаться:  переключаемся
тематический:  тематические
рост:  роста
оценить:  оцените
множественнойлинейный:  множественнойлинейной
подтверждать:  подтверждает подтверждают
зависимость:  зависимости зависимость
классика:  классика
каждый:  каждой каждый
распределение:  распределение распределения
забывать:  забываем
заострять:  заостряю
аналогичный:  аналогичным аналогичная
оранжевый:  оранжевой
оказываться:  оказывается
задавать:  задаёт задающий задаваемые
этот:  этому эта
совпасть:  совпали совпавший
простота:  простоту
задачипо:  задачипо
пополам:  пополам
востребовать:  востребованную
приблизить:  приближенные
вариант:  вариант
образец:  образец
примечание:  примечание
поведение:  поведение
зависимый:  зависимые
походить:  походим
отклонение:  отклонение
избегать:  избегать
конкретный:  конкретное конкретной
произведение:  произведение
существование:  существования
вполне:  вполне
случайный:  случайных случайные
тон:  тона
дуга:  дуги
частность:  частности
численно:  численно
отрезкать:  отрезкав
дивергенция:  дивергенция
дотошный:  дотошные
спрятаться:  спрятался
чертёж:  чертежа чертёж чертеже
спасибо:  спасибо
полёт:  полётов
двигаться:  двигаться
сайт:  сайт сайты сайта
графика:  графики графика
оформление:  оформления
идти:  идёт
причина:  причине
возрастание:  возрастание возрастания
эмпирический:  эмпирические
найтись:  нашлось
спокойствие:  спокойствие
полезный:  полезный полезная
равнина:  равнина
аналогично:  аналогично
разбираться:  разбираться
иррациональный:  иррациональных
определение:  определению определения
получиться:  получился
квадратичнуюформ:  квадратичнуюформу
карта:  карта карту
аккуратность:  аккуратность
прежний:  прежним
гипербола:  гипербола
они:  ними
обозначение:  обозначение обозначении обозначения
логика:  логики
спирмена:  спирмена
вид:  виду виды виде
возникать:  возникает
подвести:  подвёл подвести
св:  св
строгий:  строгими
второй:  второго второй
параллельно:  параллельно
иметь:  имеет
целый:  целую
пара:  пара
нипочём:  нипочём
долгий:  долгие
достаточно:  достаточно
показательный:  показательное
преобразование:  преобразования преобразований
тушеваться:  тушуемся
диффура:  диффурами
узнать:  узнать
проверять:  проверяемыми
весьма:  весьма
множество:  множество множества
сообщать:  сообщает
использовать:  используем использовать используйте
статистика:  статистика
неизменный:  неизменной
биномиальный:  биномиальное
аналог:  аналогам
божий:  божий
линиюв:  линиюв
история:  история
самостоятельный:  самостоятельного
справедливый:  справедливы
безмятежно:  безмятежно
отработка:  отработки
сантиметр:  сантиметре
установить:  установлено
дуприближённо:  дуприближённо
асимптота:  асимптоты
событие:  события
повторный:  повторные
приращение:  приращения
гаджет:  гаджетов
сосредоточенно:  сосредоточенно
б:  б
знать:  знает
состоять:  состоит
осмотреться:  осмотритесь
константа:  константы
всякий:  всякого всякий
геодезия:  геодезии
фнп:  фнп
простейшее:  простейшие
иной:  иными иному
взвыть:  взвыть
конец:  конце
размяться:  разомнёмся
часть:  частям часть части
приступать:  приступать
двойной:  двойные двойной
встреча:  встреч
несобство:  несобств
нелинейный:  нелинейная
преобразованиеквадратичный:  преобразованиеквадратичной
новый:  новым новому нового
напрашиваться:  напрашивается
функциональный:  функциональные
убывание:  убывании
глаз:  глаз
час:  час
электрический:  электрические
абсолютный:  абсолютная
комментарий:  комментариев
встречаться:  встречаются встречается
сложенияй:  сложенияи
сохраняться:  сохраняться сохраняются
регрессия:  регрессии регрессия
контроль:  контроль контроля
прозевать:  прозевать
вычислительный:  вычислительных
забыть:  забудем
рассказать:  расскажу рассказал
исчисление:  исчисления
повышеный:  повышеное
прогулка:  прогулки
гораздо:  гораздо
сказать:  сказать
ожидание:  ожидание
лаплас:  лапласа
перегиб:  перегиба
лежать:  лежащим лежит лежащего
предыдущий:  предыдущем
сходимость:  сходимости сходимость
представить:  представьте
достигать:  достигает
занятный:  позанятнее
ду:  ду
коэффициент:  коэффициент
неопределённый:  неопределенный неопределенном
дробь:  дробей
собственный:  собственные
типовик:  типовиков
признак:  признак признаки
соображение:  соображений
поэтому:  поэтому
практика:  практике практику
принцип:  принципе
жанр:  жанра
никакой:  никаких
асимметрия:  асимметрия
край:  край
сводиться:  сводящиеся
собственно:  собственно
замена:  замены
алгоритм:  алгоритма алгоритм
умещаться:  умещаться
записать:  запишем записать
маленький:  меньше
составить:  составим составить составит
например:  например
решенияопределённый:  решенияопределенных
мерило:  мерилом
задаваться:  задаётся
ориентировочный:  ориентировочный
коэффициентковариация:  коэффициентковариации
проекция:  проекцией проекция
обозначить:  обозначим обозначил
широкий:  широком
помешать:  помешает
лопиталя:  лопиталя
называться:  называется
поляформула:  поляформула
чёрный:  чёрного чёрную
фехнера:  фехнера
прозвонить:  прозвонить
эффективный:  эффективные
популярный:  популярна
условный:  условные
эллипс:  эллипс
забавный:  забавную
даламбер:  даламбера
теорема:  теоремы
факт:  факт
повторнойя:  повторнойи
естественно:  естественно
комплексный:  комплексные комплексного комплексный комплексными
ранг:  ранг
расписывать:  расписывать
кривая:  кривой
тяжестиплоска:  тяжестиплоской
ориентация:  ориентация
обобщить:  обобщили
назвать:  назвать
построить:  построить
хотеть:  хочу
максимальный:  максимального максимальную максимальный максимальная
смешанный:  смешанные
осилить:  осилили
внимание:  внимание
лейбниц:  лейбница
черновой:  черновое
ради:  ради
неравенство:  неравенства
поток:  поток
переместиться:  переместитесь
соседний:  соседней
медиана:  медиана
бывать:  бывает
направлениюй:  направлениюи
гостевой:  гостевая
аккуратно:  аккуратно
подстановка:  подстановку
понятно:  понятно
употребление:  употреблению
вывод:  вывод
внутригрупповаяй:  внутригрупповаяи
зависеть:  зависит
алгебра:  алгебры
сумма:  сумму сумма
символический:  символических
невероятно:  невероятно
существовать:  существует существовать
прямоугольник:  прямоугольников
эксцессэмпирический:  эксцессэмпирического
приободрить:  приободрить
говорить:  говорит говоря
оценка:  оценка оценки
криволинейный:  криволинейные
различный:  различных различным
библиотека:  библиотека
настолько:  настолько
скала:  скала
добро:  добро
наименьшеезначение:  наименьшеезначения
сила:  силы
задачка:  задачка
послать:  пошли
вычислимый:  вычислим
запросто:  запросто
великое:  великое
разница:  разницы
системылинейный:  системылинейных
нужно:  нужно
смело:  смело
чистовой:  чистового чистовое
интересный:  интересного
эф:  эф
физика:  физики
замкнутый:  замкнутому
негоризонтальный:  негоризонтальная
октант:  октанте
цепочка:  цепочку
очевидный:  очевидно
пройти:  пройдёт
проверить:  проверим проверить
желать:  желаю
благо:  благо
показатель:  показатели
тычок:  тычка
площадьс:  площадьс
естествоиспытатель:  естествоиспытатели
эль:  эль
убыванией:  убываниеи
повышенный:  повышенной
статистический:  статистическая статистические
пригревать:  пригревает
также:  также
интегрирование:  интегрирование
охарактеризовать:  охарактеризовать охарактеризует
легко:  легко
рациональный:  рациональные
нуль:  нулю нуля
интервальный:  интервальный
итак:  итак
соответственно:  соответственно
рука:  руку
вообще:  вообще
принадлежать:  принадлежит
оценкия:  оценкии
неявный:  неявной
несобственныхинтеграл:  несобственныхинтегралов
вероятностибиномиальный:  вероятностибиномиального
изменчивый:  изменчива
физический:  физический физических
обывательский:  обывательский
род:  рода
гаусс:  гаусса
сегодняшний:  сегодняшнего
интересовать:  интересующих
душный:  душные
рельеф:  рельеф
особый:  особых
выразить:  выразить
точно:  точно
экстремальный:  экстремальные
учёт:  учётом
нормаль:  нормали
путешествие:  путешествия
определитель:  определитель
позиция:  позиций
скорость:  скорость скорости
быстрый:  наибыстрейшего
верхний:  верхней верхнюю
выпуклость:  выпуклость
вышеизложенный:  вышеизложенному
элемент:  элементы
закреплять:  закрепляем
отсюда:  отсюда
сложность:  сложности
инструментарий:  инструментарий
значенияй:  значенияи
протестировать:  протестируем
некий:  некоего
кстати:  кстати
классическоеопределение:  классическоеопределение
инормаль:  инормаль
природа:  природу
пирамида:  пирамида
автор:  автор автора
неприятный:  неприятными
понимание:  понимания
ошибаться:  ошибаются
прочувствовать:  прочувствовать
дифференциальный:  дифференциальные
уравненияс:  уравненияс
онлайн:  онлайн
наступать:  наступает
геометрия:  геометрии геометрия
работа:  работа
произвольныйтройный:  произвольныйтройной
дизайн:  дизайна
температура:  температуру температуры
это:  это
встроить:  встроил
семестр:  семестра
поляй:  поляи
место:  местах
опечатка:  опечатку
отличный:  отличное
комната:  комнате
продолжать:  продолжаем
речь:  речь
познакомиться:  познакомились
показаться:  показалась
выбор:  выбора
посвятить:  посвящены
методомоперационный:  методомоперационного
бесповторный:  бесповторной
л:  л
помочь:  поможет
трёхмерный:  трёхмерным трёхмерного
контекст:  контекста
взять:  взять взятой
касательный:  касательных
типовыхзадача:  типовыхзадач
ранговойкорреляция:  ранговойкорреляции
отнестись:  отнесёмся
отдельно:  отдельно
извращаться:  извращаться
отыскать:  отыскать
расслабляться:  расслабляться
жизнь:  жизни
упущение:  упущение
квадратный:  квадратном
необходимый:  необходима
исследовать:  исследовать
одеяло:  одеяла одеяло
линейныйкоэффициент:  линейныйкоэффициент
несобственныйинтеграл:  несобственныйинтеграл
доступно:  доступно
удобство:  удобства
причём:  причём
учиться:  учимся
напоминать:  напоминает напоминаю
молчание:  молчание
ипример:  ипримеры
требоваться:  требуется требовалось
поверхностный:  поверхностные
холм:  холма
фигура:  фигуры
пуассон:  пуассона
изучение:  изучению
недопонять:  недопонятым
однако:  однако
приводиться:  приводится
ожидать:  ожидает
таки:  таки
несмотря:  несмотря
убывать:  убывает
благополучно:  благополучно
математическоеожидание:  математическоеожидание
воспользоваться:  воспользуемся
школа:  школа
подобрать:  подберут
неоднородный:  неоднородные
возрастать:  возрастает
вычислять:  вычислять
кратное:  кратные
системудифференциальный:  системудифференциальных
провести:  проведите проведённые
помимо:  помимо
традиционно:  традиционно
итог:  итог
последовательность:  последовательностей
развитие:  развитием
квадратичный:  квадратичные
расписать:  расписать
объём:  объем
впереди:  впереди
измерение:  измерение
принять:  приняты
поскольку:  поскольку
гипергеометрическоераспределение:  гипергеометрическоераспределение
оба:  обоих
человек:  люди
подробно:  подробно
равномерный:  равномерная равномерное
иначе:  иначе
треугольный:  треугольная
исключительно:  исключительно
вероятный:  вероятнее
картина:  картина
пожалуйста:  пожалуйста
следовать:  следует
себя:  собой
однозначно:  однозначно
квадрат:  квадратов
ответственность:  ответственностью
запрашивать:  запрашивать
сразу:  сразу
функциюкомплексный:  функциюкомплексной
мода:  мода
свойстваэлементарный:  свойстваэлементарных
стандартный:  стандартной
калькулятор:  калькулятор
волна:  волны
научиться:  научиться
спрашиваться:  спрашиваться
эталон:  эталону
делить:  делит
похоже:  похоже
учебный:  учебной
средство:  средство
стандарт:  стандарты
формально:  формально
определённый:  определенный определенного
шанс:  шансов
кратный:  кратный
предлагать:  предлагаю
действительно:  действительно
экстремум:  экстремумы
горнера:  горнера
дорога:  дороге
выйти:  выйдем выйти
распространить:  распространённые
функцийв:  функцийв
ознакомиться:  ознакомиться
видеть:  видите
полог:  полога
минимум:  минимум
довольно:  довольно
чудесный:  чудесным
лишний:  лишним
возникнуть:  возникли
три:  трёх
дискретнойслучайный:  дискретнойслучайной
знак:  знак
тангенс:  тангенсу
разновидность:  разновидностей
бета:  бетой
буквально:  буквально
крамер:  крамера
вкладываться:  вкладывались
немало:  немало
левый:  левую
правда:  правда
парабола:  парабола
дополнительный:  дополнительного
запретить:  запрещено
функциидвуха:  функциидвух
емелин:  емелин
широко:  широко
вычисленияопределенный:  вычисленияопределенных
задачин:  задачина
замечательный:  замечательные
системый:  системыи
удовлетворяетлить:  удовлетворяетли
зелёный:  зелёного
сделать:  сделайте
сегодня:  сегодня
прорешать:  прорешайте
тригонометрический:  тригонометрических тригонометрическую
обозначаться:  обозначается
аналитически:  аналитически
чётко:  чётко
проставить:  проставил
понимать:  понимают
заданав:  заданав
порядок:  порядка порядков
всё:  всё
что:  чём
тройной:  тройные
деление:  деления
контуруформула:  контуруформула
график:  график
дело:  дела деле дело
наклонный:  наклонен
пропасть:  пропасть
одуванчик:  одуванчик
либо:  либо
независимый:  независимые
зет:  зет
привести:  привести
передвигаться:  передвигались
корреляция:  корреляции
наверстать:  наверстать
заочник:  заочников
повторять:  повторяем
закрепить:  закрепим
литература:  литературе
