прибавиться:  прибавилось прибавились
скобка:  скобками скобку скобок скобка скобке
верхний:  верхнего верхний
новый:  новых новой новые новый новому новыми
неоднократно:  неоднократно
производный:  производные производная производной производную
ум:  ума уме
предел:  предел пределами пределы пределов предела
облом:  облом
числовой:  числовые
путаться:  путаемся
табличный:  табличный табличном
производныенеявно:  производныенеявно
значение:  значение значения
отрицательный:  отрицательные отрицательному отрицательными
непрерывный:  непрерывной непрерывных непрерывная непрерывна
стопудовый:  стопудово
находить:  находить находил находим нахожу
формула:  формулы формулой формуле формула формулу
преждевременный:  преждевременным
особенно:  особенно
канонический:  каноническому
дифференциал:  дифференциалах дифференциал дифференциала
повышенный:  повышенный повышенной
больший:  наибольшее
преимущество:  преимущество преимуществами
проводиться:  проводится
академичный:  академичной
точечный:  точечными
ньютон:  ньютоном
число:  число числами числу числа
вогнутостья:  вогнутостьи
преспокойно:  преспокойно
становиться:  становится
выяснить:  выяснить
первообразный:  первообразных первообразная первообразной первообразную
рыпаться:  рыпаться
случай:  случай случае случаях
потеряться:  потеряется
убедиться:  убедиться убедитесь
профессия:  профессию
указание:  указанием
пусть:  пусть
определённый:  определенном определённого определенному определенных определенные определенный определенного определённый
умножение:  умножения
система:  система системе систему системы
группировка:  группировок группировка
условнаясходимость:  условнаясходимость
краткий:  кратким
александр:  александр
роспись:  росписью
уровень:  уровень уровня
контрольный:  контрольной
который:  которые который которых которой
линейный:  линейные линейная линейных линейной
разрешимый:  разрешим
запись:  записи запись
согласие:  согласия
совет:  совет
решать:  решаем решать
дуоперационный:  дуоперационным
базис:  базисах базису базис
зависимостьвектор:  зависимостьвекторов
бесконечный:  бесконечные
снова:  снова
предложный:  предложен
день:  день дня
сначала:  сначала
метод:  методы методом метод
тема:  теме
страница:  страницу
смотреть:  смотрим
математический:  математическая математического математические математической
данные:  данных
интеграл:  интеграл интегралу интегралов интегралах интегралы интеграла интегралом интеграле
урок:  урока уроком урок уроке
разложение:  разложением разложение
доводиться:  доводится
лишний:  лишние лишней
икс:  икс
уравнение:  уравнению уравнения уравнение уравнений
обыкновенный:  обыкновенных обыкновенные
переход:  переход перехода
разбор:  разбор
желательно:  желательно
первый:  первое первым первая первом первого первый
найти:  найденных найденную нашел найдена найден найти
целесообразно:  целесообразно
малый:  малые наименьших меньший
связь:  связь
применение:  применение применения
нормальный:  нормальное
интегральнаятеорема:  интегральнаятеоремы
корнимногочлен:  корнимногочлена
логарифмический:  логарифмическая
основной:  основные
применяться:  применяется
заглянуть:  загляните
бернулли:  бернулли
полярный:  полярные полярных полярной
рассмотреть:  рассмотрим рассмотренном рассмотренный
ряд:  ряды ряда ряд рядов
разбиение:  разбиения
закипеть:  закипел
появление:  появления
значительно:  значительно
посетитель:  посетителям
вычисляться:  вычисляется
доверительный:  доверительные
буква:  буквой
смысл:  смысле смысл смысла
всевозможный:  всевозможных
прочитать:  прочитал
среднееквадратический:  среднееквадратическое
бессмысленно:  бессмысленно
комбинационный:  комбинационная
помогать:  помогать
смешанноепроизведение:  смешанноепроизведение
функция:  функции функция функций функцию
дисперсия:  дисперсия дисперсии дисперсию
постараться:  постарайтесь постараюсь
школьный:  школьный
образ:  образом
непрерывнаяслучайный:  непрерывнаяслучайная
длина:  длина
работа:  работе работа
материал:  материал материалу материалов материалы
немного:  немного
мочь:  могут
знакопостоянство:  знакопостоянства
проводить:  проводить провожу проводим
площадь:  площади площадь
неплохо:  неплохо
попробовать:  попробуйте
градиент:  градиент
логарифм:  логарифмов логарифм
трудность:  трудности
линия:  линия линии линию линиями
практический:  практическим
технический:  техническим технических
комбинаторика:  комбинаторике
случайнаявеличина:  случайнаявеличина
бесконечно:  бесконечно
плюс:  плюсом
неопределённый:  неопределенного неопределенные неопределенных неопределенный неопределенным неопределенном
встречаться:  встречался встречающаяся встречались встречается
форма:  формы
задача:  задачу задачи задача
статья:  статьи статье
подынтегральный:  подынтегральной подынтегрального подынтегральная
окончательный:  окончательный
существовать:  существовал существует
обратный:  обратную обратная обратных
дополнительный:  дополнительные дополнительный
третий:  третий третьем
готовый:  готовых готово
просто:  просто
подготовка:  подготовка подготовки
ещё:  ещё
слагаемое:  слагаемом слагаемых
переставить:  переставить
превратить:  превратить
частый:  чаще
очевидный:  очевидна очевидный очевидно
данный:  данного данном данный
вступление:  вступление
производныефункция:  производныефункции
средний:  средняя
замечательный:  замечательную замечательные
область:  области область
недостаток:  недостатки
уместно:  уместно
математик:  математика
переменный:  переменных переменной
пример:  пример примеру примера примеров примерам примерах примеры
разность:  разность
несовместный:  несовместные
независимыеслучайный:  независимыеслучайные
никакой:  никакого никаких
мучиться:  мучался
модель:  модель модели
непрерывность:  непрерывность
минус:  минус
содержать:  содержит
догадаться:  догадаться
добавляться:  добавляется добавляются
четвёртый:  четвёртой четвертую
небольшой:  небольшое
рациональный:  рационален рациональные
функциис:  функциис
полный:  полной полных полное
зеркало:  зеркало
второй:  втором второго второй
значит:  значит
исходный:  исходная
пирсон:  пирсона
вопрос:  вопрос вопроса вопросе вопросом вопросы
межгрупповой:  межгрупповая
ортогональный:  ортогональное
разрыв:  разрывами разрыва разрывы
ошибка:  ошибки ошибку ошибок
нсв:  нсв
здорово:  здорово
вроде:  вроде
упасть:  упал
один:  одно одним одна одной
писать:  пишут
отрезка:  отрезке
остаться:  оставшихся оставшегося оставшаяся
величина:  величина величин величины
решение:  решению решение решении решением решения решений
внимательно:  внимательно
интегрировать:  интегрируем интегрировать
самый:  самая самый самое
детерминация:  детерминации
путаница:  путаница
обязательно:  обязательно
следующий:  следующие следующий
начать:  начать
дифференциальныеуравнение:  дифференциальныеуравнения
прямой:  прямая прямой прямую
подстановка:  подстановке подстановках подстановки подстановка
постоянный:  постоянных
стокс:  стокса
схема:  схема
кой:  коим
самостоятельно:  самостоятельно
степень:  степень степени
заключительный:  заключительных
дробовик:  дробовик
математика:  математике математики
векторный:  векторное векторного
ваш:  ваши
вероятностия:  вероятностии
скалярный:  скалярное
совершенно:  совершенно
наш:  нашем наш нашу
значимость:  значимости
старуха:  старуху
страшный:  страшного
методический:  методическому методический
несобственный:  несобственный несобственные несобственных
такой:  такую таком таким такие такое такого такая
вышеуказанный:  вышеуказанных
казус:  казус
анализ:  анализа анализ
её:  её
частный:  частное частные
парный:  парной
вычисление:  вычислении вычисления вычисление вычислений вычислениях
несколько:  несколько
несомненный:  несомненными
сборник:  сборники
верно:  верно
параметрический:  параметрическом параметрической
молодость:  молодости
таблица:  таблице таблицу таблицы
часто:  часто
замучаться:  замучаться
неправильно:  неправильно
получаться:  получается
хороший:  хороший
какой:  какие
способ:  способа способе способом способ
место:  место
форум:  форум форуме
записывать:  записывать записываем
знак:  знаках знак
книга:  книги книга
провести:  провести провели проведем
менять:  менять
устно:  устно
вынести:  вынести
недолюбливать:  недолюбливаю
сложный:  сложным сложной сложного сложные сложных сложен
вектор:  векторы векторов
внимательный:  внимательны
вращение:  вращения
сохранить:  сохрани
копирование:  копирование
обходиться:  обходится обхожусь
выражение:  выражения выражение
отблагодарить:  отблагодарить
байес:  байеса
рассматривать:  рассматриваемому
теория:  теория теории
главный:  главный главную
двумерный:  двумерная
задать:  заданной задайте
популярный:  популярной популярная
тело:  тела
циркуляция:  циркуляция
обыденно:  обыденно
плоскость:  плоскости плоскость
пол:  пол
общий:  общим общая общем
оставить:  оставить
определителяй:  определителяи
выносить:  выносим
значок:  значки
дважды:  дважды
закон:  законы
дробь:  дроби дробей
справа:  справа
последний:  последнем
вероятность:  вероятностей вероятность вероятности
сравнение:  сравнению
заключение:  заключение
уравненийв:  уравненийв
быстрота:  быстрота
студенческий:  студенческой
отрезок:  отрезок отрезка отрезком
количество:  количества
переписать:  переписать
грин:  грина
суть:  сути
входить:  входит
эйлер:  эйлера
мешаться:  мешалась
геометрический:  геометрический геометрическая геометрическое геометрическом
каждый:  каждого
невнимательность:  невнимательности невнимательность
разбиваться:  разбивается
дискретный:  дискретный
знакочередоваться:  знакочередующиеся
обнаружить:  обнаружил
рассказать:  рассказать
голова:  голову
произвольный:  произвольных
фурье:  фурье
дать:  дан дать данная
поле:  поля
гипотеза:  гипотез гипотеза гипотезы
свойство:  свойства свойств свойство
проинтегрировать:  проинтегрировал
исследование:  исследование
вариант:  варианте
рассуждение:  рассуждений
точка:  точки точках точке
вариация:  вариации
пойти:  пойдет
основа:  основы
студент:  студент
десятка:  десяток десятки
интервал:  интервалы
кош:  коши
параграф:  параграфа параграфе
чайник:  чайников чайник
вычисленияс:  вычисленияс
глаз:  глазами
матричный:  матричные матричных матричный
заметить:  заметили заметить
навык:  навыки навыков
однородный:  однородные однородным
вычислить:  вычислить
очень:  очень
начинать:  начинаете
корень:  корнем корень
фактический:  фактического
матрица:  матрицу матрицы матрицами
этап:  этапе этап этапы
испытанияй:  испытанияи
интегралыть:  интегралыв
привыкнуть:  привык
палочка:  палочка
квадратный:  квадратным
перегруппировка:  перегруппировка
помощь:  помощью
изначальный:  изначальная
вариационный:  вариационный
элементарный:  элементарных
поход:  похода
стандартно:  стандартно
казаться:  кажется казалось
блог:  блог
высокий:  высших высшей высшая
школа:  школы школа
произведение:  произведения произведение
познавательный:  познавательный
универсальный:  универсальной
пространство:  пространстве
удобный:  удобный удобнее
путь:  путь
курс:  курс курса
последующий:  последующей
быть:  будьте будут
снежный:  снежная
координата:  координаты координат координатах
нигде:  нигде
сообщить:  сообщите
перейти:  перейдем
сделать:  сделать
аналитический:  аналитическая аналитической
понижение:  понижение понижением
центр:  центр
решить:  решит решить решу
отчёркивание:  отчёркивание отчёркиванием
позволить:  позволит
нелегальный:  нелегальна
исчисление:  исчисление исчисления
терпеть:  терпит
допустить:  допустит допустить
новизна:  новизна новизны
напрасный:  напрасной
быстрый:  быстрее
затем:  затем
построение:  построение
проверка:  проверку проверка
линейнойкорреляционный:  линейнойкорреляционной
действие:  действия
важный:  важная важна важных
существенно:  существенно
время:  время времени
готовить:  готовим
почему:  почему
распределениякритерия:  распределениякритерий
хотеть:  хотел
сверхбыстрый:  сверхбыстрой
рациональность:  рациональности
зрение:  зрения
письмо:  письме письма
касательная:  касательная
ответ:  ответ ответы
задачис:  задачис
дальнейший:  дальнейшие дальнейших
друг:  другом
правило:  правила правило
замена:  заменой замену замене замены заменами замен замена
функциия:  функциии
степенной:  степенного степенные
функцийдвуха:  функцийдвух
выборка:  выборке
сам:  сама самой
функцийнесколький:  функцийнескольких
звено:  звено
выполнить:  выполнив
чисто:  чисто
квадрат:  квадрат квадратов
множественнойлинейный:  множественнойлинейной
нахождение:  нахождением
распределение:  распределение распределения
заострять:  заостряю
задачипо:  задачипо
востребовать:  востребованную
приблизить:  приближенные
примечание:  примечание примечания
выкладка:  выкладки
зависимый:  зависимые
отклонение:  отклонение
лекция:  лекция
появиться:  появившуюся появился
случайный:  случайных случайные
дуга:  дуги
отрезкать:  отрезкав
знакомый:  знакомой
дивергенция:  дивергенция
спасибо:  спасибо
сайт:  сайт сайте сайты сайта
графика:  графики графика
простой:  простейший простой
стремиться:  стремимся
обычный:  обычное
поступить:  поступил
прорешать:  прорешали
неверно:  неверно
идти:  идёт
причина:  причине
возрастание:  возрастание
эмпирический:  эмпирические
найтись:  нашлось
арктангенс:  арктангенса
иррациональный:  иррациональных
определение:  определению определения
квадратичнуюформ:  квадратичнуюформу
карта:  карта
опускать:  опускать
гипербола:  гипербола
равно:  равно
они:  ними
обозначение:  обозначение
логика:  логики
спирмена:  спирмена
интегрирование:  интегрированием интегрирование интегрирования
вид:  виду виды виде
вовсе:  вовсе
лишь:  лишь
св:  св
иметь:  имеет
пара:  пара
достаточно:  достаточно
похожий:  похожа
показательный:  показательное
преобразование:  преобразования преобразований
диффура:  диффурами
подробный:  подробным
подолгу:  подолгу
использовать:  используем использовал использовать используйте
статистика:  статистика
подставлять:  подставляем подставлять
биномиальный:  биномиальное
линиюв:  линиюв
самостоятельный:  самостоятельного
справедливый:  справедливы справедлива
отношение:  отношении
короткий:  короткого коротким
дифференцировать:  дифференцируем
случиться:  случился
нижний:  нижнего нижний
дуприближённо:  дуприближённо
асимптота:  асимптоты
событие:  события
неувязочка:  неувязочка
повторный:  повторные
порядок:  порядок порядка порядков
состоять:  состоит
константа:  константы константа константу
вышесказанный:  вышесказанного
фнп:  фнп
простейшее:  простейшие
передел:  переделы
конец:  конце
часть:  частям часть
изучить:  изучите
двойной:  двойные двойной
компактный:  компактнее компактном
несобство:  несобств
нелинейный:  нелинейная
применить:  применить
преобразованиеквадратичный:  преобразованиеквадратичной
напрашиваться:  напрашивается
дифференцирование:  дифференцированием
функциональный:  функциональные
электронный:  электронном
освоить:  освоить
ответить:  ответить
абсолютный:  абсолютная
сложенияй:  сложенияи
регрессия:  регрессии регрессия
свой:  свой своя
уважаемый:  уважаемый
распечатать:  распечатай
деталь:  деталь
отделить:  отделить
применительно:  применительно
гораздо:  гораздо
локальный:  локальная
ожидание:  ожидание
лаплас:  лапласа
перегиб:  перегиба
сходимость:  сходимости сходимость
порнуха:  порнуха
ду:  ду
далее:  далее
делать:  делать
коэффициент:  коэффициент
собственный:  собственные
признак:  признак признаки
запутаться:  запутаться
соображение:  соображений
рядом:  рядом
упрощённый:  упрощенном
поэтому:  поэтому
практика:  практике
рекомендация:  рекомендация
лейбниц:  лейбницем лейбница
асимметрия:  асимметрия
расписываться:  расписывается
риск:  риск
сводиться:  сводящиеся
маленький:  меньше
например:  например
подвести:  подвести
решенияопределённый:  решенияопределенных
разобрать:  разобран разберем
выглядеть:  выглядит
приём:  приёмов
подобрать:  подобрал
тангенс:  тангенса тангенс
коэффициентковариация:  коэффициентковариации
отмахнуться:  отмахнуться
длинный:  длинный
лопиталя:  лопиталя
называться:  называется
обычно:  обычно
нужный:  нужна нужной
поменять:  поменять
тип:  типы тип
поляформула:  поляформула
тригонометрический:  тригонометрической тригонометрических
фехнера:  фехнера
трудный:  трудной
эффективный:  эффективные
мелкий:  мелкие
условный:  условные
эллипс:  эллипс
ноль:  ноль
поговорить:  поговорим
пи:  пи
сократить:  сократить
стараться:  старайтесь
хватать:  хватает
таскать:  таскать
даламбер:  даламбера
теорема:  теоремы
факт:  факт
отдельный:  отдельный отдельная
повторнойя:  повторнойи
естественно:  естественно
комплексный:  комплексные комплексного комплексный комплексными
ранг:  ранг
кривая:  кривой
тяжестиплоска:  тяжестиплоской
правомерность:  правомерности
касаться:  касается
построить:  построить
внимание:  внимание
неравенство:  неравенства
поток:  поток
подставить:  подставил
кто:  кого
медиана:  медиана
бывать:  бывает бывал
записать:  записать
направлениюй:  направлениюи
благодаря:  благодаря
гостевой:  гостевая
кроме:  кроме
равный:  равен
понятно:  понятно
знание:  знаний
внутригрупповаяй:  внутригрупповаяи
алгебра:  алгебры
сумма:  сумму сумма сумм
повысить:  повысить
прямоугольник:  прямоугольников
получиться:  получиться получилась
вышерассмотреть:  вышерассмотренный
эксцессэмпирический:  эксцессэмпирического
оценка:  оценка оценки
криволинейный:  криволинейные
различный:  различных
листочек:  листочек
библиотека:  библиотека
идея:  идея
некорректный:  некорректной
возможность:  возможности
наименьшеезначение:  наименьшеезначения
сила:  силы
протяжение:  протяжении
интегральный:  интегральных интегральное
выяснять:  выясняем
системылинейный:  системылинейных
нужно:  нужно
закуска:  закуску
зависимость:  зависимость
другой:  другие
замкнутый:  замкнутому
бесконечность:  бесконечность
желать:  желаю
линейность:  линейности
немедленно:  немедленно
показатель:  показатели
отличие:  отличие
площадьс:  площадьс
убыванией:  убываниеи
статистический:  статистическая статистические
также:  также
метель:  метель
пока:  пока
нуль:  нулю
ситуация:  ситуация
некоторый:  некоторых некоторые
интервальный:  интервальный
окно:  окном
мера:  мере
вообще:  вообще
сменить:  сменив
целиковый:  целиковую
лично:  лично
оценкия:  оценкии
неявный:  неявной
несобственныхинтеграл:  несобственныхинтегралов
вероятностибиномиальный:  вероятностибиномиального
род:  рода
гаусс:  гаусса
честно:  честно
полезно:  полезно
выгода:  выгода
точно:  точно
экстремальный:  экстремальные
нормаль:  нормали
определитель:  определитель
выпуклость:  выпуклость
старый:  старые
элемент:  элементы
шаг:  шаг
менее:  менее
сложность:  сложности
значенияй:  значенияи
рекомендовать:  рекомендуемый рекомендую
ломать:  ломал
справедливо:  справедливо
кстати:  кстати
зачёт:  зачете
классическоеопределение:  классическоеопределение
прикидывать:  прикидываем
инормаль:  инормаль
экзамен:  экзамене
далёкий:  дальше
пирамида:  пирамида
любой:  любого
автор:  автор автора
приступить:  приступить
дифференциальный:  дифференциальные
уравненияс:  уравненияс
онлайн:  онлайн
геометрия:  геометрии геометрия
произвольныйтройный:  произвольныйтройной
дизайн:  дизайна
это:  это
поляй:  поляи
находиться:  находится
опечатка:  опечатку
машинально:  машинально
продолжать:  продолжаем
речь:  речь
формулировка:  формулировка
методомоперационный:  методомоперационного
бесповторный:  бесповторной
мой:  моём моей
правильно:  правильно
л:  л
нести:  несет
вещь:  вещь
привычный:  привычный
касательный:  касательных
типовыхзадача:  типовыхзадач
ранговойкорреляция:  ранговойкорреляции
существенный:  существенная
добавлять:  добавлять
отвести:  отведена
исследовать:  исследовать
поверхность:  поверхности
линейныйкоэффициент:  линейныйкоэффициент
брать:  берем
несобственныйинтеграл:  несобственныйинтеграл
знаменатель:  знаменателе
доступно:  доступно
опыт:  опыте
повториться:  повторюсь
логично:  логично
учиться:  учимся
задавать:  задаваемые
отчёркивать:  отчеркиваем
ипример:  ипримеры
вертикальный:  вертикальная
особый:  особое
множество:  множества
поверхностный:  поверхностные
фигура:  фигуры
пуассон:  пуассона
подобный:  подобные подобный
успех:  успехов
большой:  большое
однако:  однако
математическоеожидание:  математическоеожидание
неоднородный:  неоднородные
необходимо:  необходимо
проверять:  проверяем
участвовать:  участвовать
сказать:  скажу
обратиться:  обратиться
кратное:  кратные
системудифференциальный:  системудифференциальных
усложнять:  усложняем
получить:  получена получили получи
рассчитывать:  рассчитываем
уметь:  уметь
алгоритм:  алгоритм
последовательность:  последовательностей
квадратичный:  квадратичные
объём:  объем
превратиться:  превратится
проверить:  проверить
поскольку:  поскольку
гипергеометрическоераспределение:  гипергеометрическоераспределение
обратить:  обратите
подробно:  подробно
равномерный:  равномерная равномерное
треугольный:  треугольная
пожалуйста:  пожалуйста
ориентироваться:  ориентироваться
записываться:  записывается
следовать:  следует
момент:  моментов
себя:  собой
запас:  запасе
сразу:  сразу
функциюкомплексный:  функциюкомплексной
единственный:  единственный
мода:  мода
подводить:  подводим
свойстваэлементарный:  свойстваэлементарных
калькулятор:  калькулятор калькуляторе
научиться:  научиться
реально:  реально
ерунда:  ерунды ерунда
разделять:  разделяя
действительно:  действительно
экстремум:  экстремумы
горнера:  горнера
предельно:  предельно
применять:  применяем
получать:  получаем
компактность:  компактность
функцийв:  функцийв
ознакомиться:  ознакомиться
видеть:  видите
допускать:  допускают
должный:  должна
возникнуть:  возникли
три:  трёх
дискретнойслучайный:  дискретнойслучайной
задание:  задания
соответствие:  соответствии
буквально:  буквально
крамер:  крамера
обосновать:  обосновать
правда:  правда
парабола:  парабола
подведение:  подведение
взять:  возьмем
запретить:  запрещено
функциидвуха:  функциидвух
черновик:  черновике
емелин:  емелин
вычисленияопределенный:  вычисленияопределенных
задачин:  задачина
системый:  системыи
удовлетворяетлить:  удовлетворяетли
специфика:  специфика
задуматься:  задумался
два:  двух
обозначаться:  обозначается
повышать:  повышать
заданав:  заданав
всё:  всё
что:  чём
тройной:  тройные
деление:  деления
являться:  является
автоматически:  автоматически
контуруформула:  контуруформула
график:  график
считать:  считаю
слабый:  слабое
фигня:  фигня
примерно:  примерно
независимый:  независимые
привести:  привести
здравствуйте:  здравствуйте
корреляция:  корреляции
прежде:  прежде
слово:  слово
заочник:  заочников
погружаться:  погружаться
максимально:  максимально
повторять:  повторяем
трата:  тратой
