уравнение:  уравнениях уравнению уравнениям уравнений уравнения уравнение уравнениями уравнением
вектор:  векторы вектору вектора векторам вектором векторами вектор векторе векторов
раздел:  разделе
внимательный:  внимательны
надобность:  надобности
ссылка:  ссылки
ось:  осью ось оси осей
пространственный:  пространственной пространственными пространственные пространственного
вращение:  вращения
придумать:  придумать
дифференциальный:  дифференциальные
уравненияс:  уравненияс
онлайн:  онлайн
разобрать:  разберём
геометрия:  геометрии геометрия геометрией
число:  числам числу число числе числами числа
копирование:  копирование
решить:  решить
думать:  думаете
рассмотреть:  рассмотрели рассмотрим рассмотренный
тренировка:  тренировку тренировки
разрыв:  разрыва
нуль:  нуля нули нулей нулю
выражение:  выражения
предыдущий:  предыдущей предыдущего
вещь:  вещей вещах вещи
производный:  производные производная производной производную
дорожка:  дорожки
прямой:  прямой прямую прямых прямые прямыми прямая
проходить:  проходил проходила проходящей проходит
дуприближённо:  дуприближённо
предел:  предел пределы пределов
прочитать:  прочитайте
сумма:  сумма сумму
модель:  модели модель
новый:  новому
буква:  буквами
произвольныйтройный:  произвольныйтройной
рабочий:  рабочий
канон:  канонов
асимптота:  асимптоты
дизайн:  дизайна
вычисленияопределенный:  вычисленияопределенных
это:  это
событие:  события
отблагодарить:  отблагодарить
пареный:  пареной
технический:  технический
повторный:  повторные
байес:  байеса
выбор:  выбор
числовой:  числовые
простой:  проще простых простом простой простым
дисперсия:  дисперсию дисперсия дисперсии
точнее:  точнее
производныенеявно:  производныенеявно
решать:  решать
значение:  значение значения значению
пример:  примере примерами примеры пример
дополнительный:  дополнительную
помнить:  помним
решение:  решений решением решение решения
подставить:  подставьте подставим
поляй:  поляи
точность:  точности
интеграл:  интегралы интеграла интеграл интеграле интегралов
находиться:  находится находиться находятся
высота:  высоте высота
место:  местах место
опечатка:  опечатку
дальнейший:  дальнейшем
результат:  результат
кусочек:  кусочек
б:  б
математический:  математические математическая математической
теория:  теория теории
находить:  находить находим
связать:  связано связаны
стойло:  стойло
параметрически:  параметрически
найти:  найденные найти найденная найдём
состоять:  состоит
схематический:  схематический
продолжать:  продолжаем
способ:  способом способе способов способ
чертёж:  чертежей чертёж
надвинуть:  надвинем
игрек:  игрек
отдельный:  отдельную отдельных
коварный:  коварен
формула:  формулы формула формулой формулу формуле формулами
смотреть:  см смотрим смотреть смотря
данный:  данном данного данное данный
статья:  статье статьи
фнп:  фнп
пропорция:  пропорции пропорцию
прийтись:  придётся
канонический:  каноническому канонические каноническом каноническими
задуматься:  задумайтесь
простейшее:  простейшие
отрицательный:  отрицательном
два:  две двум двумя двух
избежание:  избежание
гипотеза:  гипотезы гипотез гипотеза
параметр:  параметра
дифференциал:  дифференциалах дифференциала
двумерный:  двумерная
больший:  наибольшее большими
выбрать:  выбрал выбрать
лежать:  лежащая лежит лежащую
задать:  заданной задайте задать задана заданы заданная
конец:  конце
направление:  направлении
один:  одну одном одна одно одним
часть:  частям части
тело:  тела
циркуляция:  циркуляция
методомоперационный:  методомоперационного
бесповторный:  бесповторной
наверняка:  наверняка
правильно:  правильно
двойной:  двойные двойной
любой:  любому любое любые любым
ошибка:  ошибку ошибок
плоскость:  плоскости плоскостей плоскость
вправо:  вправо
несобство:  несобств
следующий:  следующих следующего следующий
строгий:  строгую
прямоугольный:  прямоугольной
известный:  известны известна
л:  л
появиться:  появятся
общий:  общим общая
нелинейный:  нелинейная
брать:  берём
направлять:  направляющий направляющего направляющими направляющим направляющем направляющие направляющих направляющему
стрелка:  стрелка
поздний:  позже
преобразованиеквадратичный:  преобразованиеквадратичной
определителяй:  определителяи
вогнутостья:  вогнутостьи
важно:  важно
многий:  многих
неизвестный:  неизвестными
снизу:  снизу
вид:  виде виды вид виду
коллинеарный:  коллинеарны коллинеарен
параллельный:  параллельны параллелен параллельную параллельна
закон:  законы
позволять:  позволяет
затруднение:  затруднения
функциональный:  функциональные
случай:  случай случая случаев случае случаями
рассматривать:  рассматриваемые
касательный:  касательных
взять:  взять возьмите
строить:  строим
глаз:  глаз
подводить:  подводит
изящно:  изящно
координата:  координату координат координаты координатах координатой координата координатами
профессия:  профессию
перечислить:  перечислить
пусть:  пусть
геометрический:  геометрическая геометрическое
абсолютный:  абсолютная
типовыхзадача:  типовыхзадач
графика:  графика графики
умножение:  умножения
вероятность:  вероятностей вероятность вероятности
выполнимый:  выполним
система:  система системой систему системе системы
частный:  частные частный частными частное
функция:  функций функции функция
ранговойкорреляция:  ранговойкорреляции
группировка:  группировок группировка
записывать:  записывают записываем
непрерывный:  непрерывная непрерывных
условнаясходимость:  условнаясходимость
уравненийв:  уравненийв
ластик:  ластиком
сложенияй:  сложенияи
терзать:  терзают
регрессия:  регрессии регрессия
величина:  величин величина величины
александр:  александр
урок:  уроках урока урок уроке
окончание:  окончание
уровень:  уровень уровня
рассказать:  расскажу рассказать рассказано
отрезок:  отрезок
переписать:  переписать перепишем переписали
который:  которые котором которых которой которая которыми
грин:  грина
суть:  сути
полный:  полное полных полной
линейный:  линейные линейная линейных линейной
вниз:  вниз
исчисление:  исчисления
координатный:  координатной координатных координатные координатную
откладывать:  откладывать откладываем
эйлер:  эйлера
расположение:  расположение
быть:  суть будьте буду будут будем
запись:  записи запись
согласие:  согласия
сам:  саму сама самом
частичка:  частичку
локальный:  локальная
приравнивать:  приравниваем
невнимательность:  невнимательности
ожидание:  ожидание ожидания
совет:  совет
придерживаться:  придерживаться
математика:  математики математике
прилично:  прилично
лаплас:  лапласа
такой:  таким такие такое такую
перегиб:  перегиба
сходимость:  сходимости сходимость
дуоперационный:  дуоперационным
готовый:  готовой готовых
несложный:  несложен
исследовать:  исследовать
дискретный:  дискретный
загнать:  загоним
базис:  базисах базис базисе базису
никто:  никто
знакочередоваться:  знакочередующиеся
задача:  задачи задачу задач задачах задача
поверхность:  поверхности
составить:  составить составим составлены
коричневый:  коричневый
векторный:  векторного векторное
создавать:  создаёт
ду:  ду
прочерчивать:  прочерчивают
соответствовать:  соответствуют
далее:  далее
зависимостьвектор:  зависимостьвекторов
линейныйкоэффициент:  линейныйкоэффициент
делать:  делать
параметрический:  параметрических параметрические параметрической параметрическом
снова:  снова
оно:  оно
формальный:  формальный
коэффициент:  коэффициент
неопределённый:  неопределенный неопределенном
сначала:  сначала
метод:  методы метод методом
данные:  данными данных
начаться:  началась
страница:  страницу
дробь:  дробей
собственный:  собственные
ваш:  ваш ваша вашего вашим ваши
подумать:  подумайте
признак:  признак признаки
произвольный:  произвольных
нормальный:  нормальные нормальное нормальным
сложный:  сложной сложных сложные
несобственныйинтеграл:  несобственныйинтеграл
принадлежащий:  принадлежащая принадлежащую
доступно:  доступно
тройка:  тройку
причём:  причём
фурье:  фурье
поле:  поля
поэтому:  поэтому
разложение:  разложением разложение
учиться:  учимся
практика:  практике
свойство:  свойства
вместо:  вместо
точка:  точка точки точкой точку точками точкам точке
момент:  момент
задавать:  задаваемые задают задаёт
исследование:  исследование
икс:  икс
принцип:  принципе
пожаловать:  пожаловать
сокращать:  сокращать
быстрый:  быстрые
плоский:  плоской плоская
ипример:  ипримеры
своеобразие:  своеобразие
множество:  множества множеством
оценка:  оценки оценка
переход:  переход
вариация:  вариации
требоваться:  требуется
асимметрия:  асимметрия
комплексный:  комплексными комплексные комплексного комплексный
основа:  основы
поверхностный:  поверхностные
принимать:  принимают принимать принимает
интервал:  интервалы
книга:  книга книги
скажем:  скажем
дать:  данные данной данная даны
главный:  главную
неудобство:  неудобства
целый:  целыми
кош:  коши
желательно:  желательно
наш:  нашим наша наш нашей
параграф:  параграфа параграф
сверху:  сверху
выше:  выше
очередь:  очередь
типовой:  типовые типовая
фигура:  фигуры
пунктирный:  пунктирные
пуассон:  пуассона
упоминаться:  упоминалось
сводиться:  сводящиеся
чайник:  чайников
жить:  живём
замена:  замены
алгоритм:  алгоритма
преобразование:  преобразований преобразования
вычисленияс:  вычисленияс
целесообразно:  целесообразно
некоторый:  некоторым некоторая
однако:  однако
малый:  малые наименьших
связь:  связь
записать:  запишем записаны записать
мир:  миром
понижение:  понижением понижение
матричный:  матричные матричных матричный
вытащить:  вытащить
методичка:  методички
заметить:  заметили
удобство:  удобство
математическоеожидание:  математическоеожидание
например:  например
однородный:  однородные однородным
решенияопределённый:  решенияопределенных
вычислить:  вычислить
неизбежный:  неизбежны
важный:  важен
школа:  школа
очень:  очень
сказка:  сказку
интегральнаятеорема:  интегральнаятеоремы
задаваться:  задаётся задаются
хотя:  хотя
корнимногочлен:  корнимногочлена
логарифмический:  логарифмическая
матрица:  матрицу матрицы матрицами
этап:  этапе
испытанияй:  испытанияи
интегралыть:  интегралыв
научиться:  научимся научиться
рад:  рад
неоднородный:  неоднородные
начать:  начнём начните начать
перегруппировка:  перегруппировка
правило:  правило правила
основной:  основные
скрещивание:  скрещивания
орт:  орту
неожиданно:  неожиданно
наградить:  наградят
применяться:  применяется
помощь:  помощью
бернулли:  бернулли
единица:  единицу единицы единице
полярный:  полярные полярной полярных
исходный:  исходный исходную исходных
мой:  моего моим моей моих моё мои
коэффициентковариация:  коэффициентковариации
ряд:  ряд ряды ряда ряде рядов
вариационный:  вариационный
шесть:  шесть
обратный:  обратная обратную
второй:  второй вторая второго вторую
должный:  должны
вопрос:  вопросы вопрос
аналитический:  аналитическую аналитическая аналитической
кратное:  кратные
системудифференциальный:  системудифференциальных
веб:  веб
пользоваться:  пользоваться
блог:  блог
доверительный:  доверительные
первый:  первой первом первого
высокий:  высших высшей высок высшая
жертва:  жертвы
настать:  настала
среднееквадратический:  среднееквадратическое
множественный:  множественном
приперчить:  приперчить
абсцисса:  абсцисс
пространство:  пространстве пространства
слово:  слова
лопиталя:  лопиталя
снимать:  снимаем
последовательность:  последовательностей
удобный:  удобный
комбинационный:  комбинационная
курс:  курс
параллельность:  параллельность
обычно:  обычно
квадратичный:  квадратичные
смешанноепроизведение:  смешанноепроизведение
ордината:  ординат
элементарный:  элементарны
подойти:  подойдёт
объём:  объем
ставить:  ставим
мимо:  мимо
очередной:  очередной
поляформула:  поляформула
проверить:  проверить проверим
аппликата:  аппликат
проверка:  проверки проверку проверка
обнулить:  обнулить обнулили
постараться:  постарайтесь постараюсь
сообщить:  сообщите
сделать:  сделать
линия:  линиями линии линия
фехнера:  фехнера
подобрать:  подберёте
получить:  полученной получены полученные получи
поскольку:  поскольку
школьный:  школьный
эффективный:  эффективные
центр:  центр
образ:  образом
гипергеометрическоераспределение:  гипергеометрическоераспределение
видеть:  видеть
тонко:  тонко
условный:  условные
непрерывнаяслучайный:  непрерывнаяслучайная
другой:  других другую другие другим
впервые:  впервые
эллипс:  эллипс
нахождение:  нахождение нахождения
ноль:  ноль
обратить:  обратите обратили
длина:  длина
хороший:  хорошая
наложиться:  наложились
сайт:  сайта сайты сайт
мочь:  могут можем
знакопостоянство:  знакопостоянства
сократить:  сократить
подробно:  подробно
стереть:  стереть
проводить:  проводить
равномерный:  равномерная равномерное
треугольный:  треугольная
родный:  родной
градиент:  градиент
забить:  забить
самый:  самую самое
дёргаться:  дёргаемся
джоконда:  джоконды
трёхмерный:  трёхмерных
определение:  определения определению
сверяться:  сверяемся
вспомнить:  вспомним
резать:  режет
пересекаться:  пересекаются
использовать:  используйте использовать используем
пожалуйста:  пожалуйста
даламбер:  даламбера
влево:  влево
попутно:  попутно
закусить:  закусить
тонкость:  тонкости
факт:  факт
теорема:  теоремы
комбинаторика:  комбинаторике
случайнаявеличина:  случайнаявеличина
располагаться:  располагаться
повторнойя:  повторнойи
построение:  построение построении
верный:  верные
следовать:  следует следовало
бесконечно:  бесконечно
вдоль:  вдоль
линейнойкорреляционный:  линейнойкорреляционной
действие:  действия
улыбка:  улыбкой
квадрат:  квадратов
ранг:  ранг
кривая:  кривой
форма:  формы
равный:  равны равна
пора:  пор пора
тяжестиплоска:  тяжестиплоской
отметить:  отметить
нулевой:  нулевая нулевые
распределениякритерия:  распределениякритерий
относительно:  относительно
функциюкомплексный:  функциюкомплексной
область:  область области
построить:  построить
несобственный:  несобственные
просто:  просто
разобраться:  разберёмся
заодно:  заодно
мода:  мода
знаменатель:  знаменатели
приём:  приём
ещё:  ещё
свойстваэлементарный:  свойстваэлементарных
считать:  считать
внимание:  внимание
непривычно:  непривычно
зрение:  зрения
кусок:  куска
лейбниц:  лейбница
калькулятор:  калькулятор
случайность:  случайность
постоянный:  постоянны постоянных
неравенство:  неравенства
застраховать:  застрахован
поставить:  поставим
поток:  поток
удовлетворять:  удовлетворяет удовлетворяют
полностью:  полностью
путеводитель:  путеводитель
порассуждать:  порассуждать
единственный:  единственным единственное
касательная:  касательная
ответ:  ответ ответа ответы ответов
задачис:  задачис
понятие:  понятии
конкретный:  конкретным конкретное
нарисовать:  нарисую
зелёный:  зелёный
медиана:  медиана
распадаться:  распадаются
король:  короле
работа:  работа
функциия:  функциии
степенной:  степенного степенные
функцийдвуха:  функцийдвух
направлениюй:  направлениюи
определённый:  определенный определенного
выборка:  выборке
премия:  премией
взаимный:  взаимное
дело:  делу деле дело
вы:  вами
гостевой:  гостевая
левый:  левый
знакомиться:  знакомиться
действительно:  действительно
распределение:  распределения распределение
кроме:  кроме
разноцветный:  разноцветные
экстремум:  экстремумы
горнера:  горнера
производныефункция:  производныефункции
средний:  средняя
понятно:  понятно
функцийнесколький:  функцийнескольких
никакой:  никакой
случайно:  случайно
подготовка:  подготовки
отщипывать:  отщипываем
вывод:  вывод
главное:  главное
альфа:  альфа
внутригрупповаяй:  внутригрупповаяи
выделять:  выделял
пара:  пару
приступить:  приступим
алгебра:  алгебры
получать:  получаем
математик:  математика
функцийв:  функцийв
переменный:  переменных переменная переменной
посмотреть:  посмотрим
несовместный:  несовместные
лоб:  лоб
независимыеслучайный:  независимыеслучайные
множественнойлинейный:  множественнойлинейной
вверх:  вверх
наоборот:  наоборот
анализ:  анализ анализа
добросовестно:  добросовестно
тема:  темы
существовать:  существует
прямоугольник:  прямоугольников
непрерывность:  непрерывность
отличаться:  отличаться
унылый:  унылый
эксцессэмпирический:  эксцессэмпирического
функциис:  функциис
озадачивать:  озадачивает
зеркало:  зеркало
криволинейный:  криволинейные
различный:  различных
значит:  значит
пирсон:  пирсона
пустой:  пустую
понимать:  понимать
библиотека:  библиотека
три:  трёх
дробный:  дробных
межгрупповой:  межгрупповая
ёж:  ежу
ортогональный:  ортогональное ортогонален
убедиться:  убедился
третий:  третьей
перепутать:  перепутайте
дискретнойслучайный:  дискретнойслучайной
задачипо:  задачипо
глазомер:  глазомер
интерпретировать:  интерпретировать
возможность:  возможности
тормозка:  тормозок
востребовать:  востребованную
добро:  добро
наименьшеезначение:  наименьшеезначения
жёлтый:  желтый
нсв:  нсв
сила:  силы
приблизить:  приближенные
очевидный:  очевидную
распространить:  распространенная
омега:  омега
рассказывать:  рассказывал
системылинейный:  системылинейных
нужно:  нужно
вроде:  вроде
подставлять:  подставляйте подставляем
отличие:  отличия отличие
быстро:  быстро
поперёк:  поперёк
упасть:  упал
ход:  ходе
чистый:  чистая
репа:  репы
зависимый:  зависимые
зависимость:  зависимость
отклонение:  отклонение
крамер:  крамера
отрезка:  отрезке
материал:  материалы материала материалов
что:  чему
таблица:  таблицы
произведение:  произведение
случайный:  случайных случайные
замкнутый:  замкнутому
давно:  давно
начало:  начале начала
пройти:  пройдёт
дуга:  дуги
частность:  частности
отрезкать:  отрезкав
отмерять:  отмеряем
детский:  детском
дивергенция:  дивергенция
парабола:  парабола
похожий:  похожих
карандаш:  карандашом
сказать:  сказал
форум:  форуме форум
показатель:  показатели
короче:  короче
площадьс:  площадьс
пэ:  пэ
запретить:  запрещено
подходить:  подходила
функциидвуха:  функциидвух
статистический:  статистические статистическая
черновик:  черновике
емелин:  емелин
синий:  синий
убыванией:  убываниеи
полупространство:  полупространстве
повышенный:  повышенной
детерминация:  детерминации
сторона:  стороны
возрастание:  возрастание
эмпирический:  эмпирические
также:  также
интегрирование:  интегрирование
легко:  легко
обязательно:  обязательно
задачин:  задачина
замечательный:  замечательные
тот:  тех
проводиться:  проводятся
рациональный:  рациональные
системый:  системыи
удовлетворяетлить:  удовлетворяетли
найтись:  нашлось
аналогично:  аналогично
пока:  пока
дифференциальныеуравнение:  дифференциальныеуравнения
всякий:  всякий
иррациональный:  иррациональных
интервальный:  интервальный
получиться:  получился получилась
тригонометрический:  тригонометрических
стокс:  стокса
квадратичнуюформ:  квадратичнуюформу
схема:  схема
карта:  карта
соответствие:  соответствие
привести:  приведённая привести
знать:  знать
предполагать:  предполагает
гипербола:  гипербола
зетовый:  зетовая
аналитически:  аналитически
вообще:  вообще
дарвин:  дарвина
дробовик:  дробовик
они:  ними
принадлежать:  принадлежит
оценкия:  оценкии
смутный:  смутные
неявный:  неявной
несобственныхинтеграл:  несобственныхинтегралов
зачёт:  зачёт
вероятностибиномиальный:  вероятностибиномиального
вероятностия:  вероятностии
логика:  логики
спирмена:  спирмена
скалярный:  скалярное
род:  рода
определять:  определяют
гаусс:  гаусса
заданав:  заданав
совершенно:  совершенно
рассматриваться:  рассматривалось
убеждать:  убеждать
порядок:  порядка порядков
всё:  всё
значимость:  значимости
связанный:  связанные
клетчатый:  клетчатой
нижний:  нижнем
пропорциональный:  пропорциональны
подбор:  подбор
серьёзный:  серьёзные
тройной:  тройные
деление:  деления
являться:  является
проштудировать:  проштудировать
мысленно:  мысленно
выразить:  выразить
контуруформула:  контуруформула
экстремальный:  экстремальные
номер:  номер
график:  график
красный:  красная
исключить:  исключить
её:  её
парный:  парной
св:  св
параллельно:  параллельно
нормаль:  нормали
определитель:  определитель
садик:  садике
выпуклость:  выпуклость
голый:  голом
несколько:  несколько
подчёркивать:  подчеркивая
элемент:  элементы
сборник:  сборники
простота:  простоты
показательный:  показательное
какой:  какую
рекомендовать:  рекомендую
независимый:  независимые
демонстрировать:  демонстрирует
автор:  автора автор
зет:  зет
сложность:  сложности
диффура:  диффурами
почленно:  почленно
часто:  часто
неправильно:  неправильно
значенияй:  значенияи
соответствующий:  соответствующие
этот:  эта
пересечение:  пересечением
фиолетовый:  фиолетовый
объяснять:  объяснять
нужный:  нужной
получаться:  получается
кстати:  кстати
вычисление:  вычисление
выполняться:  выполняется
интересовать:  интересует
классическоеопределение:  классическоеопределение
инормаль:  инормаль
статистика:  статистика
бумага:  бумаге
пунктир:  пунктиром пунктир
тетрадь:  тетради
корреляция:  корреляции
выражаться:  выражаются
остаться:  оставшееся
бэ:  бэ
биномиальный:  биномиальное
ортонормированный:  ортонормированном
дойти:  дошла
пренебрегать:  пренебрегать
лёгкий:  лёгкого
вновь:  вновь
пирамида:  пирамида
заочник:  заочников
разный:  разные
морщина:  морщин
линиюв:  линиюв
информация:  информацию
муравей:  муравей
самостоятельный:  самостоятельного
отношение:  отношении
хотеться:  хочется
наглядно:  наглядно
повторять:  повторяем
понимание:  понимания
устно:  устно
складывать:  складываем
равенство:  равенства
