помечать:  помечать
туманность:  туманность
семь:  семь
производный:  производные производная производной производную
предел:  предел пределы пределов
слагаемое:  слагаемые слагаемом
небольшой:  небольшой
числовой:  числовые
табличный:  табличный табличная табличную
производныенеявно:  производныенеявно
вернуться:  вернувшись вернемся
значение:  значение значения
скорее:  скорее
помолодеть:  помолодеет
зеркальный:  зеркальный зеркален
находить:  находить находим
игрек:  игрек
формула:  формулы формуле формула формулу
канонический:  каноническому
трёхмерный:  трехмерном трехмерного трёхмерном
два:  две двух
дифференциал:  дифференциалах дифференциал дифференциала
минковский:  минковского
больший:  наибольшее большие большую
многие:  многие
помочь:  помочь
различный:  различные различных
проводиться:  проводится
добавлять:  добавляем
число:  число числами числа
вогнутостья:  вогнутостьи
верный:  верный
выяснить:  выяснить
случай:  случай случая случае
упрощать:  упрощаем
профессия:  профессию
викторина:  викториной викторины
фильм:  фильмов фильмах фильмы
определённый:  определенном определенный определенного
умножение:  умножения
система:  система системе систему системы
группировка:  группировок группировка
условнаясходимость:  условнаясходимость
физический:  физического физических
александр:  александр
остаться:  осталось оставшиеся
зря:  зря
который:  которые который которая которого которых
закон:  закон законы закону закона
линейный:  линейные линейная линейных линейной
пожелание:  пожеланиям
равенство:  равенство равенства
запись:  записи запись
согласие:  согласия
совет:  совет
решать:  решаем решать решаю
услышать:  услышать
знать:  знают знаю знаете знает знать
дуоперационный:  дуоперационным
базис:  базисах базису базис
никто:  никто
житейский:  житейский
зависимостьвектор:  зависимостьвекторов
снова:  снова
неподвластный:  неподвластные
оно:  оно
сначала:  сначала
метод:  методы методом метод
геометрически:  геометрически
страница:  страницу
обычный:  обычные обычная обычными
вода:  воды
математический:  математическая математического математические математический математической
данные:  данных
искать:  искать
необратимый:  необратимо
потребовать:  потребовать
интеграл:  интеграл интегралов интегралы интеграла интеграле
урок:  урока урок
разложение:  разложением разложение
частный:  частную частная частное частные частных частной
икс:  икс
уравнение:  уравнению уравнения уравнение уравнений
четвёртый:  четвертое четвёртое четвертым
переход:  переход
вложение:  вложения
первый:  первое первому первая первом первого первые
практический:  практических
малый:  малые наименьших
связь:  связь
викторин:  викторину
нормальный:  нормальное
интегральнаятеорема:  интегральнаятеоремы
некоторый:  некоторой некоторую
корнимногочлен:  корнимногочлена
логарифмический:  логарифмическая
начать:  начнём начать начните
основной:  основные
функция:  функцией функции функция функций
бернулли:  бернулли
невозмутимо:  невозмутимо
полярный:  полярные полярных полярной
положительный:  положительное
рассмотреть:  рассмотрим рассмотренному рассмотренный рассмотренные рассмотреть
ряд:  ряды ряда ряд рядов
уровень:  уровня уровне
нырять:  ныряйте
значительно:  значительно
доверительный:  доверительные
смысл:  смысле
всевозможный:  всевозможных
среднееквадратический:  среднееквадратическое
народный:  народная
говориться:  говорится
комбинационный:  комбинационная
показатель:  показатель показателем показатели
смешанноепроизведение:  смешанноепроизведение
невероятный:  невероятной
дисперсия:  дисперсия дисперсии дисперсию
проверка:  проверки проверку проверка
зрение:  зрение зрения
фантастический:  фантастические фантастических
школьный:  школьный
образ:  образом
непрерывнаяслучайный:  непрерывнаяслучайная
иван:  ивану иван
прямо:  прямо
длина:  длина
хороший:  хорошая
немного:  немного
мочь:  могут
знакопостоянство:  знакопостоянства
проводить:  проводить
градиент:  градиент
прошлое:  прошлое
линия:  линия линии линиями
взбодрить:  взбодрю
запрещать:  запрещает запрещал
комбинаторика:  комбинаторике
случайнаявеличина:  случайнаявеличина
бесконечно:  бесконечно
непротиворечивый:  непротиворечиво
внимательный:  внимательным
задать:  зададите заданной задам задайте
форма:  формы
отметить:  отметить отмечу
статья:  статьи статье статью
обратный:  обратную обратная
составитель:  составители
завтра:  завтра
целое:  целое
третий:  третий третьей
реальный:  реальная
готовый:  готовых готово
просто:  просто
аргумент:  аргументами
приём:  приём
ещё:  ещё
обязанность:  обязанности
быть:  буду будут
тема:  тема тему
указывать:  указывают
нахождение:  нахождения нахождение нахождении
подобный:  подобных
данный:  данного данном
непрерывный:  непрерывных непрерывная
терять:  терять
исключить:  исключено
производныефункция:  производныефункции
средний:  средняя
знак:  знаком знак
тарелка:  тарелку
область:  области область
математик:  математика
попробовать:  попробовать
переменный:  переменных переменным переменной переменные переменная переменными
пример:  пример примера примеров примерам примерами примеры
несовместный:  несовместные
вынести:  вынесена вынесу
независимыеслучайный:  независимыеслучайные
добавить:  добавить
следовательно:  следовательно
модель:  модель модели
непрерывность:  непрерывность
химический:  химического
догадаться:  догадаться
функциис:  функциис
полный:  полной полных полный полное полная
зеркало:  зеркало
второй:  втором вторые второго второму второй вторую вторая
значит:  значит
пирсон:  пирсона
вопрос:  вопрос вопросом вопросов вопросу вопросы
понимание:  понимании понимания
найти:  найденной найдены найденную найдем найти
межгрупповой:  межгрупповая
ортогональный:  ортогональное
нсв:  нсв
вроде:  вроде
быстро:  быстро
упасть:  упал
гарантированно:  гарантированно
прочитать:  прочитать
отрезка:  отрезке
величина:  величина величин величины
обывательский:  обывательского
поверхность:  поверхность поверхности
популярный:  популярное
короче:  короче
привести:  приведенный привести
таблица:  таблица таблицы
путешествие:  путешествии путешествие
плоский:  плоские
детерминация:  детерминации
гадать:  гадать
сторона:  стороны
следующий:  следующие следующим следующих следующий
выполнить:  выполнить выполнено
философский:  философская
дифференциальныеуравнение:  дифференциальныеуравнения
прямой:  прямая прямой прямую
постоянный:  постоянных постоянными
стокс:  стокса
схема:  схема схеме
предполагать:  предполагает
оформление:  оформление оформлении
термодинамика:  термодинамики
нешуточный:  нешуточный
видеозапись:  видеозаписи
дифференцирование:  дифференцирования дифференцирование
дробовик:  дробовик
математика:  математике математики
векторный:  векторное векторного
сам:  самом сама
индекс:  индекса индекс индексы
новость:  новость
вероятностия:  вероятностии
скалярный:  скалярное
наш:  нашем нашему наше наш нашу нашей нашего
значимость:  значимости
придумать:  придумала
терминатор:  терминатора
отличие:  отличий
мысленно:  мысленно
сформулировать:  сформулировал
такой:  такую таким такие такое такого
анализ:  анализа анализ
её:  её
парный:  парной
лоренц:  лоренца
несколько:  несколько
сборник:  сборники сборников
параметрический:  параметрическом параметрической
перец:  перца
часто:  часто
пространство:  пространствах пространству пространстве пространства пространство
получаться:  получается
решение:  решение решении решением решения решений
форум:  форум форуме
книга:  книги книга
ответить:  ответил ответили ответить ответит
приободрить:  приободрю
чувство:  чувств
устно:  устно
логический:  логическими
сложный:  сложным сложной сложные сложное сложных сложными сложная
выглядеть:  выглядеть
задание:  задание задания
вектор:  векторы векторов
вращение:  вращения
именно:  именно
копирование:  копирование
читать:  читать
разрыв:  разрыва
выражение:  выражения
сознание:  сознание
максимум:  максимум
отблагодарить:  отблагодарить
являться:  являются является
байес:  байеса
отрезать:  отрежь
простой:  проще простейших просты
размерность:  размерности
начинать:  начинать начиная
результат:  результат результате
теория:  теория теории
прийти:  пришла
избежание:  избежание
подстрочный:  подстрочные подстрочный
двумерный:  двумерная
штрих:  штриха штрихом
тело:  тела
циркуляция:  циркуляция
вычислить:  вычислили вычислить
плоскость:  плоскости плоскость
общий:  общим общая общий общее
уничтожить:  уничтожить
получиться:  получится
пара:  парой пару
определителяй:  определителяи
выносить:  выносим выносить
дважды:  дважды
дробь:  дроби дробей
затруднение:  затруднения
заменимый:  заменим
пятимерный:  пятимерном пятимерное
впечатление:  впечатление
последовательно:  последовательно
действие:  действий действия
кофейный:  кофейной
вероятность:  вероятностей вероятность вероятности
уравненийв:  уравненийв
называться:  называются называется
грин:  грина
суть:  сути
эйлер:  эйлера
десятимерный:  десятимерном
другой:  другому другие другого другим
иной:  иное иную
походка:  походкой
необратимость:  необратимости
каждый:  каждого каждая
придерживаться:  придерживаться
невозможно:  невозможно
дискретный:  дискретный
событие:  событие события
знакочередоваться:  знакочередующиеся
принцип:  принцип принципы принципе принципу
выдавать:  выдавать
практически:  практически
подумать:  подумайте
произвольный:  произвольных
будущее:  будущем будущего будущее
фурье:  фурье
отвлекаться:  отвлекаемся
поле:  поля
гипотеза:  гипотез гипотеза гипотезы
свойство:  свойства
аксиоматика:  аксиоматика
исследование:  исследование
весь:  всем всеми вся весь
точка:  точки точка точке
вариация:  вариации
основа:  основы
интервал:  интервалы
садиться:  садиться
кош:  коши
инопланетянин:  инопланетяне инопланетянах
чайник:  чайников чайник
вычисленияс:  вычисленияс
матричный:  матричные матричных матричный
заметить:  заметили заметьте
однородный:  однородные однородным
очень:  очень
записать:  запишу записать
выдумка:  выдумка
матрица:  матрицу матрицы матрицами
испытанияй:  испытанияи
интегралыть:  интегралыв
научиться:  научимся научитесь научиться
перегруппировка:  перегруппировка
управляться:  управляться
домножить:  домножить
помощь:  помощью
нобелевский:  нобелевский нобелевская
вариационный:  вариационный
домой:  домой
грозный:  грозному
казаться:  кажется казались
комитет:  комитет
блог:  блог
вклад:  вклад
высокий:  высших высшей высшая высоком
типовой:  типовых
произведение:  произведения произведение
гуманоид:  гуманоидов
пойти:  пойти пошла
условие:  условиях условию
удобный:  удобный удобнее
грустный:  грустная
курс:  курс
восприятие:  восприятие
начинающий:  начинающим
координата:  координаты координат координатах
заключительный:  заключительным
знакомый:  знакомая
сообщить:  сообщите
аналитический:  аналитическая аналитической
понижение:  понижение понижением
штука:  штука штук
центр:  центр
аналогичный:  аналогичен
позволить:  позволит
любой:  любой
создавать:  создавал
производная:  производных производными
безобразие:  безобразие
считаться:  считаются
построение:  построение
вспоминать:  вспоминаем
константа:  константами константой константы константа константу
линейнойкорреляционный:  линейнойкорреляционной
время:  время
дело:  делов деле
распределениякритерия:  распределениякритерий
дальнейший:  дальнейшее
возвращаться:  возвращаться
причина:  причину
поверить:  поверите
несобственный:  несобственные
любимый:  любимую
нормалёк:  нормалёк
откуда:  откуда
подкрепить:  подкрепленное
свой:  своей
касательная:  касательная
ответ:  ответ ответов ответы
задачис:  задачис
сиё:  сиё
расправляться:  расправляться
царь:  царя
правило:  правила правилу правило
измерение:  измерений измерения измерение
функциия:  функциии
возможно:  возможно
степенной:  степенного степенная степенные
функцийдвуха:  функцийдвух
гадалка:  гадалок
монитор:  мониторы
выборка:  выборке
научный:  научный научном научной
проделать:  проделанных
факультет:  факультета
четырёхмерный:  четырехмерном четырёхмерная четырехмерное четырехмерному
функцийнесколький:  функцийнескольких
любить:  любят
квадрат:  квадрат квадратов
множественнойлинейный:  множественнойлинейной
сделать:  сделано
троечник:  троечника
причёсывать:  причесываем
распределение:  распределение распределения
теряться:  теряйтесь
задачипо:  задачипо
востребовать:  востребованную
приблизить:  приближенные
выпалить:  выпали
находиться:  находимся находятся находится
примечание:  примечание
зависимый:  зависимые зависимой
путём:  путём
отклонение:  отклонение
конкретный:  конкретное
вполне:  вполне
случайный:  случайных случайные
материал:  материала материалов материалы материалам
дуга:  дуги
частность:  частности
отрезкать:  отрезкав
труд:  трудов
дивергенция:  дивергенция
никакой:  никакими никаких никакой
сайт:  сайт сайты сайта
графика:  графики графика
спешить:  спешите
предчувствие:  предчувствие
трюк:  трюк
возрастание:  возрастание
эмпирический:  эмпирические
подставить:  подставим
найтись:  нашлось
арктангенс:  арктангенса
полезный:  полезный
аналогично:  аналогично
громоздкий:  громоздкие
иррациональный:  иррациональных
аппарат:  аппарат
определение:  определению определения
квадратичнуюформ:  квадратичнуюформу
карта:  карта
однонаправить:  однонаправлено
гипербола:  гипербола
равно:  равно
они:  ними
эйнштейн:  эйнштейна эйнштейном
обозначение:  обозначение обозначения
развитие:  развитие
логика:  логики
спирмена:  спирмена
следствие:  следствие
вид:  виду виды вид виде
преимущество:  преимуществом
постепенно:  постепенно
известный:  известная
процесс:  процессов
св:  св
прошлый:  прошлом
иметь:  имеет
четыре:  четырёх
достаточно:  достаточно
диплом:  дипломом
показательный:  показательное показательная
преобразование:  преобразования преобразований
противоречить:  противоречит
лобачевский:  лобачевского
диффура:  диффурами
подразумевать:  подразумевает
вычисление:  вычисление
фантастика:  фантастикой
использовать:  используем использовать используйте
представлять:  представляет
статистика:  статистика
произойти:  произойдет
гуща:  гуще
биномиальный:  биномиальное
крайний:  крайнем
редкий:  реже
линиюв:  линиюв
самостоятельный:  самостоятельного
справедливый:  справедливы
отношение:  отношении
забывать:  забывая
касса:  кассы
дифференцировать:  дифференцируем
туго:  туго
философия:  философии
обманчивый:  обманчиво
скучно:  скучно
решить:  решить решив
девять:  девять
дуприближённо:  дуприближённо
подход:  подхода
асимптота:  асимптоты
бывало:  бывало
повторный:  повторные
основание:  основанием
забавно:  забавно
замена:  замену замены
фнп:  фнп
сконцентрировать:  сконцентрировать
простейшее:  простейшие простейшими
пятёрка:  пятёркой пятерку
конец:  конце
часть:  частям часть
двойной:  двойные двойной
несобство:  несобств
нелинейный:  нелинейная
брать:  берём
преобразованиеквадратичный:  преобразованиеквадратичной
орган:  органы
скомпилировать:  скомпилированная
функциональный:  функциональные
способный:  способны
рациональный:  рациональнее рациональные
поменять:  поменяйте
геометрический:  геометрическая геометрическое
абсолютный:  абсолютная
комментарий:  комментариев
встречаться:  встречаются встречается
тот:  тому той ту
сложенияй:  сложенияи
происходить:  происходило
регрессия:  регрессии регрессия
требовать:  требуют
исчисление:  исчисления
премия:  премия
чистовик:  чистовике
локальный:  локальная
методичка:  методичек
ожидание:  ожидание
лаплас:  лапласа
перегиб:  перегиба
сходимость:  сходимости сходимость
ход:  ходу
задача:  задачи задач задачах
оказаться:  оказаться оказались
сослаться:  сослаться
ду:  ду
работать:  работают
далее:  далее
обладать:  обладает
коэффициент:  коэффициент
неопределённый:  неопределенный неопределенном
собственный:  собственные собственную
признак:  признак признаки
запутаться:  запутаться
устрашение:  устрашения
рядом:  рядом
наполовину:  наполовину
поэтому:  поэтому
практика:  практике
менять:  меняет
коль:  коль
асимметрия:  асимметрия
шаг:  шаге
вслух:  вслух
риск:  риск
главный:  главную
сводиться:  сводящиеся
жить:  живём
собственно:  собственно
маленький:  меньше
составить:  составим составить
например:  например
решенияопределённый:  решенияопределенных
хотя:  хотя
независимый:  независимыми независимой независимые
коэффициентковариация:  коэффициентковариации
выполнение:  выполнение
широкий:  широком
чушь:  чушь чушью
лопиталя:  лопиталя
удовольствие:  удовольствие
крайне:  крайне
осмысление:  осмысление
обычно:  обычно
поляформула:  поляформула
забавный:  забавный
компакт:  компакт
фехнера:  фехнера
эффективный:  эффективные
условный:  условные
полететь:  полетели
эллипс:  эллипс
учиться:  учился учимся
сократить:  сократить
даламбер:  даламбера
теорема:  теоремы
факт:  факт
повторнойя:  повторнойи
сложность:  сложностей сложности
комплексный:  комплексные комплексного комплексный комплексными
аналогия:  аналогии
ранг:  ранг
кривая:  кривой
тяжестиплоска:  тяжестиплоской
видеть:  видели видите
школа:  школе школа
назвать:  назвать
преподаватель:  преподаватель
построить:  построить
смешанный:  смешанные смешанных смешанная
внимание:  внимание
логарифм:  логарифм
лейбниц:  лейбница
неравенство:  неравенства
поток:  поток
медиана:  медиана
потратить:  потратить
расстраиваться:  расстраивайтесь
направлениюй:  направлениюи
гостевой:  гостевая
скоро:  скоро
аккуратно:  аккуратно
понятно:  понятно
недочёт:  недочётом
внутригрупповаяй:  внутригрупповаяи
зависеть:  зависит
формулировка:  формулировке
досада:  досаде
алгебра:  алгебры
сумма:  сумму сумма
энтропия:  энтропии
называть:  называемую
существовать:  существует существуют
прямоугольник:  прямоугольников
эксцессэмпирический:  эксцессэмпирического
выбрать:  выбрать
оценка:  оценка оценки
криволинейный:  криволинейные
пропустить:  пропущу
библиотека:  библиотека
наименьшеезначение:  наименьшеезначения
прядка:  прядка
сила:  силы
вычислимый:  вычислим
интересный:  интереснее
системылинейный:  системылинейных
нужно:  нужно
довод:  доводами
зависимость:  зависимость
информация:  информация
физика:  физики
замкнутый:  замкнутому
должный:  должен должно
очевидный:  очевидно
приноровиться:  приноровится
линейность:  линейности
задаваться:  задается
сильно:  сильно
площадьс:  площадьс
задачка:  задачек
исполнять:  исполняли
убыванией:  убываниеи
повышенный:  повышенной
статистический:  статистическая статистические
проделывать:  проделываем
интегрирование:  интегрирование
легко:  легко
нуль:  нулю
раскрутка:  раскрутка
интервальный:  интервальный
синус:  синусом
мера:  мере
бред:  бредом
фундаментальный:  фундаментальная
среднее:  среднем
вообще:  вообще
лично:  лично
оценкия:  оценкии
неявный:  неявной
несобственныхинтеграл:  несобственныхинтегралов
вероятностибиномиальный:  вероятностибиномиального
опровергнуть:  опровергла
экстрасенс:  экстрасенсов
род:  рода
гаусс:  гаусса
грубый:  грубым
естественнонаучный:  естественнонаучного
бассейн:  бассейн
экстремальный:  экстремальные
обозначаться:  обозначаются
нормаль:  нормали
определитель:  определитель
желать:  желающие
скандал:  скандал
выпуклость:  выпуклость
противоположный:  противоположный
элемент:  элементы
интересно:  интересно
значенияй:  значенияи
фм:  фм
назад:  назад
гиперповерхность:  гиперповерхность гиперповерхности
многомерный:  многомерном
нужный:  нужной
проверять:  проверял
атмосферный:  атмосферное
классическоеопределение:  классическоеопределение
инормаль:  инормаль
головоломка:  головоломкой
парадоксальный:  парадоксально
гуд:  гуд
пирамида:  пирамида
пуанкара:  пуанкаре
наслать:  нашли
автор:  автор автора
столько:  столько
отходить:  отходя
дифференциальный:  дифференциальные
уравненияс:  уравненияс
комедия:  комедия
онлайн:  онлайн
разобрать:  разберём
геометрия:  геометрии геометрия
работа:  работа
новый:  новому
произвольныйтройный:  произвольныйтройной
получить:  получите получили получи
дизайн:  дизайна
это:  это
странный:  странным страннее
поляй:  поляи
опечатка:  опечатку
василиевич:  васильевич
отмерить:  отмерь
продолжать:  продолжаем
благообразный:  благообразно
методомоперационный:  методомоперационного
бесповторный:  бесповторной
правильно:  правильно
ошибка:  ошибку ошибок
л:  л
важно:  важно
слово:  слову слова
наука:  наука наукой
взять:  взять
касательный:  касательных
разбираться:  разбираемся
диск:  диски
типовыхзадача:  типовыхзадач
один:  одной
ранговойкорреляция:  ранговойкорреляции
разбирать:  разбираем
жизнь:  жизни
шаблон:  шаблон
хотеть:  хотели
землянин:  землян
сколько:  сколько
представить:  представить
исследовать:  исследовать
общаться:  общались
нетрудно:  нетрудно
мудрость:  мудрость
линейныйкоэффициент:  линейныйкоэффициент
давление:  давление
несобственныйинтеграл:  несобственныйинтеграл
несложный:  несложных
доступно:  доступно
опыт:  опыте
рулетка:  рулеткой
разум:  разуму
причём:  причём
повториться:  повторюсь
задавать:  задаваемые
ипример:  ипримеры
множество:  множества
живой:  живой
поверхностный:  поверхностные
фигура:  фигуры
пуассон:  пуассона
таки:  таки
пятый:  пятое
математическоеожидание:  математическоеожидание
дать:  данной
неоднородный:  неоднородные
необходимо:  необходимо
оформить:  оформить
прозвучать:  прозвучит
разгрузка:  разгрузки
шесть:  шесть
думать:  думаю
кратное:  кратные
системудифференциальный:  системудифференциальных
помимо:  помимо
уметь:  уметь
алгоритм:  алгоритм
провести:  проведенный
последовательность:  последовательностей
квадратичный:  квадратичные
объём:  объем объему
летать:  летающую
проверить:  проверить
утверждать:  утверждать
поскольку:  поскольку
гипергеометрическоераспределение:  гипергеометрическоераспределение
относительность:  относительности
обратить:  обратите
подойти:  подошел
равномерный:  равномерная равномерное
треугольный:  треугольная
похожий:  похожей похожи
освоиться:  освоились
мой:  моей
пожалуйста:  пожалуйста
ку:  ку
ориентироваться:  ориентироваться
записываться:  записывается
следовать:  следует
себя:  собой
возникнуть:  возникнут
сразу:  сразу
объёмный:  объемное
функциюкомплексный:  функциюкомплексной
напоминать:  напоминаю
мода:  мода
свойстваэлементарный:  свойстваэлементарных
дэ:  дэ
краткий:  краткое
калькулятор:  калькулятор
пиар:  пиар
равный:  равна
предлагать:  предлагаю
действительно:  действительно
экстремум:  экстремумы
горнера:  горнера
предельно:  предельно
функцийв:  функцийв
три:  трех трёх
загрузиться:  загрузился
финальный:  финальному
чайниковский:  чайниковский
довольно:  довольно
заслуга:  заслугу
дискретнойслучайный:  дискретнойслучайной
горячий:  горячим
идти:  идём
прекрасно:  прекрасно
самый:  самое
благодать:  благодать
крамер:  крамера
проработать:  проработали
мы:  нами
предсказание:  предсказания
освоение:  освоения
андромеда:  андромеды
парабола:  парабола
строго:  строго
открутить:  открутить
запретить:  запрещено
выполнять:  выполняем
функциидвуха:  функциидвух
пора:  пора
черновик:  черновике
емелин:  емелин
навёрстывать:  навёрстываем
вычисленияопределенный:  вычисленияопределенных
задачин:  задачина
замечательный:  замечательные
системый:  системыи
удовлетворяетлить:  удовлетворяетли
ошибаться:  ошибаться
потеря:  потеря
всякий:  всякий
перейти:  перейти
внутренний:  внутренней
тригонометрический:  тригонометрических
чётко:  чётко
группа:  группа
уверенный:  уверенной
упустить:  упущенное
страшный:  страшные
заданав:  заданав
абсурд:  абсурд
порядок:  порядка порядков
всё:  всё
тройной:  тройные
деление:  деления
контуруформула:  контуруформула
частное:  частного
график:  график
вселенная:  вселенной
незатейливый:  незатейливо
ползать:  ползал
пропускать:  пропускайте
рекомендовать:  рекомендую
примерно:  примерно
зет:  зет
вещь:  вещью
мир:  мире
я:  мной
способ:  способ
корреляция:  корреляции
заочник:  заочников
мозг:  мозг
максимально:  максимально
говорить:  говоря
повторять:  повторяем
