вектор:  векторы векторов
негативный:  негативное
получить:  получить получи
цель:  целях
выполнить:  выполненной выполнены выполнить выполнено
вращение:  вращения
третий:  третьим третье
дифференциальный:  дифференциальные
первый:  первый первой первому первых первом первого
уравненияс:  уравненияс
постараться:  постарался
упрощение:  упрощение упрощений
сообразить:  сообразишь
именно:  именно
онлайн:  онлайн
разобрать:  разберём разобрать
геометрия:  геометрии геометрия
использоваться:  используется
копирование:  копирование
дать:  дано данной данному
замечательный:  замечательных замечательному замечательного замечательной замечательными замечательным замечательный замечательные
натуральный:  натуральной
решить:  решить
рассмотреть:  рассмотрели рассмотрена рассмотрены рассмотрим рассмотренным рассмотренном рассмотренный
разрыв:  разрыва
один:  одного одном
выражение:  выражения выражением выражение
неудобно:  неудобно
нуль:  нуля нулей нулю
производный:  производные производная производной производную
прямой:  прямой прямую прямая
дуприближённо:  дуприближённо
работа:  работа
слагаемое:  слагаемое слагаемые
предел:  предел пределом пределами пределу пределах предела пределы пределе пределов
сумма:  сумма сумму суммы
модель:  модели модель
выбор:  выборе
новый:  новому новой новая
произвольныйтройный:  произвольныйтройной
информация:  информации
ниже:  ниже
асимптота:  асимптоты
разложить:  разложить разложим
дизайн:  дизайна
вычисленияопределенный:  вычисленияопределенных
это:  это
значок:  значок
событие:  события
число:  чисел числу число числами числа
отблагодарить:  отблагодарить
повторный:  повторные
байес:  байеса
числовой:  числовые
дисперсия:  дисперсию дисперсия дисперсии
решать:  решать решаем
производныенеявно:  производныенеявно
длинный:  длиннее
таблица:  таблицу таблицей таблицы таблице
значение:  значение значения значениях
пример:  примере примерами примеры пример примеру примеров примерах
скорее:  скорее
детально:  детально
решение:  решений решения решением решение
простить:  простит
бублик:  бублика
интеграл:  интегралы интеграла интеграл интеграле интегралов интегралах
поляй:  поляи
опечатка:  опечатку
общий:  общему общим общая
результат:  результат результаты результате
математический:  математические математическая математической
теория:  теория теории
приключение:  приключения
отсутствовать:  отсутствует отсутствуют
знать:  знает знаю
строка:  строку строке строки
выгодный:  выгоднее
способ:  способом способов способу способ
многочлен:  многочлене многочленов многочлены многочлен
состоять:  состоит состоять
трудоёмкость:  трудоёмкость
преобразовать:  преобразуем
закончиться:  закончится
речь:  речь
формула:  формулы формулах формула формулу формуле
данный:  данном
забавно:  забавно
замена:  замену замены замена заменой
статья:  статье статьи
фнп:  фнп
особенно:  особенно
называть:  называют
канонический:  каноническому
переставлять:  переставляем
простейшее:  простейшие
знаменатель:  знаменателя знаменателю знаменателе знаменателем знаменатель
стремиться:  стремиться стремится стремилась
умножить:  умножить умножим
экспонент:  экспонент
иной:  иными
гипотеза:  гипотезы гипотез гипотеза
параметр:  параметра
дифференциал:  дифференциалах дифференциала
перестановка:  перестановке
больший:  наибольшее
двумерный:  двумерная
подбирать:  подбираем
задать:  заданной задайте
многие:  многие
заметить:  заметьте заметили
конец:  конце концом
часть:  частям части
оказаться:  оказались
тело:  тела
циркуляция:  циркуляция
методомоперационный:  методомоперационного
бесповторный:  бесповторной
слева:  слева
правильно:  правильно
двойной:  двойные двойной
предназначить:  предназначен
слуга:  слуга
ошибка:  ошибку
плоскость:  плоскости плоскость
несобство:  несобств
отношение:  отношение отношении
избавляться:  избавляемся
незаслуженно:  незаслуженно
л:  л
нелинейный:  нелинейная
квадратный:  квадратные
получиться:  получится получилось получился
применить:  применить
какой:  каком каким
связь:  связи связь
преобразованиеквадратичный:  преобразованиеквадратичной
вещь:  вещь вещи
определителяй:  определителяи
выносить:  выносим
вогнутостья:  вогнутостьи
вычитать:  вычитаем
страх:  страх
наворотить:  навороченных
трёхэтажность:  трёхэтажности
напрашиваться:  напрашивается
степень:  степени степень
измениться:  изменилось
дважды:  дважды
согласно:  согласно
вид:  виде виды виду
инициатива:  инициативу
курс:  курса курс
закон:  законы
справа:  справа
дробь:  дроби дробей дробях дробь
затруднение:  затруднения
встречать:  встречал
особенность:  особенность
функциональный:  функциональные
банк:  банке
возводить:  возводим
завершать:  завершающий завершающее
комментарий:  комментарии
раритет:  раритету
координата:  координатах координат координаты
касательный:  касательных
продолжить:  продолжим
самый:  самым самые
убедиться:  убедиться
упрощать:  упрощаем
качество:  качестве
профессия:  профессию
константа:  константу
действие:  действий действия
пусть:  пусть
геометрический:  геометрическая геометрическое
абсолютный:  абсолютная
типовыхзадача:  типовыхзадач
графика:  графика графики
половинный:  половинного
умножение:  умножения умножением умножении
вероятность:  вероятностей вероятность вероятности
сопрячь:  сопряженным сопряженные сопряженное
встречаться:  встречаются
выполнимый:  выполним
система:  система систему системе системы
частный:  частные частное
счастливый:  счастливым
функция:  функций функцией функции функциях функция
воспользоваться:  воспользоваться
группировка:  группировок группировка
непрерывный:  непрерывная непрерывных
ранговойкорреляция:  ранговойкорреляции
условнаясходимость:  условнаясходимость
сложенияй:  сложенияи
уравненийв:  уравненийв
плюшка:  плюшки
слово:  словами
раскрывать:  раскрываем
существенный:  существенная
угол:  угол углу угла
фигурировать:  фигурирует
отнестись:  отнесёмся
регрессия:  регрессии регрессия
величина:  величин величина величины
хорошенько:  хорошенько
александр:  александр
взять:  возьмите
вспомниться:  вспомнился
нажить:  нажито
вычитание:  вычитание
искомое:  искомое
продолжаться:  продолжаются
предупредить:  предупредить
термин:  термины
помнить:  помню
соответствовать:  соответствующий соответствует
множитель:  множители
который:  которые которых который которой которая которое
грин:  грина
полный:  полное полных полной
исчисление:  исчисления
линейный:  линейные линейная линейных линейной
жизнь:  жизни
эйлер:  эйлера
шаблон:  шаблон
другой:  другому другими других другие другим
правый:  правой
посвятить:  посвящен
насыщенный:  насыщенная
улица:  улице
закачать:  закачать
согласие:  согласия
локальный:  локальная
воспалить:  воспалённым
эквивалентность:  эквивалентности эквивалентность
сказать:  сказать
ожидание:  ожидание
сколько:  сколько
математика:  математики математике
лаплас:  лапласа
такой:  таким такие такое
перегиб:  перегиба
сходимость:  сходимости сходимость
дуоперационный:  дуоперационным
исследовать:  исследовать
поехать:  поехали
дискретный:  дискретный
пригодиться:  пригодится
базис:  базисах базис базису
никто:  никто
ход:  ходу
поверхность:  поверхности
знакочередоваться:  знакочередующиеся
вычисление:  вычислений вычисления вычисление
задача:  задачи задач задачах
векторный:  векторного векторное
отрицательный:  отрицательных
ду:  ду
принцип:  принцип
далее:  далее
зависимостьвектор:  зависимостьвекторов
рисовать:  рисуем
домножать:  домножаем
распространить:  распространённый распространённому распространенные
делать:  делать
снова:  снова
раз:  разу раза
остаток:  остатка остатке
известный:  известному
линейныйкоэффициент:  линейныйкоэффициент
коэффициент:  коэффициент коэффициенты
неопределённый:  неопределенный неопределенном
нахождение:  нахождении
практикум:  практикум
сначала:  сначала
круг:  круг
метод:  методы методом метод
сам:  самому сама самом
тема:  теме тему
страница:  страницу
собственный:  собственные
числитель:  числителе числитель числителя
ваш:  ваш ваши
отличиться:  отличатся
признак:  признак признаки
несобственныйинтеграл:  несобственныйинтеграл
произвольный:  произвольных
данные:  данных
сложный:  сложной посложнее сложных сложный сложные сложная сложен
открыть:  откроем
доступно:  доступно
свестись:  сведётся
четвёртый:  четвёртым
работать:  работает работать
причём:  причём
фурье:  фурье
урок:  урока уроке
поле:  поля
поэтому:  поэтому
разложение:  разложением разложение
избавиться:  избавились
разделить:  разделить разделим
свойство:  свойства
практика:  практике
учиться:  учимся
задавать:  задаваемые
типовой:  типовой
деление:  делении делением деление деления
теоретический:  теоретический
анекдот:  анекдот
исследование:  исследование
икс:  икс
одночлен:  одночлен
ипример:  ипримеры
уравнение:  уравнению уравнений уравнения уравнение
точка:  точки точке
множество:  множества
найти:  найти
проблема:  проблем
переход:  переход
вариация:  вариации
знакомый:  знакомый знакомы знакомая
асимметрия:  асимметрия
шаг:  шаге шагах шаг
оценка:  оценки оценка
комплексный:  комплексными комплексные комплексного комплексный
указывать:  указывая
основа:  основы
студент:  студент
поверхностный:  поверхностные
мало:  мало
высказать:  высказал
интервал:  интервалы
достижение:  достижением
книга:  книга книги
заметка:  заметку
главный:  главную
кош:  коши
сверху:  сверху
фигура:  фигуры
пуассон:  пуассона
подобный:  подобные
сводиться:  сводящиеся
ножка:  ножки
чайник:  чайников
алгоритм:  алгоритма алгоритм
преобразование:  преобразований преобразование преобразования
вычисленияс:  вычисленияс
целесообразно:  целесообразно
однако:  однако
малый:  малые наименьших малых
таки:  таки
понижение:  понижением понижение
матричный:  матричные матричных матричный
пора:  поры
сокращение:  сокращения
навык:  навыки
математическоеожидание:  математическоеожидание
однородный:  однородные однородным
решенияопределённый:  решенияопределенных
итог:  итоге
записывать:  записываем
вычислить:  вычислить
выглядеть:  выглядит
нормальный:  нормальное
очень:  очень
школа:  школа школе
два:  двух
интегральнаятеорема:  интегральнаятеоремы
удобный:  удобнее удобный
корнимногочлен:  корнимногочлена
логарифмический:  логарифмическая
корень:  корнем корень
условие:  условие
матрица:  матрицу матрицы матрицами
раскручиваться:  раскручивается
оформлять:  оформляем оформлять
этап:  этапе
испытанияй:  испытанияи
интегралыть:  интегралыв
привыкнуть:  привык
неоднородный:  неоднородные
начать:  начнём начните начать
козлик:  козлика
перегруппировка:  перегруппировка
необходимо:  необходимо
экспонента:  экспонентой
волос:  волосы
правило:  правило правила правилу правилом
приводить:  приводим
основной:  основные
тангенс:  тангенса тангенс
пойти:  пойдёт
помощь:  помощью
осторожный:  осторожнее
бернулли:  бернулли
единица:  единицу единицы
полярный:  полярные полярной полярных
исходный:  исходный
коэффициентковариация:  коэффициентковариации
конкретный:  конкретными
ряд:  ряд ряды ряда рядов
вариационный:  вариационный
рвать:  рвать
уровень:  уровня уровнем
обратный:  обратная обратную
второй:  второй второго вторую
думать:  думаю
цикл:  цикл
вопрос:  вопросы вопрос вопроса
кратное:  кратные
неопределённость:  неопределённости неопределённость
внимание:  вниманием внимание
присниться:  приснится
обделить:  обделены
системудифференциальный:  системудифференциальных
синус:  синусам синуса
перечисленный:  перечисленные
блог:  блог
доверительный:  доверительные
высокий:  высших высшей высшая высоким
делить:  делить делили
ограничивать:  ограничивает
среднееквадратический:  среднееквадратическое
пространство:  пространстве
тип:  типа
лопиталя:  лопиталя
говориться:  говорится
последний:  последнее
последовательность:  последовательностей
комбинационный:  комбинационная
должный:  должно должен
квадратичный:  квадратичные
быть:  будьте будут будем
наглядный:  наглядная
смешанноепроизведение:  смешанноепроизведение
черта:  чертой
напоследок:  напоследок
ориентация:  ориентации
объём:  объем
столбик:  столбиком
поляформула:  поляформула
тригонометрический:  тригонометрической тригонометрических тригонометрические тригонометрическую
непосильный:  непосильным
сообщить:  сообщите
проверить:  проверить проверим
линия:  линиями линии линия
фехнера:  фехнера
аналитический:  аналитическая аналитической
мой:  моим
предварительный:  предварительный
аналогичный:  аналогичны аналогичные
школьный:  школьный
эффективный:  эффективные
поскольку:  поскольку
центр:  центр
сервак:  сервак
свести:  сведён свести
образ:  образом
гипергеометрическоераспределение:  гипергеометрическоераспределение
условный:  условные
непрерывнаяслучайный:  непрерывнаяслучайная
дико:  дико
эллипс:  эллипс
оба:  обеих оба
ноль:  ноль
обратить:  обратите
прямо:  прямо
отчёркивание:  отчёркивание
длина:  длина
материал:  материал материалы материалов
сайт:  сайта сайты сайт
мочь:  могут
знакопостоянство:  знакопостоянства
сократить:  сократить
разность:  разности разность
технический:  техническую
понятие:  понятие
подробно:  подробно
равномерный:  равномерная равномерное
треугольный:  треугольная
градиент:  градиент
писать:  пишем
прибавлять:  прибавляем
определение:  определения определению
необходимость:  необходимость
прикреплять:  прикрепляя
использовать:  используйте используя использовать используем
пожалуйста:  пожалуйста
даламбер:  даламбера
сторона:  сторону
теорема:  теоремы
затем:  затем
комбинаторика:  комбинаторике
случайнаявеличина:  случайнаявеличина
преимущественно:  преимущественно
повторнойя:  повторнойи
построение:  построение
мучиться:  мучиться
проверка:  проверку проверка
бесконечно:  бесконечно
давать:  даёт давать
оговориться:  оговорюсь
линейнойкорреляционный:  линейнойкорреляционной
делиться:  делится
программа:  программа
маленький:  мал
труд:  трудом
время:  время времени
скобка:  скобки
ранг:  ранг
квадрат:  квадратов
кривая:  кривой
логарифм:  логарифмом
форма:  формы
организовать:  организуем
сознание:  сознанием
тяжестиплоска:  тяжестиплоской
закусочный:  закусочный
начальный:  начальном начальный
сразу:  сразу
девчонка:  девчонки
почему:  почему
устранить:  устранить устранена
распределениякритерия:  распределениякритерий
окончательный:  окончательный
функциюкомплексный:  функциюкомплексной
кратко:  кратко
случай:  случаи случае случаю
техника:  технике техника
напоминать:  напоминаю
область:  область области
небольшой:  небольшим невелики
понятный:  понятнее
стандартный:  стандартным
аргумент:  аргумента аргумент
предстоять:  предстоит
построить:  построить
повестка:  повестке
готовый:  готовых готово
несобственный:  несобственные
просто:  просто
нумерация:  нумерации
мода:  мода
выполнять:  выполнять выполняем
приём:  приём
провести:  проведём проведем провести
свойстваэлементарный:  свойстваэлементарных
ещё:  ещё
заездить:  заезженный
вернуться:  вернёмся вернитесь
закомментировать:  закомментирую
лейбниц:  лейбница
калькулятор:  калькулятор
родить:  рождены
избыточный:  избыточной
недоставать:  недостающие
научиться:  научиться
отчёркивать:  отчёркиваем
неравенство:  неравенства
свирепый:  свирепый
поток:  поток
удовлетворять:  удовлетворяет
делимое:  делимое
касательная:  касательная
ответ:  ответ ответы
задачис:  задачис
герой:  героя
медиана:  медиана
функциия:  функциии
видеть:  видел
записать:  записать
частый:  чаще
степенной:  степенного степенные
переворачиваться:  переворачиваются
функцийдвуха:  функцийдвух
направлениюй:  направлениюи
определённый:  определенный определенного
читатель:  читателей
выборка:  выборке
трофей:  трофей
единственный:  единственное
гостевой:  гостевая
незнакомец:  незнакомца
деться:  делась
наличие:  наличие
действительно:  действительно
распределение:  распределения распределение
использование:  использовании
кроме:  кроме
экстремум:  экстремумы
горнера:  горнера
основание:  основание
подстановка:  подстановку подстановке
производныефункция:  производныефункции
средний:  средняя средним
равный:  равен
пошуршать:  пошуршать
запрещать:  запрещают
повысить:  повысив
понятно:  понятно
функцийнесколький:  функцийнескольких
знак:  знаком знак
искусственный:  искусственное искусственный
подготовка:  подготовки
альфа:  альфа
закрепление:  закрепления
применять:  применять
внутригрупповаяй:  внутригрупповаяи
тривиальный:  тривиальным
подобрать:  подобрать
приступить:  приступим
алгебра:  алгебры
получать:  получаем
математик:  математика
рост:  роста
предосудительный:  предосудительного
переменный:  переменных переменная переменной
раскладывать:  раскладывать
функцийв:  функцийв
ознакомиться:  ознакомиться
несовместный:  несовместные
независимыеслучайный:  независимыеслучайные
множественнойлинейный:  множественнойлинейной
удовольствие:  удовольствием
рука:  рука
рассматривать:  рассматриваемого
довольно:  довольно
анализ:  анализ анализа
оборот:  оборот
искать:  ищем
минус:  минус
непрерывность:  непрерывность
прямоугольник:  прямоугольников
эксцессэмпирический:  эксцессэмпирического
напомнить:  напомню
выбрать:  выбрать
возникнуть:  возникли
выступать:  выступать
функциис:  функциис
обещать:  обещанные
прописывать:  прописываем
лёгкий:  легче
зеркало:  зеркало
криволинейный:  криволинейные
значит:  значит
различный:  различных
пирсон:  пирсона
устранение:  устранения
свой:  своё
библиотека:  библиотека
три:  трёх
межгрупповой:  межгрупповая
каждый:  каждый
ортогональный:  ортогональное
разборка:  разборки
архив:  архив
дискретнойслучайный:  дискретнойслучайной
забытый:  забыты
задачипо:  задачипо
простой:  простые
похожий:  похож
делитель:  делитель
востребовать:  востребованную
наименьшеезначение:  наименьшеезначения
нсв:  нсв
сила:  силы сил
приблизить:  приближенные
подойти:  подошли
короткий:  короткий
нелепый:  нелепых
видно:  видно
сносить:  сносим
старший:  старшая
открывать:  открываем
иллюстрация:  иллюстрация
системылинейный:  системылинейных
нужно:  нужно
важный:  важную
быстро:  быстро
трёхчлен:  трёхчлены
почленный:  почленное
упасть:  упал
соответствие:  соответствии
зависимый:  зависимые
ликвидироваться:  ликвидируется
зависимость:  зависимость
отклонение:  отклонение
покорный:  покорный
крамер:  крамера
отрезка:  отрезке
произведение:  произведение
свидетель:  свидетели
кто:  кому
случайный:  случайных случайные
замкнутый:  замкнутому
нестандартный:  нестандартного
очевидный:  очевидно
дуга:  дуги
частность:  частности
отрезкать:  отрезкав
подвернуться:  подвернулись
расправляться:  расправляемся
сравнить:  сравните
дивергенция:  дивергенция
парабола:  парабола
форум:  форуме форум
показатель:  показатели показателе
следующий:  следующий следующие следующее
наш:  наш нашего нашем
отличие:  отличие
сильно:  сильно
площадьс:  площадьс
функциидвуха:  функциидвух
солидный:  солиднее
запретить:  запрещено
статистический:  статистические статистическая
энтузиазм:  энтузиазмом
емелин:  емелин
идти:  идёт
умножать:  умножаем
сей:  сей
убыванией:  убываниеи
вводный:  вводного
детерминация:  детерминации
повышенный:  повышенной
возрастание:  возрастание
эмпирический:  эмпирические
также:  также
интегрирование:  интегрирование
обязательно:  обязательно
задачин:  задачина
рациональный:  рациональные
системый:  системыи
удовлетворяетлить:  удовлетворяетли
найтись:  нашлось
место:  месте
аналогично:  аналогично
пока:  пока
пятый:  пятым
сегодня:  сегодня
дифференциальныеуравнение:  дифференциальныеуравнения
нулевой:  нулевые
приходиться:  приходится
явный:  явном
иррациональный:  иррациональных
интервальный:  интервальный
убеждённый:  убеждён
перейти:  перейти
применение:  применения
постоянный:  постоянных
стокс:  стокса
квадратичнуюформ:  квадратичнуюформу
сокращать:  сокращаем
схема:  схема схеме схемы
карта:  карта
косинус:  косинус косинусам косинуса
устраняться:  устраняется
параметрический:  параметрической параметрическом
проводить:  проводим
куб:  кубов
некоторый:  некоторое некоторые
гипербола:  гипербола
вообще:  вообще
жалко:  жалко
одинокий:  одинокий
дробовик:  дробовик
они:  ними
лично:  лично
оценкия:  оценкии
неявный:  неявной
признаваться:  признавайтесь
несобственныхинтеграл:  несобственныхинтегралов
вероятностибиномиальный:  вероятностибиномиального
поделиться:  поделился
вероятностия:  вероятностии
логика:  логики
спирмена:  спирмена
скалярный:  скалярное
род:  рода
гаусс:  гаусса
заданав:  заданав
перехватить:  перехватите
порядок:  порядка порядков
всё:  всё
значимость:  значимости
номер:  номеров
тройной:  тройные
возникать:  возникает
выписать:  выпишем
являться:  является
заключительный:  заключительный
выразить:  выразить
точно:  точно
рассказывать:  рассказывать
контуруформула:  контуруформула
кубический:  кубические
экстремальный:  экстремальные
вовсе:  вовсе
вышеуказанный:  вышеуказанных
остаться:  остались оставшееся
график:  график
лишь:  лишь
дело:  деле дело
парный:  парной
день:  дня
св:  св
нормаль:  нормали
присест:  присест
определитель:  определитель
желать:  желающие
искусственно:  искусственно
выпуклость:  выпуклость
хах:  хах
экземпляр:  экземпляры
элемент:  элементы
встретить:  встретите
сборник:  сборники
верно:  верно
показательный:  показательное
иегова:  иеговы
сложность:  сложность сложности
рекомендовать:  рекомендую
зачистка:  зачистке
раскрыть:  раскрыть
независимый:  независимые
менее:  менее
автор:  автора автор
диффура:  диффурами
почленно:  почленно
котангенс:  котангенсом
часто:  часто
набиваться:  набивается
пользоваться:  пользуясь
значенияй:  значенияи
привести:  привести
подробный:  подробным
рожок:  рожки
весьма:  весьма
никуда:  никуда
конечный:  конечному
менять:  меняем
нужный:  нужной
обойтись:  обошлось
получаться:  получается
любой:  любом
кстати:  кстати
территория:  территории
классическоеопределение:  классическоеопределение
инормаль:  инормаль
статистика:  статистика
корреляция:  корреляции
прежде:  прежде
редкий:  редкими
биномиальный:  биномиальное
пирамида:  пирамида
заочник:  заочников
повторение:  повторения
линиюв:  линиюв
фантастически:  фантастически
разоблачить:  разоблачить
находиться:  находятся
история:  история
самостоятельный:  самостоятельного
отобрать:  отобрать
делимый:  делим
повторять:  повторяем
второе:  второе
критерий:  критерию
