вектор:  векторы вектора векторов
раздел:  разделе раздела разделу разделов раздел
отработка:  отработки
техника:  технику технике техники
вращение:  вращения
добротный:  добротный
дифференциальный:  дифференциальные дифференциальными дифференциальное дифференциальных
действительный:  действительной
серьёзный:  серьёзный серьёзные
смысл:  смысл
геометрия:  геометрии геометрия
укрепляться:  укрепляемся
решить:  решить
изучение:  изучением изучению изучения
выражение:  выражения выражений
предыдущий:  предыдущей
симпсон:  симпсона
производный:  производные производная производной производную
прямой:  прямой прямую прямая
новый:  новому новой
предел:  предел предела пределы пределов
ниже:  ниже
посетить:  посетите
рабочий:  рабочий рабочие
асимптота:  асимптоты
это:  это
стараться:  старался
мнимый:  мнимой
событие:  события
повторный:  повторные
неопределённый:  неопределенных неопределённые неопределенные
байес:  байеса
числовой:  числовые числового
поверхность:  поверхностей поверхности поверхность
значение:  значение значения значений
блок:  блока блоков
непрерывный:  непрерывной непрерывная непрерывных непрерывные
находиться:  находится
интеграл:  интегралы интеграла интеграл интегралов интегралах интегралам
обширный:  обширный
осваивать:  осваиваем
приложение:  приложениям приложение приложения
теория:  теория теории
находить:  находить
параметрически:  параметрически
математический:  математические математической математического математическое
продолжение:  продолжение
продолжать:  продолжаем
разбирать:  разбираю
лимит:  лимитов
данный:  данную данном данный
носить:  носят
ресурс:  ресурсы
многий:  многими многих многим
формула:  формулы формула
смотреть:  см
сам:  сами
фнп:  фнп
поиск:  поиск поиском
учебный:  учебные
трудный:  трудный трудной трудная
канонический:  каноническому
потенциальный:  потенциальное
начинающий:  начинающих
простейшее:  простейшие
конспект:  конспект
два:  две двум двух
криволинейный:  криволинейных криволинейные
операторный:  операторным
самый:  самых
дифференциал:  дифференциалах дифференциала
больший:  наибольшее большие наибольшего
базовый:  базовых базовый базовые
который:  которых которые которой которая
задать:  заданной задайте задана
уравнение:  уравнениями уравнению уравнений уравнения уравнение
конец:  конце
часть:  частям часть части
двумерный:  двумерная
тело:  тела
страница:  страницами страницу страницы
двойной:  двойного двойные двойной двойным
циркуляция:  циркуляция
неявно:  неявно
доступный:  доступные доступная
разложение:  разложению разложение
обратный:  обратной обратная обратную
тройной:  тройной тройные тройным
нижеследующий:  нижеследующим
довесок:  довесок
плоскость:  плоскости плоскость
сильвестр:  сильвестра
следующий:  следующих следующими следующую следующего
случайный:  случайная случайной случайных случайные
практический:  практические практическую
замкнутый:  замкнутую замкнутому
общий:  общим
интересный:  интереснейшая
оставить:  оставить
расположить:  расположить
мир:  мир
операционный:  операционного
график:  графиков
выделить:  выделить
алгебра:  алгебра алгебре
закон:  законы закон
первый:  первым первого
функциональный:  функциональные функциональных
судьба:  судьбы
случай:  случай случае
касательный:  касательных
самовар:  самоваров
статья:  статья статьями статью статьи статьям статьёй
освоить:  освоить
приближённый:  приближённого приближённых приближённое приближённые
распространение:  распространение
разбираться:  разбираемся
тот:  той та тех
прожечь:  прожжённых
вогнутость:  вогнутость
графика:  графика графики
абсолютный:  абсолютная
умножение:  умножения
вероятность:  вероятностей вероятности
воспользоваться:  воспользоваться
система:  система систему системе системы
частный:  частные частных частное
функция:  функций функцию функции функция
критерий:  критерий
исследование:  исследования исследованию исследование
треугольник:  треугольником
окружность:  окружность окружностей
подбор:  подбора
свой:  свой свои
заключительный:  заключительная
плохой:  плохи
александр:  александр
подготовить:  подготовленных
готовенький:  готовеньких
урок:  уроках урок уроков уроки
величина:  величин величина величины
иметь:  имеют имеет
необходимый:  необходимый
продвинуть:  продвинутый
уровень:  уровень уровня
логический:  логической
полный:  полное полных полной полному
суть:  сути
исчисление:  исчисления
линейный:  линейные линейная линейных
эйлер:  эйлера
выразить:  выражена
объём:  объём объем
быть:  суть будьте
восстановить:  восстановить
локальный:  локальная
эквивалентность:  эквивалентности
популярный:  популярная популярное
студент:  студента студентам
известный:  известной известная
ожидание:  ожидание
математика:  математики математику математике
лаплас:  лапласа
представить:  представить представлена представлены
сходимость:  сходимости сходимость
исследовать:  исследовать
поехать:  поехали
дискретный:  дискретный дискретные дискретных дискретной
кривая:  кривых кривой
базис:  базисах базис базису
вычисление:  вычислений вычисления вычисление
задача:  задачи задач задача
знакочередоваться:  знакочередующиеся
векторный:  векторного векторное векторные
несколько:  нескольких несколько
наиболее:  наиболее
ду:  ду
справочный:  справочные справочными справочный справочная
нахождение:  нахождении нахождение
небоскрёб:  небоскрёб
практикум:  практикум
лекция:  лекций лекцией лекция лекции
посвятить:  посвящена посвящён
сначала:  сначала
метод:  методы методам методом метод
дробь:  дробей
пожалуй:  пожалуй
тема:  теме тема тему темой темы
собственный:  собственные
составлять:  составляю
рассмотреть:  рассмотрена рассмотрел
угорелый:  угорелых
навигационный:  навигационному
признак:  признак признаки
произвольный:  произвольных произвольного произвольный
сложный:  сложной сложных сложные
рубеж:  рубежах
доступно:  доступно
удобство:  удобства
полярный:  полярная полярные полярных
причём:  причём
страничка:  страничку
комбинаторика:  комбинаторики
фурье:  фурье
поэтому:  поэтому
поле:  поля поле
задавать:  задаваемые
разделить:  разделить
спешить:  спешить
свойство:  свойства
ветвь:  ветви
момент:  момент
иже:  иже
плоский:  плоской
теоретический:  теоретические теоретической
множество:  множества
переход:  переходе переход
найти:  найти
сайт:  сайту сайта сайт
вариация:  вариации
комплексный:  комплексными комплексные комплексной комплексный
поверхностный:  поверхностные поверхностных
основа:  основы
штабель:  штабелем
ссылка:  ссылок
интервал:  интервалы
главный:  главную главной
раскрыть:  раскрыл
основной:  основной основные
кош:  коши
координата:  координат координаты координатах
фигура:  фигуры
изучать:  изучаем изучать
выше:  выше
определённый:  определённые определённых определённого определённый
пуассон:  пуассона
создать:  создан
сводиться:  сводящиеся
чайник:  чайников
собственно:  собственно
поверхностно:  поверхностно
отличный:  отличная
замена:  замены
гипергеометрический:  гипергеометрическое
численный:  численным
целесообразно:  целесообразно
некоторый:  некоторым некоторых некоторые
малый:  малые наименьшего наименьших наименьшее
человек:  людей
ковариация:  ковариация
методичка:  методички
кликать:  кликаем
дополнительный:  дополнительных
тяжесть:  тяжести
навык:  навыки
уверить:  уверены
стандартный:  стандартное
например:  например
однородный:  однородные
скорый:  скорая
помощь:  помощь помощью
вычислить:  вычислить
определение:  определение определения определению
нормальный:  нормальное
очень:  очень
приближённо:  приближённо
курс:  курса курс
направленность:  направленность
матрица:  матрицу матрицы матрицами
условно:  условно
несобственный:  несобственного несобственные несобственных несобственный
рад:  рад
неоднородный:  неоднородные
пирамида:  пирамидой
библиотека:  библиотеку библиотека
гуманитарий:  гуманитариев
элементарный:  элементарного элементарных
фанат:  фанатов
наверх:  наверх
ориентироваться:  ориентируйтесь
бернулли:  бернулли
открывать:  открывающая
простой:  простых
прозрачный:  прозрачных
ряд:  ряды ряда рядов
матричный:  матричных матричная
вручать:  вручаю
цикл:  цикл
обобщить:  обобщил
вопрос:  вопросы вопрос
кратное:  кратные
мануал:  мануалом
блог:  блог
высокий:  высших высшей высшая высшую
подраздел:  подраздела подразделов
форма:  форме формы
типовой:  типовых типовая
руководство:  руководство
список:  списку список
последовательность:  последовательности последовательностей
пространство:  пространстве пространства
уметь:  уметь
пример:  примеры
градиентный:  градиентное
лопиталя:  лопиталя
убывание:  убывание
называться:  называется
нужный:  нужного нужных
удобный:  удобный
вводный:  вводную вводные
квадратичный:  квадратичные квадратичной
обычно:  обычно
такой:  такое
маленький:  маленьких
однократный:  однократные
дифференцирование:  дифференцирование дифференцирования
заштатный:  заштатных
проверить:  проверить
окончательно:  окончательно
спускаться:  спускаемся
дисперсия:  дисперсия
линия:  линиями линии линия
аналитический:  аналитическая аналитической
понижение:  понижение
неравномерный:  неравномерная
геометрический:  геометрическое
ласточка:  ласточки
эффективный:  эффективные
центр:  центр
построение:  построению построение построения
условный:  условные условная
эллипс:  эллипс
ибо:  ибо
ненавязчивый:  ненавязчиво
сложение:  сложения
завоевать:  завоёванных
длина:  длина
удивительный:  удивительный
пск:  пск
материал:  материал материалы материалами материала материалов материалам
один:  одна
мочь:  могут
понятие:  понятие
отрезок:  отрезка
производная:  производных
знакопостоянство:  знакопостоянства
равномерный:  равномерная равномерное
хотеть:  хотите хочу
огромный:  огромное
градиент:  градиент
количество:  количество
хватать:  хватает
мой:  моей
рубикон:  рубикон
интересовать:  интересующему
глава:  глава главы
отзыв:  отзыв
использовать:  используйте
даламбер:  даламбера
знакомиться:  знакомимся
примечательный:  примечателен
теорема:  теоремы
число:  числе числами числа
возвести:  возведён
следовать:  следует
бесконечно:  бесконечно
определитель:  определителя определители определитель
удивляться:  удивляемся
делиться:  делится делятся
действие:  действия
желать:  желающих желаю
квадрат:  квадратов
ранг:  ранг
знание:  знания
требовать:  требующая
книга:  книге
сразу:  сразу
стать:  ставшие статей
смешанный:  смешанное
допускать:  допускающие
лифт:  лифте
область:  область области
нуль:  нули
касаться:  касается
просто:  просто
нормаль:  нормаль нормали
бонус:  бонус
обычный:  обычная
предназначить:  предназначена
лейбниц:  лейбница
поисковик:  поисковика
разгром:  разгром
повестись:  повелось
неравенство:  неравенства
удовлетворять:  удовлетворяет
поток:  поток
пропустить:  пропустите
отдельный:  отдельная
занятие:  занятия
алгебраический:  алгебраических
касательная:  касательная
разобраться:  разобраться
посмотреть:  посмотрите
правило:  правила
захватывать:  захватывающая
диффура:  диффуры
степенной:  степенного степенные
любимый:  любимая любимых
читатель:  читателей
гостевой:  гостевой
кроме:  кроме
экстремум:  экстремумы
перечисленный:  перечисленных
обращаться:  обращайтесь
распределение:  распределения распределение распределений
операция:  операций
второй:  вторая второго
альфа:  альфа
сравнение:  сравнения
тельняшка:  тельняшках
перегиб:  перегибы
звать:  зовут
математик:  математика
контрольный:  контрольные
распространить:  распространённые распространенные
переменный:  переменных переменной переменными
др:  др
тотальный:  тотальный
настоящий:  настоящий
ознакомиться:  ознакомиться
видеть:  видите
несовместный:  несовместные
наоборот:  наоборот
минимум:  минимум
раздобыть:  раздобыть
ценный:  ценное
анализ:  анализ анализа
ключ:  ключ
начинать:  начинаем
прямоугольник:  прямоугольников
непрерывность:  непрерывность
ротор:  ротор
трапеция:  трапеций
радикальный:  радикальный
решение:  решением решению решение решения
радость:  радость
пользователь:  пользователей
зеркало:  зеркало
различный:  различных
слу:  слу
три:  трёх
тематический:  тематическими
ортогональный:  ортогональное
предмет:  предметов
кривой:  криво
разделяться:  разделяющимися
приблизить:  приближенные
знак:  знак
вид:  виды виду
насыщенный:  насыщенный
омега:  омега
нужно:  нужно
корень:  корней
зайти:  зайдите зашёл
классифицировать:  классифицированы
данные:  данным
лагранж:  лагранжа
упасть:  упал
самостоятельный:  самостоятельная
путём:  путём
зависимый:  зависимые
незаменимый:  незаменимый
зависимость:  зависимость
отклонение:  отклонение
крамер:  крамера
описание:  описанию
отрезка:  отрезке
конкретный:  конкретное
произведение:  произведение
левый:  левому
изображение:  изображений
интегральный:  интегральная интегральный
мобильный:  мобильных
дуга:  дуги
частность:  частности
приведение:  приведение
запись:  запись
песочница:  песочница
дивергенция:  дивергенция
парабола:  парабола
классический:  классическое
форум:  форуме форум
важный:  важных важные
подведение:  подведение
дверь:  дверь
наш:  наш нашу
к:  ко
литература:  литературы
воля:  волею
емелин:  емелин
оформлять:  оформлять
аз:  азы
таблица:  таблица
тип:  типам
площадь:  площадь
повышенный:  повышенной
возрастание:  возрастание
также:  также
интегрирование:  интегрирование интегрирования
замечательный:  замечательные
начать:  начать
найтись:  нашлось
пока:  пока
создание:  создании
перейти:  перейти
держать:  держат
треугольный:  треугольной
тригонометрический:  тригонометрических
постоянный:  постоянных
тактика:  тактика
стокс:  стокса
карта:  карта карту
схема:  схема
гипербола:  гипербола
мегапопулярный:  мегапопулярный
скалярный:  скалярного скалярное
ручной:  ручного
лично:  лично
они:  ними
оригинал:  оригиналов
неявный:  неявной
знакоопределённость:  знакоопределенность
десерт:  десерт
отрабатывать:  отрабатываем
логика:  логики
род:  рода
гаусс:  гаусса
вышка:  вышке
порядок:  порядка порядков
аналогичный:  аналогичная
значительный:  значительное
гордость:  гордости
оказаться:  оказалось
подробный:  подробному
деление:  деления
являться:  является
позволять:  позволяют
преобразование:  преобразование преобразования
частное:  частного
иной:  иной
кладовка:  кладовка
доходчивый:  доходчивой
дело:  дела
вручную:  вручную
меню:  меню
её:  её
св:  св
приветствовать:  приветствую
сумма:  суммы
технарь:  технарей
архив:  архивами
выпуклость:  выпуклость
направление:  направлению
элемент:  элементы
достаточно:  достаточно
закреплять:  закрепляем
показательный:  показательное
статистический:  статистическое
либо:  либо
трёхмерный:  трёхмерные
практика:  практика
рекомендовать:  рекомендую рекомендуемые
пользоваться:  пользуйтесь
примерно:  примерно
независимость:  независимость
удаться:  удалось
контур:  контуру
менее:  менее
сложность:  сложности
часто:  часто
никуда:  никуда
порция:  порция
весь:  всей
включить:  включены
немного:  немного
вместить:  вместить
я:  мной
биномиальный:  биномиальное
организационный:  организационная
идея:  идеи
плотность:  плотности
потренироваться:  потренироваться
отношение:  отношении
увлекательный:  увлекательных
ярко:  ярко
традиционный:  традиционными
