чертёж:  чертежом чертежу чертежа чертежи чертёж чертеже чертежей
обязательный:  обязательны
ось:  осью ось оси
переписать:  перепишите перепишем
техника:  технику техники
последний:  последнюю последний последняя
исконно:  исконно
производный:  производные производная производной производную
предел:  предел пределы пределов
ввиду:  ввиду
ограничивать:  ограничивают ограничивающими
выбор:  выбор
числовой:  числовые
точнее:  точнее
производныенеявно:  производныенеявно
значение:  значение значения
скорее:  скорее
детально:  детально
общий:  общему общим общая общем
игрек:  игрек
формула:  формулы формуле формулам формула формулу
смотреть:  см смотрим смотрите
определять:  определять
потеря:  потерей
параллельный:  параллельные параллельную параллельны
прийтись:  придётся
канонический:  каноническому
два:  две двух
отрезок:  отрезках отрезка
дифференциал:  дифференциалах дифференциалов дифференциала
больший:  наибольшее
известно:  известно
многие:  многие
выразить:  выразим
бояться:  бояться
сверять:  сверять
вредный:  вредно
проводиться:  проводится
нижний:  нижнее нижнюю
число:  число числами числа
вогнутостья:  вогнутостьи
многий:  многих
двойной:  двойных двойном двойному двойные двойной двойными
выяснить:  выяснить
особенность:  особенность
убедиться:  убедиться
профессия:  профессию
лазерный:  лазерную
срок:  сроки
радиус:  радиусом радиуса
умножение:  умножения
прощение:  прощения
выполнимый:  выполним
система:  система системе систему системы
мелок:  мелком
группировка:  группировок группировка
поверхность:  поверхностями поверхность поверхностей поверхностях поверхностью поверхности
условнаясходимость:  условнаясходимость
окружность:  окружность окружности
александр:  александр
кухня:  кухня
который:  которые который которая которое которым которых которой
традиционный:  традиционный
линейный:  линейные линейная линейных линейной
ограничить:  ограничено ограничены ограничена
объём:  объём объёму объема объёма объем
пожарный:  пожарный
обычный:  обычных
запись:  записи
согласие:  согласия
вычисление:  вычислением вычислениям вычислении вычисления вычисление вычислений
цилиндрический:  цилиндрическим цилиндрической цилиндрических цилиндрическую цилиндрического цилиндрические
эллиптический:  эллиптический эллиптическим эллиптического
дуоперационный:  дуоперационным
итоговый:  итоговая
иллюзия:  иллюзия
базис:  базисах базису базис
зависимостьвектор:  зависимостьвекторов
снова:  снова
оно:  оно
соответствовать:  соответствующее соответствует
сначала:  сначала
рассматриваться:  рассматривается
метод:  методы методом метод
тема:  теме
страница:  страницу
описание:  описанием
математический:  математическая математические математической
данные:  данных
призывать:  призываю
высекать:  высекает высекают
интеграл:  интеграл интегралу интегралов интегралами интегралах интегралы интеграла интегралом интеграле интегралам
урок:  урока урокам урок уроке
похожий:  похожее
разложение:  разложением разложение
переносица:  переносицу
икс:  икс
уравнение:  уравнению уравнения уравнение уравнением уравнений
переход:  переход переходе перехода
косвенный:  косвенным
получиться:  получилось получится получился получатся
симметрично:  симметрично
интересный:  интересны
симметрия:  симметрии симметрию
совпадать:  совпадают
получить:  полученную получены полученного получено полученный получи
существо:  существу
попасться:  попасться
деканат:  деканате
желательно:  желательно
очередь:  очередь очереди
первый:  первое первую первого первый
соединять:  соединяем
целесообразно:  целесообразно
малый:  малые малому наименьших меньшим
базовый:  базовую
связь:  связь связи
ответить:  ответим ответьте
точка:  точку точки точках точка точке
сомнение:  сомнения
простой:  простая проще простых простейшую простейшем простейший
нормальный:  нормальное
делаться:  делается
интегральнаятеорема:  интегральнаятеоремы
корнимногочлен:  корнимногочлена
логарифмический:  логарифмическая
условие:  условие условиях условия условию
внешний:  внешним
основной:  основные
бернулли:  бернулли
единица:  единицу единицы
полярный:  полярные полярных полярными полярной
положительный:  положительное
рассмотреть:  рассмотрим рассмотреть рассмотренной
ряд:  ряды ряда ряд рядов
уровень:  уровня уровнем
должный:  должны
доверительный:  доверительные
смысл:  смысле смысл смыслом
статься:  статься
эра:  эр
форма:  форме формы
редкость:  редкость
добавиться:  добавилась
среднееквадратический:  среднееквадратическое
решение:  решениями решение решением решения решений
четыре:  четырьмя
комбинационный:  комбинационная
декартов:  декартовой декартовых
смешанноепроизведение:  смешанноепроизведение
функция:  функции функция функций функцию
аппликата:  аппликат аппликатой
дисперсия:  дисперсия дисперсии дисперсию
множество:  множеством множество множества
вынужденный:  вынужденным
неиллюзорный:  неиллюзорно
школьный:  школьный
высота:  высота высоту высотой высоте
мы:  нам
треугольник:  треугольника треугольником треугольник
образ:  образом
выбирать:  выбираем
непрерывнаяслучайный:  непрерывнаяслучайная
сканирование:  сканирование
трудный:  трудными труднее
ибо:  ибо
прямо:  прямо
длина:  длина
материал:  материал материалов материалами материалы
мочь:  могут
знакопостоянство:  знакопостоянства
неплохо:  неплохо
фигура:  фигуру фигуры
градиент:  градиент
догадаться:  догадались
вертикальный:  вертикальные вертикальный вертикальная
линия:  линия линией линии линию линиями линий
бесконечный:  бесконечном
комбинаторика:  комбинаторике
случайнаявеличина:  случайнаявеличина
бесконечно:  бесконечно
незавидный:  незавиден
давать:  даёт
брус:  бруса
задача:  задачу задаче задачи задач задачах задача
отметить:  отметить
возвращаться:  возвращаемся
статья:  статьи статье статью
способствовать:  способствуют
случай:  случаи случаев случае случаях
весомый:  весомый
обратный:  обратную обратная
дополнительный:  дополнительные дополнительная дополнительную дополнительный
большой:  велико большой
третий:  третий
готовый:  готовых готовыми
три:  тремя трёх
просто:  просто
ещё:  ещё
вернуться:  вернёмся
тело:  тело тел тела телом
включить:  включил
произвольный:  произвольный произвольных произвольное
исследовать:  исследованное исследовать исследуемое
порядок:  порядком порядок порядка порядков
приложение:  приложения
веник:  веник
обращать:  обращаю
нахождение:  нахождения
частый:  чаще
любимый:  любимая
оценивать:  оценивая
бумага:  бумагу
данный:  данного данную данном данное
непрерывный:  непрерывных непрерывная непрерывна
обращаться:  обращайтесь
посвятить:  посвящённой
производныефункция:  производныефункции
средний:  средняя
пересечение:  пересечения
отработать:  отработанной
область:  области область
математик:  математика
переменный:  переменных переменной переменную переменная
пример:  пример примера примере примеры
несовместный:  несовместные
буква:  буквы
половина:  половины
независимыеслучайный:  независимыеслучайные
выполнение:  выполнения выполнению выполнение
вверх:  вверх
обнаружиться:  обнаружилась
модель:  модель модели
минус:  минус
непрерывность:  непрерывность
сфера:  сферы сфера сферой
содержать:  содержит содержащее содержат
верхний:  верхняя верхнюю
сечение:  сечение
функциис:  функциис
полный:  полной полных полное
выходить:  выходят выходит выходим
зеркало:  зеркало
второй:  втором второго второму второй
читатель:  читатели
значит:  значит
пирсон:  пирсона
некоторый:  некоторую некоторых некоторые
вопрос:  вопрос вопросы
межгрупповой:  межгрупповая
ортогональный:  ортогональное ортогональную
сферический:  сферическими
рисунок:  рисунком рисунок
нсв:  нсв
отмечать:  отмечаем
плоский:  плоскую плоской
здорово:  здорово
положение:  положение
упасть:  упал
один:  одно одной
трёхмерный:  трёхмерной трёхмерным трёхмерные трёхмерного трёхмерный
отрезка:  отрезке
допускать:  допускает
величина:  величина величин величины
важный:  важный важные
внимательно:  внимательно
основный:  основная основных
затруднить:  затруднено
парабола:  параболе параболы парабола
рассматривать:  рассматриваемой рассматриваем рассматриваемых
отличие:  отличием
сей:  сей
самый:  самая самый самые
детерминация:  детерминации
обязательно:  обязательно
следующий:  следующие следующее следующую следующим следующий
начать:  начать
гениальный:  гениальное
проходить:  проходящую проходящий проходит
выполнить:  выполнить
подробный:  подробное
дифференциальныеуравнение:  дифференциальныеуравнения
прямой:  прямая прямой прямые прямую
сожаление:  сожалению
постоянный:  постоянных
стокс:  стокса
схема:  схема
неформальный:  неформальный
чёрный:  чёрная чёрный
дробовик:  дробовик
часть:  частью частям часть части
математика:  математике математики
векторный:  векторное векторного
сам:  самом саму сами само самой
вероятностия:  вероятностии
скалярный:  скалярное
понятный:  понятен
затруднительно:  затруднительно
значимость:  значимости
удосужиться:  удосужился
страшный:  страшного
мысленно:  мысленно
вершина:  вершины вершину вершина
анализ:  анализа анализ
её:  её
частный:  частное частные
парный:  парной
координата:  координатами координаты координатам координат координатах
сбоку:  сбоку
примерный:  примерный
найти:  найдём найденные найденное найти
сборник:  сборники
параметрический:  параметрическом параметрической
частичка:  частички
показаться:  показалось
пространственный:  пространственных пространственный пространственного пространственное
делать:  делаем делайте делать
часто:  часто
человек:  человек людям
трёхгранный:  трёхгранном
получаться:  получается
какой:  какие
замыкать:  замыкает
вырезать:  вырезаю
фи:  фи
точный:  точного
форум:  форум форуме
книга:  книги книга
включая:  включая
обернуть:  обернули
провести:  провести проведу
случаем:  случаем
вынести:  вынести
задание:  задание заданий
вектор:  векторы векторов
забыть:  забыл
передышка:  передышку
вращение:  вращения
именно:  именно
копирование:  копирование
разрыв:  разрыва
неудобно:  неудобно
выражение:  выражения
значок:  значок
грубо:  грубо
отблагодарить:  отблагодарить
байес:  байеса
решать:  решать
цилиндр:  цилиндра цилиндром цилиндр цилиндрами
привязать:  привязали
неравенство:  неравенствами неравенств неравенство неравенства
результат:  результат результата результате
теория:  теория теорией теории
словесный:  словесным
отсутствовать:  отсутствует
схематический:  схематический
проверить:  проверьте проверим проверить
двумерный:  двумерная двумерному
задать:  заданной задайте задана заданного
циркуляция:  циркуляция
тройной:  тройной тройного тройных тройные
лежать:  лежат лежал лежит лежащие
тяжёлый:  тяжёлом
плоскость:  плоскости плоскостью плоскость
странно:  странно
поздний:  позже
понадобиться:  понадобится
определителяй:  определителяи
выносить:  выносим
закон:  законы
утыкаться:  утыкается
качество:  качестве качество качества
корень:  корня корню корень
читать:  читаете
волшебный:  волшебный
последовательно:  последовательно
действие:  действий действия
вероятность:  вероятностей вероятность вероятности вероятностью
нога:  ногам
любой:  любое любых
уравненийв:  уравненийв
множитель:  множитель
грин:  грина
суть:  сути
эйлер:  эйлера
высказать:  высказали
осваиваться:  осваивается
кольцо:  кольцо
геометрический:  геометрический геометрическая геометрическое
закачать:  закачать
вычесть:  вычтем
годиться:  годится
кубик:  кубиков
письменно:  письменно
дискретный:  дискретный
знакочередоваться:  знакочередующиеся
труп:  труп
очевидность:  очевидности
смочь:  смогли
подумать:  подумайте подумать
сложный:  сложной сложные сложных
советовать:  советовал
мотив:  мотив
фурье:  фурье
поле:  поля
гипотеза:  гипотез гипотеза гипотезы
свойство:  свойства
исследование:  исследование
начинаться:  начинается
проблема:  проблем проблемы
вариация:  вариации
основа:  основы
слишком:  слишком
переходить:  переходим
интервал:  интервалы
кош:  коши
параграф:  параграфа параграфу
одиночный:  одиночными
выше:  выше
чайник:  чайников чайникам
вычисленияс:  вычисленияс
матричный:  матричные матричных матричный
заметить:  заметили
однородный:  однородные однородным
прочесть:  прочёл
вычислить:  вычислить
очень:  очень
матрица:  матрицу матрицы матрицами
этап:  этапе
испытанияй:  испытанияи
интегралыть:  интегралыв
перегруппировка:  перегруппировка
избыточность:  избыточность
монитор:  монитора
помощь:  помощью
осторожный:  осторожнее
начало:  начало начале
понять:  поняли понять
вариационный:  вариационный
тонкий:  тонкое
исключение:  исключением
держать:  держал
крестик:  крестик
блог:  блог
высокий:  высших высшей высшая
параболический:  параболический параболического параболическим параболическими
симметричный:  симметричными
возникнуть:  возникнет
доступный:  доступной
пойти:  пойти
пространство:  пространстве пространства
удобный:  удобный удобнее
путь:  путь путями
курс:  курс
быть:  будьте
ордината:  ординат
сообщить:  сообщите
сделать:  сделать
аналитический:  аналитическая аналитическое аналитической
понижение:  понижение понижением
определить:  определить
центр:  центр центром
граница:  границе
считаться:  считается
изобразить:  изобразить изобразим
пересекаться:  пересекаются
опорный:  опорную
луч:  лучи
закончить:  закончить
преимущественно:  преимущественно
построение:  построение построении
вспоминать:  вспоминаем
осуществляться:  осуществляется
линейнойкорреляционный:  линейнойкорреляционной
игрековый:  игрековые игрековый
оставаться:  остаётся
особо:  особо
распределениякритерия:  распределениякритерий
дальнейший:  дальнейшее
отражать:  отражающего
несобственный:  несобственные
выполнять:  выполнять выполняем
искомый:  искомая
представлять:  представлять представляет представляете
откуда:  откуда
практика:  практикой практике
полностью:  полностью
касательная:  касательная
ответ:  ответ ответу ответы
задачис:  задачис
опасаться:  опасаться
забывать:  забывать забываем забывая
константа:  константой константы константу
разобраться:  разобраться разберёмся разобрались
правило:  правила правило
функциия:  функциии
щёлкать:  щёлкаем
возможно:  возможно
степенной:  степенного степенные
сантиметр:  сантиметров
функцийдвуха:  функцийдвух
выборка:  выборке
проецироваться:  проецируются
входить:  входят входим
функцийнесколький:  функцийнескольких
подготовка:  подготовки
множественнойлинейный:  множественнойлинейной
распределение:  распределение распределения
задавать:  задаёт задают задаваемые
закомментировать:  закомментировать
параболоид:  параболоид параболоидом параболоида
ракурс:  ракурса
решить:  решим решить
задачипо:  задачипо
рассекать:  рассекает
востребовать:  востребованную
чаша:  чаша
приблизить:  приближенные
краткий:  кратчайшие краткое
вариант:  вариант
фонарик:  фонарик
образец:  образец
примечание:  примечание
пункт:  пункта
зависимый:  зависимые
разминаться:  разминаться
отклонение:  отклонение
таблица:  таблицы
произведение:  произведение
знать:  знаете
вполне:  вполне
случайный:  случайных случайны случайные
время:  времени
воронка:  воронку
озаглавить:  озаглавить
дуга:  дуги
численно:  численно
частность:  частности
отрезкать:  отрезкав
дивергенция:  дивергенция
сайт:  сайт сайты сайта
наш:  наш нашей
графика:  графики графика
оформление:  оформления
думать:  думал
расположить:  расположены расположенный расположено
предлагать:  предлагаемые предлагаю
возрастание:  возрастание
эмпирический:  эмпирические
подставить:  подставим подставить
найтись:  нашлось
этот:  этих эта
разбираться:  разбираться разбираемся
иррациональный:  иррациональных
определение:  определению определения
наглядный:  наглядного
квадратичнуюформ:  квадратичнуюформу
ваш:  вашу
обходить:  обходить
карта:  карта
конус:  конус конуса
гипербола:  гипербола
несложный:  несложная
равно:  равно
начертить:  начертить
неподалёку:  неподалёку
они:  ними
октант:  октант
молитва:  молитвы
логика:  логики
спирмена:  спирмена
вид:  виду виды вид виде
оказаться:  оказалось оказаться
подвести:  подвёл
вовсе:  вовсе
увы:  увы
лишь:  лишь
уточнить:  уточним
картинка:  картинок
обход:  обхода обходе
день:  дня
св:  св
популярный:  популярными
параллельно:  параллельно
сумма:  суммы сумму сумма
предыдущий:  предыдущих предыдущего
рукопись:  рукописей
достаточно:  достаточно
показательный:  показательное
оговорка:  оговорки
надёжный:  надёжной
преобразование:  преобразования преобразование преобразований
диффура:  диффурами
почленно:  почленно
остаться:  оставшиеся остались
перейти:  перейдём перейти
подразумевать:  подразумевает
аргумент:  аргумент
использовать:  используем используя используйте
статистика:  статистика
пунктир:  пунктиром
биномиальный:  биномиальное
записаться:  запишется
линиюв:  линиюв
самостоятельный:  самостоятельного
отношение:  отношении
второе:  второе
одноимённый:  одноимённым одноимённую
дуприближённо:  дуприближённо
внутренность:  внутренность
проанализировать:  проанализированы
асимптота:  асимптоты
событие:  события
пифагор:  пифагора
повторный:  повторные повторным
состоять:  состоит
преобразовать:  преобразуем
фнп:  фнп
пропорция:  пропорции
экран:  экрана
склоняться:  склоняетесь
простейшее:  простейшие
иной:  иными
конец:  конце конца
заштриховать:  заштрихованную заштрихованный
проецирование:  проецирование
несобство:  несобств
нелинейный:  нелинейная
брать:  берём
преобразованиеквадратичный:  преобразованиеквадратичной
шар:  шар шара
напрашиваться:  напрашивается напрашивающихся
функциональный:  функциональные функциональном
прочертить:  прочертить
комментарий:  комментарии комментарий
сканировать:  сканируем
угол:  углы углом
классический:  классический
войти:  вошёл
абсолютный:  абсолютная
расправиться:  расправиться
встречаться:  встречаются встречается
включать:  включать
сложенияй:  сложенияи
сказать:  сказано сказал
начеку:  начеку
регрессия:  регрессии регрессия
свой:  свой
хватить:  хватило
оценка:  оценке оценка оценки
польза:  пользу
штаны:  штаны
исчисление:  исчисления
физический:  физические
иксовыя:  иксовые
применительно:  применительно
приуныть:  приуныли
подходить:  подходит
обойти:  обошли
зачастую:  зачастую
гораздо:  гораздо
локальный:  локальная
отрицательный:  отрицательным
ожидание:  ожидание
дорогой:  дороже
лаплас:  лапласа
такой:  таким такие такое такому таких
перегиб:  перегиба
сходимость:  сходимости сходимость
представить:  представьте представили представить
справедливость:  справедливости
покойник:  покойник
сослаться:  сослаться
ду:  ду
далее:  далее
свобода:  свободу
коэффициент:  коэффициент
неопределённый:  неопределенный неопределенном
круг:  круг
дробь:  дробей
собственный:  собственные собственных
суммарный:  суммарное
признак:  признак признаки признаком
забраковать:  забраковать
поэтому:  поэтому
разделить:  разделить
вместо:  вместо
ознакомиться:  ознакомились ознакомиться
решаться:  решаются
никакой:  никаких
знакомый:  знакомый знакомо
коль:  коль
асимметрия:  асимметрия
выигрыш:  выигрыш
рука:  руках руки
главный:  главную
сверху:  сверху
элементарный:  элементарен элементарного
сводиться:  сводящиеся
замена:  замены
грозить:  грозит
маленький:  меньше
составить:  составим
например:  например
решенияопределённый:  решенияопределенных
выглядеть:  выглядит
задаваться:  задаётся
хотя:  хотя
аналогичный:  аналогичное
сопрячь:  сопряжено
выражать:  выражаем
коэффициентковариация:  коэффициентковариации
проекция:  проекцией проекции проекцию проекция
приличный:  приличных
коридор:  коридоре
помешать:  помешает
кирпичик:  кирпичика
абсцисса:  абсцисс
абсолютно:  абсолютно
лопиталя:  лопиталя
называться:  называется
обычно:  обычно
ставить:  ставим
недопонимание:  недопонимание
столбик:  столбиком
поляформула:  поляформула
наверное:  наверное
просить:  прошу
фехнера:  фехнера
эффективный:  эффективные
сегмент:  сегментами
условный:  условные
эллипс:  эллипс
сократить:  сократить
бакс:  баксов
теорема:  теорему теоремы
хотеть:  хотите
развеять:  развеем
даламбер:  даламбера
косой:  косым
разобрать:  разобранном разобранной
факт:  факт факта
повторнойя:  повторнойи
естественно:  естественно
полусфера:  полусферу
рассказать:  рассказал
комплексный:  комплексные комплексного комплексный комплексными
дело:  делах дела деле дело
сахар:  сахар
ранг:  ранг
кривая:  кривой
тяжестиплоска:  тяжестиплоской
круговой:  кругового круговым
относительно:  относительно
лениться:  ленитесь
проверка:  проверка проверкой
назвать:  назвать
просвечивать:  просвечиваем
построить:  построить
внимание:  внимание
тактика:  тактики
лейбниц:  лейбница
ради:  ради
поток:  поток
проработать:  проработайте
выручать:  выручают
медиана:  медиана
бывать:  бывает
записать:  записать
направлениюй:  направлениюи
гостевой:  гостевая
письменный:  письменный письменные
скоро:  скоро
русский:  русский
чреватый:  чреват
кроме:  кроме
аккуратно:  аккуратно
равный:  равен
главное:  главное
внутригрупповаяй:  внутригрупповаяи
одетый:  одетый
он:  нём
алгебра:  алгебры
придерживаться:  придерживаемся
строка:  строкой
прямоугольник:  прямоугольников
эксцессэмпирический:  эксцессэмпирического
парочка:  парочку
выбрать:  выбрать выберем
томик:  томик
криволинейный:  криволинейные
различный:  различных
библиотека:  библиотека
объединять:  объединяет
определяться:  определяется
прорисовать:  прорисовать
наименьшеезначение:  наименьшеезначения
сила:  силы
вычислимый:  вычислим
выяснять:  выяснять выясняем
системылинейный:  системылинейных
нужно:  нужно
чистовой:  чистового
зависимость:  зависимость
другой:  другие
замкнутый:  замкнутому
очевидный:  очевидно очевидная очевидны
полупространство:  полупространство
показатель:  показатели
вытекать:  вытекает
сжить:  сжил
трудность:  трудностями трудность
площадьс:  площадьс
ранее:  ранее
большинство:  большинстве
поучительный:  поучительны
вышеуказанный:  вышеуказанного
убыванией:  убываниеи
повышенный:  повышенной
статистический:  статистическая статистические
также:  также
дать:  данная данные данной
интегрирование:  интегрирование интегрирования интегрировании
легко:  легко
рациональный:  рациональные рациональную
пока:  пока
интервальный:  интервальный
таков:  таковы
интегральный:  интегральное
распространить:  распространённым
соответственно:  соответственно
требовать:  требует
выгодный:  выгодный
вообще:  вообще
разъяснить:  разъяснил
лично:  лично
оценкия:  оценкии
неявный:  неявной
выдержать:  выдержал
несобственныхинтеграл:  несобственныхинтегралов
вероятностибиномиальный:  вероятностибиномиального
род:  рода
гаусс:  гаусса
определимый:  определим
заключительный:  заключительное заключительной
ювелирный:  ювелирная
острый:  острые
прорисоваться:  прорисовался
точно:  точно
экстремальный:  экстремальные
весь:  вся весь
нормаль:  нормали
определитель:  определитель
желать:  желающие
выпуклость:  выпуклость
элемент:  элементы
интересно:  интересно
лазер:  лазера
менее:  менее
сложность:  сложности
значенияй:  значенияи
нужный:  нужной
голый:  голое
кстати:  кстати
классическоеопределение:  классическоеопределение
инормаль:  инормаль
отличный:  отлична
изложить:  изложен
далёкий:  дальше
пирамида:  пирамида
автор:  автор автора
цель:  целях
дифференциальный:  дифференциальные
уравненияс:  уравненияс
онлайн:  онлайн
геометрия:  геометрии геометрия
работа:  работа
фрагмент:  фрагмент
новый:  новому
произвольныйтройный:  произвольныйтройной
дизайн:  дизайна
ограниченный:  ограниченную ограниченного
это:  это этим
помнить:  помним
поляй:  поляи
находиться:  находится
опечатка:  опечатку
формальный:  формальные
способ:  способом способ
продолжать:  продолжаем
параметр:  параметр
речь:  речь
формулировка:  формулировка
образовать:  образующие образующей
методомоперационный:  методомоперационного
бесповторный:  бесповторной
правильно:  правильно
ошибка:  ошибку
л:  л
обойтись:  обойтись
измерение:  измерения
указанный:  указанными
внутренний:  внутренним
понимание:  пониманию
снизу:  снизу
слово:  слову слова
взять:  взять
касательный:  касательных
тот:  той
типовыхзадача:  типовыхзадач
ранговойкорреляция:  ранговойкорреляции
оттяпать:  оттяпает
искомое:  искомое
сломать:  сломать
координатный:  координатной координатные координатную
пересекать:  пересекает
линейныйкоэффициент:  линейныйкоэффициент
белый:  белого
несколько:  несколькими
несобственныйинтеграл:  несобственныйинтеграл
накрыть:  накроет
доступно:  доступно
сторона:  сторон
крутой:  крута
логично:  логично
учиться:  учимся
напоминать:  напоминает напоминаю
допустить:  допустить
ипример:  ипримеры
особый:  особое
конический:  коническую конической
выигрышный:  выигрышный
поверхностный:  поверхностные
разделять:  разделять
пуассон:  пуассона
однако:  однако
пора:  поры
сотня:  сотни
математическоеожидание:  математическоеожидание
школа:  школа
неоднородный:  неоднородные
необходимо:  необходимо
наметить:  наметить
расставлять:  расставлять
кратное:  кратные
системудифференциальный:  системудифференциальных
указка:  указку
правильность:  правильности
рассчитывать:  рассчитываем
масштаб:  масштабе
помимо:  помимо
свет:  света
рассуждение:  рассуждение
зетовый:  зетового
каков:  каков
уметь:  уметь
последовательность:  последовательностей
шапка:  шапку шапки
квадратичный:  квадратичные
свестись:  свелось
единственный:  единственная
требоваться:  требовалось
поскольку:  поскольку
чувствовать:  чувствую
гипергеометрическоераспределение:  гипергеометрическоераспределение
оба:  обоих оба
обратить:  обратите
возможность:  возможность
равномерный:  равномерная равномерное
иначе:  иначе
подробно:  подробно
касаться:  касаясь
треугольный:  треугольная
вероятный:  вероятнее
забить:  забить
мой:  моей
пожалуйста:  пожалуйста
ориентироваться:  ориентироваться
следовать:  следует
хороший:  хорошем хорошим
скорость:  скорости
вдоль:  вдоль
себя:  собой
квадрат:  квадратов
сразу:  сразу
функциюкомплексный:  функциюкомплексной
стандартный:  стандартным
мода:  мода
свойстваэлементарный:  свойстваэлементарных
дальний:  дальней
считать:  считать
остальной:  остальное
калькулятор:  калькулятор
научиться:  научиться
фихтенголец:  фихтенгольца
отобразиться:  отобразится
единичный:  единичного
определённый:  определенный определенного
шанс:  шансов
предположение:  предположение
действительно:  действительно
экстремум:  экстремумы
горнера:  горнера
объяснение:  объяснениям
вкус:  вкусом
видный:  виден
предельно:  предельно
куба:  кубе
нахал:  нахал
функцийв:  функцийв
продвинуться:  продвинуться
видеть:  видите
размерность:  размерность
вмещать:  вмещает
чертить:  чертить
вместиться:  вместится
несведущий:  несведущий
лёгкий:  легче
иллюстрация:  иллюстрации
срезать:  срежет
дискретнойслучайный:  дискретнойслучайной
знак:  знак
прутик:  прутикам
сносить:  сносим
перспективный:  перспективнее
соответствие:  соответствии
бодаться:  бодаться
крамер:  крамера
изнутри:  изнутри
принципиальный:  принципиальный
строго:  строго
расписывать:  расписываем
к:  ко
функциидвуха:  функциидвух
запретить:  запрещено
емелин:  емелин
вычисленияопределенный:  вычисленияопределенных
отдельность:  отдельности
задачин:  задачина
замечательный:  замечательные
системый:  системыи
удовлетворяетлить:  удовлетворяетли
субъективный:  субъективной
упрощённый:  упрощённом
приходиться:  приходится
явный:  явном
всякий:  всякий
тригонометрический:  тригонометрических
аналитически:  аналитически
скромно:  скромно
остановиться:  остановимся
заданав:  заданав
всё:  всё
что:  чём
циркуль:  циркуль
тривиальный:  тривиален
заморочить:  заморочит
деление:  деления
являться:  является
контуруформула:  контуруформула
график:  график
пациент:  пациента
принимать:  принимая
текст:  текст
либо:  либо
рекомендовать:  рекомендую
независимый:  независимые
зет:  зет
привести:  привести
справочный:  справочной
ограниченно:  ограниченно
корреляция:  корреляции
коммент:  комментов
заочник:  заочников
подынтегральный:  подынтегральная
говорить:  говоря
повторять:  повторяем
малополезный:  малополезно
