изучение:  изучением изучения
производный:  производные производная производной производную
предел:  предел пределы пределов
округлять:  округляем
половина:  половина половиной
числовой:  числовые числовая
экселе:  экселе
точнее:  точнее
производныенеявно:  производныенеявно
значение:  значение значением значений значения
пиджак:  пиджаков пиджак пиджаке пиджаки
затрата:  затрат
формула:  формулы формулой формуле формула формулу
смотреть:  см
отбрасывать:  отбрасывать
сюда:  сюда
канонический:  каноническому
два:  две двух
бухгалтер:  бухгалтер
дифференциал:  дифференциалах дифференциала
содержаться:  содержатся
больший:  наибольшее большее большую большей
составить:  составлен составить
гистограмма:  гистограмму гистограмме
против:  против
проводиться:  проводится
стрелка:  стрелка
иксовой:  иксовое
число:  число числами чисел числа
вогнутостья:  вогнутостьи
посему:  посему
отыскание:  отыскания
многий:  многих
становиться:  становится
позволять:  позволяет
случай:  случай случаи случая случаев случае случаях
плохой:  хуже
профессия:  профессию
условие:  условии условия
пусть:  пусть
умножение:  умножения
развивать:  развивать
система:  система системе систему системы
группировка:  группировок группировка
условнаясходимость:  условнаясходимость
предшествовать:  предшествующего
представительный:  представительную
офлайн:  оффлайн
подготовить:  подготовленных
александр:  александр
который:  которые котором который которая которое которую которого которых которой
редко:  редко
линейный:  линейные линейная линейных линейной
аномальный:  аномальные
стать:  стало
объём:  объём объема объёма объем
быть:  суть буду
согласие:  согласия
чётный:  чётного чётное
арифметический:  арифметической арифметическое арифметическому
отметка:  отметку отметка
относительный:  относительных относительные
решать:  решаем решать
дуоперационный:  дуоперационным
пуговица:  пуговицы пуговиц
базис:  базисах базису базис
зависимостьвектор:  зависимостьвекторов
распределить:  распределена
предложный:  предложен
сначала:  сначала
метод:  методы методом метод
страница:  страницу
столбец:  столбцу столбце столбца
обычный:  обычные
математический:  математическая математические математической
данные:  данных данным
интеграл:  интеграл интегралов интегралы интеграла интеграле
характеристика:  характеристика характеристиками характеристик
урок:  урока
разложение:  разложением разложение
отбросить:  отбросим
друг:  друга друг другу
двухпуговичный:  двухпуговичные
уравнение:  уравнению уравнения уравнение уравнений
тематичный:  тематичная
шляпка:  шляпки
переход:  переход
планка:  планки
сортировка:  сортировка
симметрия:  симметрии
плавно:  плавно
первый:  первое первых первого
считать:  считают считаем считать
целесообразно:  целесообразно
малый:  малые наименьших
связь:  связь
середина:  середину середины
петров:  петрова
расчётный:  расчётную
нормальный:  нормальное
интегральнаятеорема:  интегральнаятеоремы
корнимногочлен:  корнимногочлена
логарифмический:  логарифмическая
начать:  начнём начать
основной:  основные
переслать:  перешли
модальный:  модальными модальный модального модальных модальное
бернулли:  бернулли
полярный:  полярные полярных полярной
средний:  средней средняя средних средние среднему среднюю среднее
ряд:  ряды ряда ряду ряд ряде рядов
уровень:  уровня
ячейка:  ячейку
разбиение:  разбиения разбиение
доверительный:  доверительные
экселя:  экселя
среднееквадратический:  среднееквадратическое
коротко:  коротко
справочный:  справочно
комбинационный:  комбинационная
показатель:  показатель показателям показателей показатели показателями
смешанноепроизведение:  смешанноепроизведение
обнаружиться:  обнаружатся
функция:  функции функция функций
сподручный:  сподручнее
дисперсия:  дисперсия дисперсии дисперсию
срединный:  срединный
разориться:  разорится
рассчитываться:  рассчитывается рассчитываются
знакомый:  знакомого знакомой
школьный:  школьный
сместить:  смещено смещена
мы:  нам
образ:  образом
частота:  частоты частотам частот частотой частота
непрерывнаяслучайный:  непрерывнаяслучайная
длина:  длина длины
хороший:  хорошая
материал:  материал материалом материалов материалы
усмотреть:  усмотреть
немного:  немного
мочь:  могут
знакопостоянство:  знакопостоянства
быстрый:  быстрый
интервал:  интервале интервала интервалах интервалы интервал интервалу интервалами интервалов
попробовать:  попробуйте
градиент:  градиент
равный:  равных равные равное равна
конец:  конец конце конца
линия:  линия линии линиями
повторяться:  повторяется
полагать:  полагаем
разнообразие:  разнообразия
ясно:  ясно
комбинаторика:  комбинаторике
упорядочить:  упорядоченного упорядоченный упорядоченной
случайнаявеличина:  случайнаявеличина
интервальный:  интервальная интервальном интервального интервальный интервальному
бесконечно:  бесконечно
следующий:  следующими следующие следующее следующего следующим следующий следующей
накопить:  накопленная накопленные накопленным
форма:  формы
задача:  задачу задаче задачи задачах задача
отметить:  отметить отмечу
возвращаться:  возвращаемся
статья:  статьи статья
сформировать:  сформированного сформированному
ориентироваться:  ориентируясь
обратный:  обратную обратная
готовый:  готовых готовый готово готовому
просто:  просто
видеть:  видим видите
получить:  получены полученные полученного получено полученное полученная полученный получи
приём:  приём
ещё:  ещё
выборка:  выборка выборке выборку выборки
сверка:  сверки
свой:  своих
часть:  частей частям части
возмущение:  возмущение
вызвать:  вызовет
приблизить:  приблизили приближенные
текущий:  текущей текущий
отличаться:  отличается
частый:  чаще
калькулятор:  калькулятора калькулятор калькуляторе
вычислить:  вычислила вычисленным вычислить
читатель:  читателей читатели
сортировать:  сортировать сортируем
непрерывный:  непрерывных непрерывная
мысль:  мысли
медиана:  медианы медиане медиана медианой медиану
производныефункция:  производныефункции
ботинок:  ботинки ботинками
попасть:  попали
область:  области область
ссылка:  ссылке ссылка
математик:  математика
переменный:  переменных переменной
пример:  пример примера примере примеры
несовместный:  несовместные
независимыеслучайный:  независимыеслучайные
добавить:  добавить
обеспечение:  обеспечении
модель:  модель модели
непрерывность:  непрерывность
содержать:  содержит содержащий
способ:  способами способом способ
накопиться:  накопиться
рассчитывать:  рассчитывать
тупо:  тупо
квартиль:  квартили квартиль квартилей
функциис:  функциис
тенденция:  тенденцию
право:  правом
полный:  полной полных полное
зеркало:  зеркало
значит:  значит
пирсон:  пирсона
вопрос:  вопрос вопросы
общественность:  общественности
межгрупповой:  межгрупповая
ортогональный:  ортогональное
высокий:  высокой высших высшей высшая
удобный:  удобен удобный удобнее
нсв:  нсв
исходный:  исходным исходные
вроде:  вроде
упасть:  упал
заголовок:  заголовке
отрезка:  отрезке
величина:  величина величин величинах величины
учебный:  учебном учебная
оглавление:  оглавление
прорешать:  прорешать
найтись:  найтись нашлось
она:  неё
количество:  количеству количества количество
анализировать:  анализировать анализируя
детерминация:  детерминации
статистика:  статистикой статистика статистики
деталь:  детали
дифференциальныеуравнение:  дифференциальныеуравнения
название:  названия
прямой:  прямая прямой прямую
выборочный:  выборочную выборочной выборочного выборочная
постоянный:  постоянных
стокс:  стокса
схема:  схема
самостоятельно:  самостоятельно
дробовик:  дробовик
индекс:  индекса
тяжёлый:  тяжелых тяжёлых
математика:  математике математики
векторный:  векторное векторного
вероятностия:  вероятностии
скалярный:  скалярное
совершенно:  совершенно
объединять:  объединяем
наш:  нашем наш
понятный:  понятен
значимость:  значимости
округлить:  округлёнными
некоторый:  некоторая
мысленно:  мысленно
нижний:  нижняя
описка:  описка
вариационный:  вариационного вариационном вариационный
анализ:  анализа анализ
красный:  красная
статистический:  статистической статистическое статистических статистическая статистические
её:  её
частный:  частное частные
парный:  парной
фрейд:  фрейду
несколько:  несколько несколькими
сборник:  сборники
параметрический:  параметрическом параметрической
дециль:  децили децилей децилями
таблица:  таблице таблицу таблицы
делать:  делаем делают
часто:  часто
зарабатывать:  зарабатывает
получаться:  получается
находить:  находим
другой:  другая другими другие другим
решение:  решение решением решения решений
форум:  форум форуме
книга:  книги книга
включая:  включая
разряд:  разряда разряд разряды
заработный:  заработную
устно:  устно
задание:  задание заданий
вектор:  векторы векторов
вращение:  вращения
наличие:  наличии
именно:  именно
копирование:  копирование
вдаваться:  вдаваясь
разрыв:  разрыва
выражение:  выражения
отблагодарить:  отблагодарить
байес:  байеса
рассматривать:  рассматриваем рассматривают
точность:  точности
оценить:  оценить
результат:  результат результатам результате результаты
теория:  теория теории
опробовать:  опробовать
характеризовать:  характеризует характеризуют
определять:  определяем
двумерный:  двумерная
задать:  заданной задайте
инструкция:  инструкция инструкции
тело:  тела
циркуляция:  циркуляция
слева:  слева
отдельный:  отдельные
отклонение:  отклонения отклонение
плоскость:  плоскости плоскость
организовать:  организуют
общий:  общим общая общем общее
поздний:  позже
определителяй:  определителяи
закон:  законы
справа:  справа
самый:  самым самое
качество:  качестве
буква:  буква
типичный:  типичная
вероятность:  вероятностей вероятность вероятности вероятностью
центральный:  центральными центральные центральную центрального центральных
уравненийв:  уравненийв
программный:  программном
правильный:  правильного
диапазон:  диапазон
больница:  больнице
нечётный:  нечётное
привести:  приведена приведу привёл привести
грин:  грина
эйлер:  эйлера
цех:  цеха
надевать:  надеваем
дискретный:  дискретный дискретным дискретная дискретного
знакочередоваться:  знакочередующиеся
практический:  практический
важный:  важнейший
вводиться:  вводятся
заметно:  заметно
делить:  делённая делит делят
смущать:  смущать
практически:  практически
произвольный:  произвольных
сложный:  сложной сложные сложных
плата:  плату
рассмотрение:  рассмотрению
работать:  работает
первичный:  первичным первичные первичных
фурье:  фурье
дать:  дан дано данные данной даны
поле:  поля
зайти:  зашла
гипотеза:  гипотез гипотеза гипотезы
свойство:  свойства
попсовый:  попсовая
исследование:  исследование исследованиях исследований исследования
весь:  всем вся всей
точка:  точки точке
вариация:  вариации
основа:  основы
глаз:  глаза
броситься:  бросился
кош:  коши
выше:  выше
составлять:  составляет составлять
чайник:  чайников чайникам
вычисленияс:  вычисленияс
правый:  правую правее правому
внутренний:  внутренних
матричный:  матричные матричных матричный
заметить:  заметили заметим
однородный:  однородные однородным
очень:  очень
матрица:  матрицу матрицы матрицами
испытанияй:  испытанияи
интегралыть:  интегралыв
вразумительный:  вразумительнее
точный:  точным точное
перегруппировка:  перегруппировка
каждый:  каждое каждому каждый
помощь:  помощью
продажа:  продаж
страшненький:  страшненькой
исключение:  исключением
блог:  блог
вывод:  выводу вывод
каноничный:  каноничная
пространство:  пространстве
совокупность:  совокупности совокупность
путь:  путь
курс:  курс курсе
координата:  координаты координат координатах
помогать:  помогают
сообщить:  сообщите
главный:  главном главную
аналитический:  аналитическая аналитической
понижение:  понижение понижением
определить:  определить
центр:  центр центра
нахождение:  нахождение
локальный:  локальные локальная
скобка:  скобку
сторона:  сторону
построение:  построение
вспоминать:  вспоминаем
линейнойкорреляционный:  линейнойкорреляционной
действие:  действия
время:  время времени
особо:  особо
крайний:  крайних крайний
почему:  почему
распределениякритерия:  распределениякритерий
выгода:  выгоды
несобственный:  несобственные
затруднить:  затруднена
станок:  станка
откуда:  откуда
вариант:  варианты вариант варианту варианта
занять:  займут
занятие:  занятия занятие
касательная:  касательная
ответ:  ответ ответы
задачис:  задачис
правило:  правила правило
медианный:  медианный медианное медианного медианным
функциия:  функциии
степенной:  степенного степенные
функцийдвуха:  функцийдвух
использование:  использовании использования использование
функцийнесколький:  функцийнескольких
рассчитать:  рассчитать
понять:  понять
близкий:  близки
множественнойлинейный:  множественнойлинейной
потребоваться:  потребуются
тема:  темы
распределение:  распределение распределения
город:  города
максимальный:  максимальной
условный:  условном условные
икс:  икса
задачипо:  задачипо
пополам:  пополам
нравиться:  нравятся
востребовать:  востребованную
искажённый:  искажённая
цена:  цены цена цен
видно:  видно
образец:  образец
зависимый:  зависимые
произведение:  произведение произведений
красивый:  красивый
вполне:  вполне
случайный:  случайных случайные
дуга:  дуги
частность:  частности
отрезкать:  отрезкав
дивергенция:  дивергенция
квалификационный:  квалификационные квалификационный
укрупнять:  укрупняем
сайт:  сайт сайты сайта
графика:  графики графика
ситуация:  ситуации ситуация
причина:  причине
возрастание:  возрастание возрастанию
эмпирический:  эмпирические
этот:  этих эта
характерный:  характерно
статический:  статические
исследуться:  исследуется
абсцисса:  абсцисса
иррациональный:  иррациональных
отличный:  отличный отличны
определение:  определению определение определения
квадратичнуюформ:  квадратичнуюформу
карта:  карта
вычисление:  вычисления вычисление
гипербола:  гипербола
цветочек:  цветочками
равно:  равно
они:  ними
закономерный:  закономерный
логика:  логики
спирмена:  спирмена
вид:  виду виды виде
оказаться:  оказалось оказаться оказались
возникать:  возникает
ход:  ход
вычислительный:  вычислительный
рабочий:  рабочими рабочих рабочие
св:  св
второй:  второго второй вторая
персонал:  персонал
достаточно:  достаточно
показательный:  показательное
преобразование:  преобразования преобразований
петровский:  петровского
особый:  особой особые
диффура:  диффурами
соответствующий:  соответствующие
перейти:  перейдём
весьма:  весьма
использовать:  используем использовали используйте
биномиальный:  биномиальное
записаться:  запишется
линиюв:  линиюв
упороть:  упоротых
самостоятельный:  самостоятельного
отношение:  отношении
таковой:  таковых
любительски:  любительски
смысл:  смысл
решить:  решить
дуприближённо:  дуприближённо
академичный:  академичен
асимптота:  асимптоты
событие:  события
невозможный:  невозможна
повторный:  повторные
различный:  различны различных
состоять:  состоит
фнп:  фнп
выделять:  выделяем
забитый:  забиты
простейшее:  простейшие
эксель:  эксель
двойной:  двойные двойной
компактный:  компактнее компактном
несобство:  несобств
о:  обо
известный:  известны
нелинейный:  нелинейная
преобразованиеквадратичный:  преобразованиеквадратичной
граница:  граница
функциональный:  функциональные
участок:  участок
среднестатистический:  среднестатистический
геометрический:  геометрическая геометрическое
абсолютный:  абсолютная
встречаться:  встречаются
получать:  получая
сложенияй:  сложенияи
сказать:  сказано скажешь
регрессия:  регрессии регрессия
расстояние:  расстояние
исчисление:  исчисления
подобный:  подобной
подходить:  подходит
гораздо:  гораздо
популярный:  популярная
ожидание:  ожидание
лаплас:  лапласа
такой:  таким такое такая таких такими
перегиб:  перегиба
сходимость:  сходимости сходимость
представить:  представьте
перцентиль:  перцентили перцентилей
ду:  ду
далее:  далее
формальный:  формальный
коэффициент:  коэффициент
неопределённый:  неопределенный неопределенном
приходить:  приходим
дробь:  дробей
магазин:  магазинах магазин
собственный:  собственные
близлежащий:  близлежащие
признак:  признак признаки
рядом:  рядом
поэтому:  поэтому
разделить:  разделить разделило
мышка:  мышкой
генеральный:  генеральной генеральную генеральная
асимметрия:  асимметрия асимметрии
скажем:  скажем
сверху:  сверху
сводиться:  сводящиеся
замена:  замены
записать:  запишем записать
встреча:  встрече
например:  например
удваивать:  удваиваем
решенияопределённый:  решенияопределенных
одинаковый:  одинаковой одинаковые одинаковых
массив:  массиву
коэффициентковариация:  коэффициентковариации
штука:  штук
завод:  завода
практика:  практику
экселевскома:  экселевском
лопиталя:  лопиталя
называться:  называется
крайне:  крайне
мода:  моду модой моды мода мод
обычно:  обычно
нужный:  нужна нужной
ставить:  ставим
поляформула:  поляформула
фехнера:  фехнера
эффективный:  эффективные эффективным
обозначать:  обозначаем
прикладной:  прикладных
эллипс:  эллипс
занудничать:  занудничать
чертёж:  чертёж
хватать:  хватает
приближение:  приближение
даламбер:  даламбера
теорема:  теоремы
повторнойя:  повторнойи
денежный:  денежных
ровно:  ровно
рассказать:  рассказал
комплексный:  комплексные комплексного комплексный комплексными
ранг:  ранг
кривая:  кривой
тяжестиплоска:  тяжестиплоской
нудно:  нудно
относительно:  относительно
проверка:  проверка
касаться:  касается
построить:  построить
внимание:  внимание
повторить:  повторить
лейбниц:  лейбница
отсчитывать:  отсчитывать
лениться:  ленимся
неравенство:  неравенства
палец:  пальцами
поток:  поток
палата:  палате
додумывать:  додумывать
предыдущий:  предыдущего предыдущий
бывать:  бывает
направлениюй:  направлениюи
гостевой:  гостевая
левый:  левый левого
кроме:  кроме
страшный:  страшной
геометрия:  геометрию геометрии геометрия
понятно:  понятно
жать:  жмём
внутригрупповаяй:  внутригрупповаяи
алгебра:  алгебры
сумма:  сумму сумма
наоборот:  наоборот
прямоугольник:  прямоугольников
эксцессэмпирический:  эксцессэмпирического
говорить:  говорит
пускаться:  пускается
оценка:  оценка оценки
криволинейный:  криволинейные
библиотека:  библиотека
определяться:  определяется
изготовление:  изготовления изготовление
возможность:  возможности возможность
наименьшеезначение:  наименьшеезначения
сила:  силы
вычислимый:  вычислим
переваливать:  переваливает
запросто:  запросто
модный:  модная
изложить:  изложенная
системылинейный:  системылинейных
нужно:  нужно
зависимость:  зависимость
эф:  эф
пять:  пять
замкнутый:  замкнутому
площадьс:  площадьс
ранее:  ранее
убыванией:  убываниеи
повышенный:  повышенной
также:  также
интегрирование:  интегрирование
легко:  легко
фабрика:  фабрику
рациональный:  рациональные
прийти:  прийти
вводить:  вводим
видный:  видна
универмаг:  универмаге
провести:  проведена
закрывать:  закрываем
полигон:  полигону полигоне
итак:  итак
рука:  руку
вообще:  вообще
перевалить:  перевалила
нанять:  наняли
цивилизовать:  цивилизованную
лично:  лично
оценкия:  оценкии
неявный:  неявной
несобственныхинтеграл:  несобственныхинтегралов
вероятностибиномиальный:  вероятностибиномиального
род:  рода
гаусс:  гаусса
точно:  точно
кучковаться:  кучкуются
экстремальный:  экстремальные
номер:  номер
специализированный:  специализированных
депеша:  депеш
нормаль:  нормали
определитель:  определитель
успеть:  успели успело
существовать:  существуют
выпуклость:  выпуклость
редкий:  редкие
элемент:  элементы
сформулировать:  сформулирую
менее:  менее
директор:  директора
сложность:  сложности
встретиться:  встретился
значенияй:  значенияи
кстати:  кстати
труд:  труда
классическоеопределение:  классическоеопределение
инормаль:  инормаль
тетрадь:  тетради
занятный:  занятнее
пирамида:  пирамида
находиться:  находятся находится
автор:  автор автора
делимый:  делим
отходить:  отходя
счёт:  счёт
дифференциальный:  дифференциальные
уравненияс:  уравненияс
подсчёт:  подсчёты
онлайн:  онлайн
работа:  работа
широкий:  широкое
расхождение:  расхождение
новый:  новому
произвольныйтройный:  произвольныйтройной
ниже:  ниже
дизайн:  дизайна
это:  это
основание:  основании
современный:  современном
увеличиться:  увеличится
помнить:  помним
поляй:  поляи
место:  местах
опечатка:  опечатку
продолжать:  продолжаем
речь:  речь
данный:  данном
методомоперационный:  методомоперационного
бесповторный:  бесповторной
любой:  любую
убывание:  убыванию
ошибка:  ошибку
л:  л
важно:  важно
снизу:  снизу
ед:  ед
касательный:  касательных
продолжить:  продолжим
краткий:  краткая краткое
типовыхзадача:  типовыхзадач
содержание:  содержание
один:  одной
воспользоваться:  воспользоваться
ранговойкорреляция:  ранговойкорреляции
пройти:  пройденных пройдена
оставлять:  оставляю
отыскать:  отыскать
характеризоваться:  характеризуется
ден:  ден
исследовать:  исследовать
поверхность:  поверхности
углядеть:  углядят
линейныйкоэффициент:  линейныйкоэффициент
иной:  иную
несобственныйинтеграл:  несобственныйинтеграл
доступно:  доступно
истинный:  истинное
понятие:  понятия
причём:  причём
логично:  логично
учиться:  учимся
задавать:  задаваемые
ипример:  ипримеры
зоркий:  зоркие
множество:  множества
найти:  найти
требоваться:  требуется
живой:  живой
поверхностный:  поверхностные
порядок:  порядку порядка порядков
фигура:  фигуры
пуассон:  пуассона
несмотря:  несмотря
забивать:  забиваем
математическоеожидание:  математическоеожидание
школа:  школа
неоднородный:  неоднородные
обратить:  обратим
кратное:  кратные
треугольник:  треугольнике
системудифференциальный:  системудифференциальных
изначально:  изначально
абзац:  абзацев
алгоритм:  алгоритм
последовательность:  последовательностей
ранжировать:  ранжированного
квадратичный:  квадратичные
проверить:  проверить
утверждать:  утверждать
поскольку:  поскольку
гипергеометрическоераспределение:  гипергеометрическоераспределение
раз:  раза
поступить:  поступить
содержательный:  содержательном
равномерный:  равномерная равномерное
треугольный:  треугольная
картина:  картина
подстрочный:  подстрочного
зарплата:  зарплата
пожалуйста:  пожалуйста
мина:  мин
план:  плане
следовать:  следует
квадрат:  квадратов
экран:  экране
функциюкомплексный:  функциюкомплексной
непригодный:  непригодна
напоминать:  напоминаю напоминать
занимательный:  занимательной
ивр:  ивр
свойстваэлементарный:  свойстваэлементарных
стандартный:  стандартной
научиться:  научиться
сам:  самой
отуплять:  отупляют
определённый:  определенный определенного
тренировка:  тренировки
предлагать:  предлагаю
действительно:  действительно
экстремум:  экстремумы
горнера:  горнера
упомянуть:  упомянутый
применять:  применяем
функцийв:  функцийв
ознакомиться:  ознакомиться
должный:  должна
среди:  среди
лёгкий:  легче
три:  трёх
большой:  большому
единица:  единиц
дискретнойслучайный:  дискретнойслучайной
карл:  карл
знак:  знак
сносить:  сносим
дробить:  дробят
крамер:  крамера
необработанный:  необработанные
руководящий:  руководящий
олигарх:  олигарха
парабола:  парабола
установить:  установлены
обработка:  обработка
рассмотреть:  рассмотренных
функциидвуха:  функциидвух
запретить:  запрещено
черновик:  черновике
емелин:  емелин
вычисленияопределенный:  вычисленияопределенных
задачин:  задачина
замечательный:  замечательные
отдельность:  отдельности
системый:  системыи
удовлетворяетлить:  удовлетворяетли
заполнить:  заполним
зелёный:  зелёные
тригонометрический:  тригонометрических
аналитически:  аналитически
мыший:  мышью
шляпа:  шляпы
заданав:  заданав
что:  чём
всё:  всё
значительный:  значительное
тройной:  тройные
деление:  деления
являться:  является
автоматически:  автоматически
контуруформула:  контуруформула
график:  график
просуммировать:  просуммировать
либо:  либо
свободный:  свободную
рекомендовать:  рекомендую
примерно:  примерно
независимый:  независимые
температура:  температура
неудовлетворительно:  неудовлетворительно
дело:  дело
разобрать:  разберу
обозначение:  обозначения
край:  краям
группа:  группы
корреляция:  корреляции
тот:  ту
получиться:  получилась
заочник:  заочников
файл:  файле
разный:  разные
повторять:  повторяем
