вектор:  векторы векторов
творческий:  творческий
разобраться:  разобрались
вращение:  вращения
гроза:  грозы
сборник:  сборник сборники
дифференциальный:  дифференциальные дифференциального дифференциальное дифференциальных
первый:  первый первым первому первом первого
уравненияс:  уравненияс
онлайн:  онлайн
чайник:  чайником чайников
геометрия:  геометрии геометрия
копирование:  копирование
использовать:  используют используйте используя использован использовать используем
провести:  проведённую проведём проведем
решить:  решить решим
разрыв:  разрыва
работа:  работа
выражение:  выражения
сумма:  сумма сумму
производный:  производные производная производной производную
прямой:  прямой прямую прямая
дуприближённо:  дуприближённо
новый:  новому
предел:  предел пределы пределов
произвольныйтройный:  произвольныйтройной
модель:  модели модель
характеристический:  характеристическое
асимптота:  асимптоты
дизайн:  дизайна
это:  это
название:  название
исключение:  исключение
событие:  события
отблагодарить:  отблагодарить
который:  которую которого который которая которое
повторный:  повторные
чёткий:  чёткий
восстанавливать:  восстанавливаем
неопределённый:  неопределенных неопределенный неопределенном
байес:  байеса
запаковать:  запаковать
исходный:  исходного исходное исходном
числовой:  числовые
дисперсия:  дисперсию дисперсия дисперсии
выступать:  выступают
решать:  решать решают решаете
производныенеявно:  производныенеявно
пример:  примере примеры пример примерам примера примерах
составить:  составите составить составим
скорее:  скорее
решение:  решений решении решением решение решения
поляй:  поляи
интеграл:  интегралы интеграла интеграл интеграле интегралов интегралами интегралах
находиться:  находится находятся
опечатка:  опечатку
случай:  случаях случаев случае
теория:  теория теории
математический:  математические математическая математической
находить:  находить находили находим
способ:  способом способа способ
найти:  найденные найдены найти найденного найденной найдена найдем
состоять:  состоит состоять
упрощать:  упрощать
формула:  формулы формулам формула формулу
данный:  данном данное данного данный
константа:  константы констант константу константа
технически:  технически
приходиться:  приходилось
замена:  замену замены
статья:  статье статьей статьи
фнп:  фнп
однородный:  однородного однородные однородным
образец:  образцом
действительный:  действительные
поиск:  поиск
канонический:  каноническому
простейшее:  простейшие
главный:  главный главную
два:  две двумя двух
гипотеза:  гипотезы гипотез гипотеза
дифференциал:  дифференциалах дифференциала
двумерный:  двумерная
больший:  наибольшее
методомоперационный:  методомоперационного
задать:  заданной задайте заданному заданным
конец:  конце конец
часть:  частям частями часть части
различный:  различные различных
тело:  тела
циркуляция:  циркуляция
бесповторный:  бесповторной
собрать:  собраны
рассмотреть:  рассмотрен рассмотрим рассмотренный
двойной:  двойные двойной
предназначить:  предназначен
ошибка:  ошибку
рассматриваться:  рассматривался рассматривалась
плоскость:  плоскости плоскость
несобство:  несобств
л:  л
написать:  написал
общий:  общим общая общего общее
нелинейный:  нелинейная
добавлять:  добавляем
применить:  применить
какой:  каком каких какую
правый:  правая правой правую
преобразованиеквадратичный:  преобразованиеквадратичной
определителяй:  определителяи
вогнутостья:  вогнутостьи
неизвестный:  неизвестными неизвестной неизвестных неизвестные
хрень:  хрень
вид:  виде виды вид виду
закон:  законы
справа:  справа
особенность:  особенность
функциональный:  функциональные
варьироваться:  варьируются
заменимый:  заменим
слово:  слову
бытовой:  бытовых
касательный:  касательных
отбросить:  отбросьте
качество:  качестве
значение:  значения
разбираться:  разбираемся
профессия:  профессию
буква:  буква буквы
геометрический:  геометрическая геометрическое
абсолютный:  абсолютная
графика:  графика графики
типовыхзадача:  типовыхзадач
тяжёлый:  тяжелые
произвольный:  произвольной произвольных
умножение:  умножения
вероятность:  вероятностей вероятность вероятности
ранговойкорреляция:  ранговойкорреляции
система:  система систему системе системы
частный:  частные частное
функция:  функций функцией функцию функции функциями функция
выполнимый:  выполним
непрерывный:  непрерывная непрерывных
группировка:  группировок группировка
условнаясходимость:  условнаясходимость
сложенияй:  сложенияи
любой:  любое
уравненийв:  уравненийв
путать:  путать
раскрывать:  раскрываем
сокращать:  сокращает
подбор:  подбора подбор
регрессия:  регрессии регрессия
величина:  величин величина величины
вовремя:  вовремя
александр:  александр
остаться:  осталось
сокращаться:  сокращаются
раскрываться:  раскрывается
корень:  корни
грин:  грина
полный:  полное полных полного полная полной
неоднородный:  неоднородного неоднородное неоднородные неоднородном неоднородным неоднородных
исчисление:  исчисления
линейный:  линейные линейным линейная линейное линейных линейного линейной
простой:  простое простой
игрек:  игреки
коэффициент:  коэффициентов коэффициент коэффициентами
эйлер:  эйлера
приходить:  приходит
метод:  метода методы методом метод
подведение:  подведения
постоянный:  постоянные постоянная постоянными постоянных постоянной
согласие:  согласия
локальный:  локальная
сказать:  сказать
вспомогательный:  вспомогательного вспомогательным вспомогательное
ожидание:  ожидание
математика:  математики математике
лаплас:  лапласа
перегиб:  перегиба
такой:  таким таком такое
ускорять:  ускоряет
удовлетворять:  удовлетворяющее удовлетворять
сходимость:  сходимости сходимость
дуоперационный:  дуоперационным
исследовать:  исследовать
дискретный:  дискретный
базис:  базисах базис базису
ход:  ходу ход
поверхность:  поверхности
знакочередоваться:  знакочередующиеся
задача:  задачи задачу задачей
начальный:  начальным начальными начальному
тот:  те тех
векторный:  векторного векторное
предположить:  предположить
доска:  доску
ду:  ду
наиболее:  наиболее
далее:  далее
зависимостьвектор:  зависимостьвекторов
линейныйкоэффициент:  линейныйкоэффициент
делать:  делать
экспонент:  экспонента экспоненты экспонентами
взаимоуничтожаться:  взаимоуничтожаются
соответствовать:  соответствующее
дробь:  дробей дробь
собственный:  собственные
тема:  теме
страница:  страницу
практически:  практически
несобственныйинтеграл:  несобственныйинтеграл
признак:  признак признаки
смотреть:  смотрим
данные:  данных
сложный:  сложной посложнее сложных сложный сложные
непростой:  непростой
доступно:  доступно
искать:  искать искали ищем
фурье:  фурье
учиться:  учимся
поле:  поля
урок:  урока урок уроку уроке
разложение:  разложением разложение
задавать:  задаваемые
логично:  логично
свойство:  свойства
вместо:  вместо
косинус:  косинусы
момент:  момент
практика:  практике
ничто:  ничем ничто
исследование:  исследование
икс:  икс
принцип:  принципе
предпочитать:  предпочитаю
ипример:  ипримеры
уравнение:  уравнению уравнений уравнении уравнения уравнение уравнением
точка:  точки точке
множество:  множества
оценка:  оценки оценка
никакой:  никаких никакого
вариация:  вариации
переход:  переход перехода
коль:  коль
заканчивать:  заканчиваете
асимметрия:  асимметрия
шаг:  шаге
ссылка:  ссылка
знакомый:  знакомый знакомым
комплексный:  комплексными комплексные комплексного комплексный
основа:  основы
поверхностный:  поверхностные
мало:  мало
интервал:  интервалы
книга:  книга книги
кош:  коши
причём:  причем
понятный:  понятный
координата:  координат координаты координатах
фигура:  фигуры
выше:  выше
пуассон:  пуассона
желательно:  желательно
подобный:  подобные
успех:  успехов
сводиться:  сводящиеся
преобразование:  преобразований преобразования
вычисленияс:  вычисленияс
малый:  малые наименьших
связь:  связь
понижение:  понижением понижение
матричный:  матричные матричных матричный
получить:  полученное получено получены получи
результат:  результате
заметить:  заметили заметите заметить
ответ:  ответе ответ ответа ответы
математическоеожидание:  математическоеожидание
например:  например
решенияопределённый:  решенияопределенных
итог:  итоге
записывать:  записываем
помощь:  помощь помощью
вычислить:  вычислить
нормальный:  нормальное нормальную
обнулить:  обнулим
школа:  школа
очень:  очень
интегральнаятеорема:  интегральнаятеоремы
некоторый:  некоторой некоторых
предполагать:  предполагаю
хотя:  хотя
действительность:  действительности
корнимногочлен:  корнимногочлена
логарифмический:  логарифмическая
начинать:  начинаете
матрица:  матрицу матрицы матрицами
сопрячь:  сопряженные
этап:  этапе
испытанияй:  испытанияи
интегралыть:  интегралыв
число:  чисел числами числа
универсальный:  универсальный
необходимо:  необходимо
перегруппировка:  перегруппировка
каждый:  каждое
правило:  правило правила правилу
ограниченный:  ограниченном
основной:  основные
нужный:  нужные нужной
выражать:  выражаем
трудный:  трудным
применяться:  применяется
бернулли:  бернулли
полярный:  полярные полярной полярных
коэффициентковариация:  коэффициентковариации
начало:  начало
ряд:  ряд ряды ряда ряде рядов
вариационный:  вариационный
второй:  второму второй вторым втором второго вторую
уровень:  уровня
обратный:  обратная обратную
должный:  должны
вопрос:  вопросы вопрос
кратное:  кратные
жесть:  жесть
системудифференциальный:  системудифференциальных
казаться:  кажется
значительно:  значительно
блог:  блог
доверительный:  доверительные
высокий:  высших высшей высшая
мысль:  мыслей
произведение:  произведения произведение
среднееквадратический:  среднееквадратическое
пространство:  пространстве
уметь:  уметь
алгоритм:  алгоритм алгоритме
логарифм:  логарифмы логарифм
лопиталя:  лопиталя
называться:  называется
последовательность:  последовательностей
удобный:  удобный
комбинационный:  комбинационная
вкусный:  вкусная
курс:  курс
оба:  обе обоих
квадратичный:  квадратичные
обычно:  обычно
смешанноепроизведение:  смешанноепроизведение
объём:  объем
проверить:  проверить
поляформула:  поляформула
сообщить:  сообщите
линия:  линиями линии линия
фехнера:  фехнера
аналитический:  аналитическая аналитической
мой:  моим
штука:  штука
поскольку:  поскольку
школьный:  школьный
эффективный:  эффективные
левый:  левой левыми
мы:  нам нами
центр:  центр
образ:  образом
гипергеометрическоераспределение:  гипергеометрическоераспределение
условный:  условные
непрерывнаяслучайный:  непрерывнаяслучайная
эллипс:  эллипс
ноль:  ноль
обратить:  обратите
длина:  длина
сайт:  сайта сайты сайт
один:  одна одни
мочь:  могут
сократить:  сократить
производная:  производных
квадрат:  квадрата квадратов
знакопостоянство:  знакопостоянства
немного:  немного
подробно:  подробно
равномерный:  равномерная равномерное
проводить:  проводить
заключительный:  заключительном заключительный
треугольный:  треугольная
поэтому:  поэтому
безобразие:  безобразие
градиент:  градиент
писать:  пишем
задействовать:  задействована
мнение:  мнение
определение:  определения определению
трудность:  трудности
практический:  практическим
пожалуйста:  пожалуйста
даламбер:  даламбера
рассортировать:  рассортируем
теорема:  теоремы
комбинаторика:  комбинаторике
стандартный:  стандартный стандартным стандартной
случайнаявеличина:  случайнаявеличина
повторнойя:  повторнойи
построение:  построение
следовать:  следует
вспоминать:  вспоминаем
мучиться:  мучиться
бесконечно:  бесконечно
сложность:  сложностей сложности
наш:  наша наш нашу
называть:  называть
осуществляться:  осуществляется
линейнойкорреляционный:  линейнойкорреляционной
действие:  действия
вести:  ведёт
ранг:  ранг
скобка:  скобки
кривая:  кривой
восстанавливаться:  восстанавливается
форма:  формы
тяжестиплоска:  тяжестиплоской
сразу:  сразу
соответствующий:  соответствующего
почему:  почему
распределениякритерия:  распределениякритерий
функциюкомплексный:  функциюкомплексной
напоминать:  напоминаю
область:  область области
проверка:  проверка
предстоять:  предстоит
построить:  построить
лёгкий:  легких легче
готовый:  готовых
несобственный:  несобственные
просто:  просто
мода:  мода
свойстваэлементарный:  свойстваэлементарных
ещё:  ещё
внимание:  внимание
калькулятор:  калькулятор
лейбниц:  лейбница
привести:  приведу приведем привести
научиться:  научиться
откуда:  откуда
неравенство:  неравенства
происходить:  происходит
вышеупомянутый:  вышеупомянутом вышеупомянутого
поток:  поток
сам:  самой сама самом
быть:  буду будем
ехать:  едем
похоже:  похоже
касательная:  касательная
задачис:  задачис
держаться:  держитесь
цель:  цель
отрабатывать:  отрабатывали
посмотреть:  посмотрите
медиана:  медиана
синус:  синусы
функциия:  функциии
записать:  записать
диффура:  диффуры диффур диффурами
степенной:  степенного степенные
функцийдвуха:  функцийдвух
направлениюй:  направлениюи
определённый:  определенный определенного
выборка:  выборке
предвещать:  предвещает
гостевой:  гостевая
многочлен:  многочлены
знакомиться:  знакомиться
скоро:  скоро
приносить:  приносит
единственный:  единственное
распределение:  распределения распределение
кроме:  кроме
экстремум:  экстремумы
горнера:  горнера
подстановка:  подстановку
производныефункция:  производныефункции
средний:  средняя
функцийнесколький:  функцийнескольких
предложение:  предложение
прокомментировать:  прокомментирую
интересный:  интересном
возникнуть:  возникнуть
внутригрупповаяй:  внутригрупповаяи
зависеть:  зависит
алгебра:  алгебры
путь:  пути
приняться:  примемся
варьировать:  варьируем
запугать:  запугал
математик:  математика
функцийв:  функцийв
переменный:  переменных переменной переменные переменными
раскладывать:  раскладывать
видеть:  видите
несовместный:  несовместные
независимыеслучайный:  независимыеслучайные
множественнойлинейный:  множественнойлинейной
добавить:  добавить
проясниться:  прояснилось
анализ:  анализ анализа
прямоугольник:  прямоугольников
непрерывность:  непрерывность
эксцессэмпирический:  эксцессэмпирического
слагаемое:  слагаемых
тупо:  тупо
функциис:  функциис
неприятный:  неприятная
зеркало:  зеркало
криволинейный:  криволинейные
значит:  значит
определитель:  определителями определитель
пирсон:  пирсона
библиотека:  библиотека
три:  трёх
цветочек:  цветочки
межгрупповой:  межгрупповая
ортогональный:  ортогональное
дискретнойслучайный:  дискретнойслучайной
задачипо:  задачипо
трахча:  трахча
служить:  служить
востребовать:  востребованную
наименьшеезначение:  наименьшеезначения
условие:  условиям условиями условию
нсв:  нсв
сила:  силы
разделяться:  разделяющимися
приблизить:  приближенные
знак:  знак
минута:  минут
позабыться:  позабылось
вариант:  вариант
системылинейный:  системылинейных
нужно:  нужно
вроде:  вроде
слышать:  слышать
задание:  задания
взять:  возьму
упасть:  упал
чистовой:  чистового
соответствие:  соответствии
расслабление:  расслабления
зависимый:  зависимые
благодать:  благодать
зависимость:  зависимость
отклонение:  отклонение
крамер:  крамера
громоздкий:  громоздкую
отрезка:  отрезке
материал:  материалы материалов
другой:  другие
таблица:  таблицы
красивый:  красивый
случайный:  случайных случайные
предвзятый:  предвзятое
замкнутый:  замкнутому
отход:  отходов
освоение:  освоения
дуга:  дуги
внимательно:  внимательно
отрезкать:  отрезкав
запись:  запись
желать:  желаю
тангенс:  тангенс
дивергенция:  дивергенция
парабола:  парабола
возможный:  возможное
проходить:  проходит
форум:  форуме форум
показатель:  показатели
свалка:  свалку
отличие:  отличие
оформление:  оформления
думать:  думал
обычный:  обычное
площадьс:  площадьс
запретить:  запрещено
функциидвуха:  функциидвух
интегрировать:  интегрируем
ранее:  ранее
статистический:  статистические статистическая
ситуация:  ситуации
емелин:  емелин
трюк:  трюк
она:  неё
убыванией:  убываниеи
вычисленияопределенный:  вычисленияопределенных
повышенный:  повышенной
возрастание:  возрастание
эмпирический:  эмпирические
детерминация:  детерминации
проделывать:  проделываем
интегрирование:  интегрирование интегрирования интегрированием
легко:  легко
обязательно:  обязательно
подставить:  подставим
задачин:  задачина
замечательный:  замечательные
рациональный:  рациональные
системый:  системыи
начать:  начать
удовлетворяетлить:  удовлетворяетли
праздник:  праздников
найтись:  нашлось
мучительный:  мучительно
выполнить:  выполнить
решаться:  решается
место:  месте
пока:  пока
дифференциальныеуравнение:  дифференциальныеуравнения
обратиться:  обратитесь
иррациональный:  иррациональных
обнулять:  обнуляем
интервальный:  интервальный
тригонометрический:  тригонометрических тригонометрическую
квадратичнуюформ:  квадратичнуюформу
стокс:  стокса
примерный:  примерным
схема:  схема схеме
карта:  карта
заменять:  заменяя
параметрический:  параметрической параметрическом
итак:  итак
несложный:  несложный
гипербола:  гипербола
дифференцирование:  дифференцирования
дробовик:  дробовик
они:  ними
плавный:  плавного
оценкия:  оценкии
неявный:  неявной
параграф:  параграф
встречаться:  встречается
несобственныхинтеграл:  несобственныхинтегралов
вероятностибиномиальный:  вероятностибиномиального
вероятностия:  вероятностии
логика:  логики
род:  рода
заданав:  заданав
скалярный:  скалярное
спирмена:  спирмена
гаусс:  гаусса
ориентироваться:  ориентируется
следующий:  следующее
совершенно:  совершенно
порядок:  порядка порядков
всё:  всё
значимость:  значимости
приплюсовывать:  приплюсовываем
тройной:  тройные
лнд:  лнду
особый:  особых
возникать:  возникает
деление:  деления
являться:  является являетесь
контуруформула:  контуруформула
частное:  частного
экстремальный:  экстремальные
график:  график
лишь:  лишь
умный:  умную
дело:  деле
её:  её
прозрачный:  прозрачный
св:  св
парный:  парной
студент:  студентов
нормаль:  нормали
иметь:  имеет
браться:  берутся
прокатывать:  прокатывает
выпуклость:  выпуклость
элемент:  элементы
достаточно:  достаточно
показательный:  показательное
отсюда:  отсюда
рассмотрение:  рассмотрением
рекомендовать:  рекомендую
независимый:  независимые
раскрыть:  раскрыть
менее:  менее
автор:  автора автор
разделять:  разделяем
кузнецов:  кузнецова
часто:  часто
значенияй:  значенияи
контрольный:  контрольный
никак:  никак
получаться:  получается
наблюдение:  наблюдениям
вычисление:  вычисление
выполняться:  выполняется
надеяться:  надеюсь
верный:  верном
классическоеопределение:  классическоеопределение
инормаль:  инормаль
представлять:  представляет
статистика:  статистика
корреляция:  корреляции
прежде:  прежде
бэ:  бэ
выделение:  выделения
биномиальный:  биномиальное
аист:  аист
далёкий:  дальше
редкий:  реже
заочник:  заочников
пирамида:  пирамида
многий:  многим
позор:  позора
линиюв:  линиюв
очевидный:  очевиден
счастие:  счастье
самостоятельный:  самостоятельного
наслать:  нашли
отношение:  отношении
распечатать:  распечатаете
повторять:  повторяем
злоупотреблять:  злоупотреблял
