раскрывать:  раскрывать
частный:  частным частное частные
третий:  третьим
яркий:  яркой
неоднократно:  неоднократно
производный:  производные производная производной производную
предел:  предел пределами пределы пределов предела пределе
здоровье:  здоровье
неприступный:  неприступного
идея:  идеями идея идеи
выслеживать:  выслеживают
интерес:  интереса
обычный:  обычном обычными
числовой:  числовые числового числовой числовая числовых
экселе:  экселе
возиться:  возиться
производныенеявно:  производныенеявно
значение:  значение значения
скорее:  скорее
отрицательный:  отрицательные отрицательным
попасться:  попался
формула:  формулы формула
смотреть:  см
ряд:  рядами ряды ряда ряду ряд ряде рядов
сюда:  сюда
прийтись:  придётся пришлось
канонический:  каноническому
дифференциал:  дифференциалах дифференциала
больший:  наибольшее большее большим большую
характер:  характера
многие:  многие
число:  число числами чисел числа
вогнутостья:  вогнутостьи
многий:  многих
позволять:  позволяет
мутный:  мутным
случай:  случай случаев случае
упрощать:  упрощаем
вытрясти:  вытрясут
плохой:  хуже
применить:  применил применить
доллар:  долларов
профессия:  профессию
сравнить:  сравнить
влияние:  влияния
волк:  волк волки
удобно:  удобно
видеть:  видит видят
умножение:  умножения
африканский:  африканском
терпеть:  терпите
система:  система системе систему системы
группировка:  группировок группировка
условнаясходимость:  условнаясходимость
слово:  словами
александр:  александр
душа:  душу
необходимый:  необходимый необходимое необходимого
который:  которые который которая которую
редко:  редко
линейный:  линейные линейная линейных линейной
помочь:  помогло
попытка:  попытка
объём:  объём объем
гарантировать:  гарантировано гарантирует
неведомый:  неведомые
раздел:  разделах разделу
разобрать:  разобрано разобраны
согласие:  согласия
прочий:  прочие прочих
эквивалентность:  эквивалентности эквивалентностью эквивалентностями эквивалентность
опыт:  опыт опыта опытом
нечётный:  нечётных
дуоперационный:  дуоперационным
пример:  примером пример примера примере примерах примеры
базис:  базисах базису базис
оговорка:  оговорка
хитрый:  хитрой хитрые
зависимостьвектор:  зависимостьвекторов
снова:  снова
сходимость:  сходимостью сходимости сходимость
сначала:  сначала
метод:  методы методами методом метод
вывести:  вывел
составлять:  составляем составляет
спустя:  спустя
тема:  теме
страница:  страницу страницы
числитель:  числителе числитель числителя
математический:  математическая математического математические математический математической
данные:  данных
четвёртый:  четвёртым
тройка:  тройку
интеграл:  интеграл интегралов интегралы интеграла интегралом интеграле
урок:  урока урок
разложение:  разложением разложении разложение
отбросить:  отбросим
типовой:  типовой типовым
расходиться:  расходится расходятся расходящимся расходиться расходящегося расходящемся
синус:  синус синуса синусах
помогать:  помогает
уравнение:  уравнению уравнения уравнение уравнений
переход:  переход
аргумент:  аргументе аргумент
черновик:  черновики черновике
утверждение:  утверждение
разбор:  разбор
причина:  причины причине причина
очередь:  очередь
первый:  первое первых первая первом первого первый
эквивалентный:  эквивалентными эквивалентный эквивалентной эквивалентную
малый:  малые малом малую малой наименьших малая меньшим
связь:  связь
вдохновение:  вдохновения
применение:  применение применения
нормальный:  нормальное
интегральнаятеорема:  интегральнаятеоремы
корнимногочлен:  корнимногочлена
логарифмический:  логарифмическая
решить:  решил решишь решить
условие:  условие условия
оформлять:  оформляем
ночь:  ночи
место:  места
основной:  основные
черновой:  черновой
образец:  образцу образец образцы
бернулли:  бернулли
полярный:  полярные полярных полярной
рассмотреть:  рассмотрим рассмотренные
быть:  будете будут
добыча:  добычу
уровень:  уровня
доверительный:  доверительные
редкость:  редкость
среднееквадратический:  среднееквадратическое
рассчитать:  рассчитана
неопределённость:  неопределённость неопределённости
выясниться:  выяснилась
рааба:  раабе
комбинационный:  комбинационная
сопрячь:  сопряженное
смешанноепроизведение:  смешанноепроизведение
функция:  функции функция функций
вместе:  вместе
дисперсия:  дисперсия дисперсии дисперсию
проверка:  проверки проверка
постараться:  постарайтесь
огромный:  огромный
школьный:  школьный
мы:  нам нами
образ:  образом
непрерывнаяслучайный:  непрерывнаяслучайная
другой:  других другие
длина:  длина
процесс:  процессе
подавлять:  подавляющем
хороший:  лучших
посмотреть:  посмотреть
немного:  немного
мочь:  могут можем
знакопостоянство:  знакопостоянства
проводить:  проводить
градиент:  градиент
конец:  конец конце
увеличивать:  увеличивает
линия:  линия линии линиями
предупреждать:  предупреждал
дать:  дал данная данные
комбинаторика:  комбинаторике
случайнаявеличина:  случайнаявеличина
маскироваться:  маскируется
свой:  своего
бесконечно:  бесконечно
отношение:  отношению отношение отношении
давать:  даёт
расписать:  распишите распишем расписать
простой:  простому проще прост простое простого
форма:  формы
отметить:  отметить
статья:  статьи статья статьях
бесполезность:  бесполезности
фраза:  фразу
обратный:  обратную обратная
простить:  простите
год:  годы лет
сравнимый:  сравним
готовый:  готовых готовые готово
просто:  просто
приём:  приём приёмами приёма приёмом
ещё:  ещё
порядок:  порядком порядок порядка порядков
влиять:  влияет
применимый:  применимо применим
читатель:  читателей читатели
высокий:  высокого высших высшей высшая
сходиться:  сходится сходящегося сходящейся сходиться сходящийся сходящимся сходящимися
подобный:  подобных подобные
данный:  данного данном данный
бумага:  бумагу
вывернуться:  вывернуться
непрерывный:  непрерывных непрерывная непрерывна
квест:  квеста
производныефункция:  производныефункции
средний:  средняя
домножения:  домножения
знак:  знаком
обязать:  обязан
заслать:  зашли
область:  области область
ура:  ура
далеко:  далеко
математик:  математика
переменный:  переменных переменной
справиться:  справитесь
несовместный:  несовместные
независимыеслучайный:  независимыеслучайные
ответ:  ответа ответы
следовательно:  следовательно
восклицательный:  восклицательным
модель:  модель модели
непрерывность:  непрерывность
функциис:  функциис
полный:  полной полных полный полное
зеркало:  зеркало
значит:  значит
пирсон:  пирсона
член:  члены члена член членов
абель:  абеля
вопрос:  вопрос вопросом вопросы
понимание:  понимании
традиция:  традициях
межгрупповой:  межгрупповая
ортогональный:  ортогональное
нсв:  нсв
стиль:  стиле
запустить:  запущены
расходимость:  расходимости расходимость
здорово:  здорово
вроде:  вроде
проанализировать:  проанализировать проанализируем проанализируйте
упасть:  упал
ход:  ходе ход ходу
отрезка:  отрезке
величина:  величина величин величины
игра:  игры
арсенал:  арсенала
недостаток:  недостатком недостатка
положительный:  положительные положительный положительных
убывать:  убывающей
скверный:  скверное
продолжение:  продолжения продолжение
детерминация:  детерминации
конечный:  конечное
двойной:  двойным двойные двойной двойного
обязательно:  обязательно
мучаться:  мучаться
тот:  тех той
начать:  начать
степень:  степенями степень степеней степени
сильный:  сильный сильные
навороченность:  навороченности
дифференциальныеуравнение:  дифференциальныеуравнения
гармонический:  гармонического гармоническим
прямой:  прямая прямой прямую
сожаление:  сожалению
постоянный:  постоянных
стокс:  стокса
схема:  схема
работа:  работы работа
оформление:  оформление оформлению оформления
самостоятельно:  самостоятельно
дифференцирование:  дифференцирования
дробовик:  дробовик
марать:  марать
легально:  легально
получить:  получен полученного получим получено полученное получила получи
математика:  математике математики
векторный:  векторное векторного
нечто:  нечто
вероятностия:  вероятностии
скалярный:  скалярное
следующий:  следующее следующую следующего
совершенно:  совершенно
сочный:  сочных
наш:  нашем нашему наше наш нашего
понятный:  понятен понятным понятной
значимость:  значимости
оформить:  оформлено оформить
слон:  слон
мысленно:  мысленно
несобственный:  несобственный несобственные несобственным
предельный:  предельный предельного
признак:  признака признак признаков признаку признаки
анализ:  анализа анализ
исследовать:  исследуемый исследуем исследовать
её:  её
напоминать:  напоминающее напоминает напоминаю
парный:  парной
поставить:  поставят
неверный:  неверный
примерный:  примерный примерные
несколько:  несколько
доказать:  доказаны доказанный
сборник:  сборники
параметрический:  параметрическом параметрической
злоключение:  злоключений
версия:  версия
зверь:  зверь
показаться:  показалось
часто:  часто
человек:  человек
пояснять:  поясняю
получаться:  получается
дикобраз:  дикобразов
нота:  ноте
надеяться:  надеюсь
решение:  решение решении решением решения решений
форум:  форум форуме
изящный:  изящное
книга:  книги книга
наводить:  наводит
провести:  провести проведём проведена
случаем:  случаем
рекуррентный:  рекуррентных
выглядеть:  выглядеть
прозрачность:  прозрачности
вектор:  векторы векторов
встреча:  встречи
вращение:  вращения
настроение:  настроение
именно:  именно
копирование:  копирование
отбрасываться:  отбрасываются
разрыв:  разрыва
справочник:  справочник
выражение:  выражения выражение
истинный:  истинный
траурный:  траурное
грубо:  грубо
отблагодарить:  отблагодарить
байес:  байеса
круг:  кругу
рассматривать:  рассматриваем
решать:  решать
перечитать:  перечитать
без:  безо
неравенство:  неравенствами неравенство неравенства неравенствах
результат:  результат результате результату
теория:  теория теории
связать:  связано
цитата:  цитата
дополнительно:  дополнительно
нулевой:  нулевым
общий:  общих общим общая общий общего
называть:  называют
двумерный:  двумерная
задать:  заданной задайте
классический:  классическим
тело:  тела
циркуляция:  циркуляция
набитый:  набит
плоскость:  плоскости плоскость
соответствовать:  соответствующим
определителяй:  определителяи
выносить:  выносим
выступать:  выступает
пробел:  пробелами
дважды:  дважды
врубиться:  врубился
закон:  законы
дробь:  дроби дробь дробей
затруднение:  затруднения
заменимый:  заменим
дикий:  диких дикой
качество:  качестве
впечатление:  впечатление
сафари:  сафари
действие:  действий действия
насколько:  насколько
вероятность:  вероятностей вероятность вероятности
уравненийв:  уравненийв
аналогичный:  аналогична
множитель:  множитель
появиться:  появились
количество:  количества
грин:  грина
уменьшать:  уменьшая
эйлер:  эйлера
картиночка:  картиночки
русский:  русской
закачать:  закачать
сам:  саму сама само
годиться:  годится
хрен:  хрен
невнимательность:  невнимательности
отбрасывание:  отбрасывание
короткий:  коротких короткая короткое
невозможно:  невозможно
дискретный:  дискретный
знакочередоваться:  знакочередующиеся
обнаружить:  обнаружил
заметно:  заметно
воспроизводить:  воспроизвожу
немножечко:  немножечко
практически:  практически
подумать:  подумайте
произвольный:  произвольных
сложный:  сложной сложный сложные сложных сложная
работать:  работает работают
фурье:  фурье
поле:  поля
гипотеза:  гипотез гипотеза гипотезы
свойство:  свойства свойство
исследование:  исследование исследования
начинаться:  начинается
рассуждение:  рассуждений рассуждение
точка:  точки точке
проблема:  проблем
вариация:  вариации
тупик:  тупик
основа:  основы
студент:  студент студентов
глаз:  глаза
интервал:  интервалы
кош:  коши
такой:  таком таким такие такое такого такая такому таких
выше:  выше
надежда:  надежд
пылиться:  пылится
соответствующий:  соответствующих
тигр:  тиграм тигр
чайник:  чайников
дополнительный:  дополнительными
предвещать:  предвещало
вычисленияс:  вычисленияс
некоторый:  некоторым некоторых
матричный:  матричные матричных матричный
всякий:  всяких
заметить:  заметили
уверить:  уверены
однородный:  однородные однородным
записывать:  записываем
вычислить:  вычислить вычислил
очень:  очень
зачёт:  зачёта
матрица:  матрицу матрицы матрицами
этап:  этапе
испытанияй:  испытанияи
интегралыть:  интегралыв
перегруппировка:  перегруппировка
практический:  практической практическими
обсуждаться:  обсуждалось
неожиданно:  неожиданно
помощь:  помощью
близкий:  ближайшие
вариационный:  вариационный
чистый:  чистую
использовать:  использую используем использовал использовать использована используйте
приятный:  приятной
блог:  блог
произведение:  произведения произведение
последовательность:  последовательности последовательностях последовательностей последовательность
пространство:  пространстве
удобный:  удобный
курс:  курс
координата:  координаты координат координатах
перед:  передо
сообщить:  сообщите
сделать:  сделать сделанный
аналитический:  аналитическая аналитической
понижение:  понижение понижением
знать:  знаю знает
штука:  штука
видоизменить:  видоизменить
центр:  центр
искусственный:  искусственного
предшествовать:  предшествует
затмение:  затмение
чётный:  чётных
считаться:  считается
упорно:  упорно
разделить:  разделим
гранатомёт:  гранатомёт
возвести:  возвести
сторона:  сторону
выпадать:  выпадает
шанс:  шанс
верёвка:  верёвку
построение:  построение
природа:  природе
осуществляться:  осуществляется
линейнойкорреляционный:  линейнойкорреляционной
пользоваться:  пользовались пользуйтесь
вести:  ведёт
ассоциация:  ассоциации
оставаться:  остаётся
сила:  силу силы
почему:  почему
распределениякритерия:  распределениякритерий
удержаться:  удержался
оказывать:  оказывает
известный:  известна известные
сложность:  сложностью сложности
зрение:  зрения
откуда:  откуда
сдаться:  сдамся
полностью:  полностью
касательная:  касательная
задачис:  задачис
правило:  правила правилу правило
функциия:  функциии
завершать:  завершающем
степенной:  степенного степенные
возможно:  возможно
функцийдвуха:  функцийдвух
выборка:  выборке
неожиданный:  неожиданное
потратить:  потрачена
обитатель:  обитателей
функцийнесколький:  функцийнескольких
рост:  роста
множественнойлинейный:  множественнойлинейной
распределение:  распределение распределения
оказываться:  оказывается
радикальный:  радикальный
зеркальный:  зеркальна
саванна:  саванны
доставлять:  доставляют
задачипо:  задачипо
востребовать:  востребованную
приблизить:  приближенные
злиться:  злись
изучить:  изучив
отчаяние:  отчаянии
обобщённый:  обобщенного
выкладка:  выкладки выкладку
зависимый:  зависимые
предложить:  предложил
отклонение:  отклонение
таблица:  таблицы
вполне:  вполне
случайный:  случайных случайные
шкура:  шкуру
время:  времени
дуга:  дуги
частность:  частности
разведка:  разведку
отрезкать:  отрезкав
дивергенция:  дивергенция
спасибо:  спасибо
возникнуть:  возник
полёт:  полётов
бинокль:  бинокль
сайт:  сайт сайты сайта
графика:  графики графика
предчувствие:  предчувствие
путешествие:  путешествие
желательный:  желательна
подробный:  подробнее
неверно:  неверно
экстремальный:  экстремального экстремальные
ситуация:  ситуации ситуация
идти:  идёт
какой:  какому
возрастание:  возрастание
эмпирический:  эмпирические
приличный:  приличной
арксинус:  арксинуса
задаваться:  задаёмся
объектив:  объективом
найтись:  нашлось
арктангенс:  арктангенса
соблазн:  соблазна
бесконечный:  бесконечного
аналогично:  аналогично
иррациональный:  иррациональных
мой:  моё мои моей
отличный:  отличный отличное
определение:  определению определения
квадратичнуюформ:  квадратичнуюформу
карта:  карта
вычисление:  вычисления вычисление вычислений
эпический:  эпический
гипербола:  гипербола
загвоздка:  загвоздка
неподалёку:  неподалёку
начинка:  начинкой
они:  ними
методика:  методику
происшествие:  происшествия
логика:  логики
спирмена:  спирмена
материал:  материалов материалы
бесполезно:  бесполезно
вид:  виду виды виде
номер:  номеров номера
оказаться:  оказалось
возникать:  возникает
знаменатель:  знаменателем знаменателя знаменатель
расставлять:  расставляю
вовсе:  вовсе
полка:  полке
лишь:  лишь
св:  св
самый:  самый самое
второй:  второго второй вторая
иметь:  имеет
сумма:  суммы сумму сумма
факториал:  факториалы факториалов факториала факториал
предыдущий:  предыдущих
подобрать:  подберите
пара:  пара
достаточно:  достаточно
показательный:  показательное
моментально:  моментально
преобразование:  преобразования преобразований
понимать:  понимаете
диффура:  диффурами
выполняться:  выполняется
статистика:  статистика
биномиальный:  биномиальное
обманывать:  обманывает
линиюв:  линиюв
история:  история
самостоятельный:  самостоятельного
любительский:  любительским
посетитель:  посетителей
туго:  туго
дуприближённо:  дуприближённо
товарищ:  товарища
прочитать:  прочитайте
навевать:  навевает
асимптота:  асимптоты
событие:  события
повторный:  повторные
неограниченно:  неограниченно
б:  б
прогрессия:  прогрессией
состоять:  состоит
оставить:  оставило
задание:  заданий заданиями задании
замена:  замену замены замена
фнп:  фнп
простейшее:  простейшие
расти:  растущая
иной:  иными
часть:  частям часть
разобраться:  разберусь
несобство:  несобств
нелинейный:  нелинейная
преобразованиеквадратичный:  преобразованиеквадратичной
наворотить:  навороченных
напрашиваться:  напрашивается
проникнуться:  прониклись
функциональный:  функциональные
чудо:  чудо
час:  час
сто:  сто
творческий:  творческого
геометрический:  геометрическая геометрической геометрическое
абсолютный:  абсолютная
выполнить:  выполнен выполненных выполнено
расправиться:  расправиться
зверушка:  зверушки
устоять:  устояли
натуральный:  натуральных
срабатывать:  срабатывает
сложенияй:  сложенияи
регрессия:  регрессии регрессия
хватить:  хватило хватит
оценка:  оценке оценка оценки
ограничить:  ограничена
исчисление:  исчисления
чрезвычайно:  чрезвычайно
подходить:  подходит
зачастую:  зачастую
локальный:  локальная
начинать:  начиная
ожидание:  ожидание
лаплас:  лапласа
перегиб:  перегиба
задача:  задачи задач задача
ду:  ду
делать:  делать
остаток:  остатка
мысль:  мысль
возбраняться:  возбраняется
коэффициент:  коэффициент
неопределённый:  неопределенный неопределенном
собственный:  собственные
замечательный:  замечательной замечательный замечательными замечательные
ваш:  ваш вашего
запутаться:  запутаться
рядом:  рядом
поэтому:  поэтому
практика:  практике практики
вместо:  вместо
намылить:  намыленную
знакомый:  знакомый
асимметрия:  асимметрия
шаг:  шаге шага
скажем:  скажем
главный:  главную
сводиться:  сводящиеся
собственно:  собственно
краткость:  краткости
маленький:  меньше мала малы
например:  например
решенияопределённый:  решенияопределенных
нужный:  нужный нужной
хотя:  хотя
формальность:  формальность
тангенс:  тангенса
французский:  французский
коэффициентковариация:  коэффициентковариации
технический:  технического
выполнение:  выполнение
ограниченность:  ограниченность ограниченностью
обманчивый:  обманчивы
непотопляемый:  непотопляемый
великий:  великой
лопиталя:  лопиталя
перо:  перьях
крайне:  крайне
обычно:  обычно
стандартный:  стандартными стандартного
поляформула:  поляформула
наверное:  наверное
фехнера:  фехнера
найти:  нашёл найти
вычислительный:  вычислительной
эффективный:  эффективные
условный:  условные условный
эллипс:  эллипс
доказательство:  доказательство доказательства
ненавязчивый:  ненавязчиво
завезти:  завезли
пошерстить:  пошерстив
один:  одна
выход:  выход
смысл:  смысла
даламбер:  даламбера даламбер
факт:  факт факты
теорема:  теоремы теорема
повторнойя:  повторнойи
естественно:  естественно
комплексный:  комплексные комплексного комплексный комплексными
скобка:  скобки
ранг:  ранг
мгновенно:  мгновенно
кривая:  кривой
организовать:  организуем
тяжестиплоска:  тяжестиплоской
построить:  построить
внимание:  внимание
логарифм:  логарифм
лейбниц:  лейбница
ради:  ради
комментарий:  комментария
поток:  поток
реальный:  реальных
медиана:  медиана
бывать:  бывает
туман:  туман
направлениюй:  направлениюи
гостевой:  гостевая
банкет:  банкета
аккуратно:  аккуратно
зачётка:  зачётку
понятно:  понятно
знание:  знаний
вывод:  вывод
главное:  главное
внутригрупповаяй:  внутригрупповаяи
зависеть:  зависит
доставаться:  достаётся
алгебра:  алгебры
наоборот:  наоборот
рабочий:  рабочая
трёхходовой:  трёхходовое
двухходовый:  двухходовое
существовать:  существует существуют
прямоугольник:  прямоугольников
эксцессэмпирический:  эксцессэмпирического
виновато:  виновато
говорить:  говорит говоря
битый:  битый
учесть:  учесть
неприятный:  неприятная
криволинейный:  криволинейные
различный:  различных
тарабарщина:  тарабарщиной
устранение:  устранения
библиотека:  библиотека
каждый:  каждый
настолько:  настолько
корень:  корень корней
наименьшеезначение:  наименьшеезначения
разрулить:  разрулит
небрежность:  небрежности
ты:  тебе
системылинейный:  системылинейных
нужно:  нужно
худой:  худой
семестр:  семестре
вынос:  выносом
зависимость:  зависимость
категория:  категории
гулять:  гулять
увлечение:  увлечением
замкнутый:  замкнутому
давно:  давно
очевидный:  очевидно очевиден
проверить:  проверим проверить
желать:  желаю желающие желала
несправедливый:  несправедливым
показатель:  показатели
догадаться:  догадаешься
отличие:  отличие
сильно:  сильно
площадьс:  площадьс
большинство:  большинстве
леопард:  леопард леопарды
убыванией:  убываниеи
повышенный:  повышенной
статистический:  статистическая статистические
также:  также
интегрирование:  интегрирование
легко:  легко
рациональный:  рациональные рациональную
интегральный:  интегральный
стадо:  стадо
стоп:  стоп
мягко:  мягко
интервальный:  интервальный
живой:  живые
народный:  народной
вообще:  вообще
лично:  лично
оценкия:  оценкии
неявный:  неявной
несобственныхинтеграл:  несобственныхинтегралов
вероятностибиномиальный:  вероятностибиномиального
род:  рода
замаячить:  замаячило
гаусс:  гаусса
покорить:  покорить
особый:  особых
точно:  точно
умножить:  умножим
дирихло:  дирихле
нормаль:  нормали
определитель:  определитель
провокационный:  провокационный
приводить:  привожу приводят
выпуклость:  выпуклость
элемент:  элементы
значенияй:  значенияи
справедливо:  справедливо
мудрость:  мудрости
классическоеопределение:  классическоеопределение
инормаль:  инормаль
далёкий:  дальше
пригодный:  пригоден
пирамида:  пирамида
помнить:  помните
любой:  любого любых
автор:  автор автора
забраться:  забрались
осмотр:  осмотр
накручивать:  накручивает
ссылка:  ссылки
цель:  целях
дифференциальный:  дифференциальные
уравненияс:  уравненияс
мощность:  мощности
слонёнок:  слонёнок
незабываемый:  незабываемое
онлайн:  онлайн
геометрия:  геометрии геометрия
нуль:  нуля
новый:  новому
дальнейший:  дальнейших
произвольныйтройный:  произвольныйтройной
основный:  основного
дизайн:  дизайна
нацедить:  нацедили
ограниченный:  ограниченную
это:  это этим
родственник:  родственники
кровь:  кровью
поляй:  поляи
опечатка:  опечатку
выгодный:  выгоднее
продолжать:  продолжаем
способ:  способом способу способ
трофейный:  трофейную
технически:  технически
показать:  показать
непременно:  непременно
вызывать:  вызывает
методомоперационный:  методомоперационного
бесповторный:  бесповторной
правильно:  правильно
ошибка:  ошибку
л:  л
уметь:  умеют
выручать:  выручавший
спокойно:  спокойно
взять:  взять
касательный:  касательных
приблизительно:  приблизительно
разбираться:  разбираемся
сравнение:  сравнение сравнения
идентичный:  идентичного
типовыхзадача:  типовыхзадач
немыслимый:  немыслимым
планирование:  планирования
взгляд:  взгляд
воспользоваться:  воспользоваться
ранговойкорреляция:  ранговойкорреляции
рука:  руки
отпадать:  отпадают
тяжёлый:  тяжёлые
отложить:  отложим
отдельно:  отдельно
подсказывать:  подсказывает
ребёнок:  дети
детский:  детскую
африка:  африку
грациозный:  грациозных
тамбовский:  тамбовского
поверхность:  поверхности
составить:  составить
размахивать:  размахивающий
ознакомиться:  ознакомимся
теоретически:  теоретически
уйма:  уйма
линейныйкоэффициент:  линейныйкоэффициент
несобственныйинтеграл:  несобственныйинтеграл
доступно:  доступно
причём:  причём
логично:  логично
учиться:  учимся
пройти:  пройти
задавать:  задаваемые
допустить:  допустить
хищник:  хищник
ипример:  ипримеры
множество:  множества
добывать:  добывать
вынести:  вынесем
поверхностный:  поверхностные
сработать:  сработал
фигура:  фигуры
пуассон:  пуассона
успех:  успехов
поверхностно:  поверхностно
большой:  большое велика
однако:  однако
пытка:  пытка
математическоеожидание:  математическоеожидание
итог:  итоге
школа:  школа
неоднородный:  неоднородные
необходимо:  необходимо
проверять:  проверяем
вода:  воду
посещать:  посещает
чистовой:  чистовое
обратиться:  обратиться
кратное:  кратные
добраться:  добрались
системудифференциальный:  системудифференциальных
изначально:  изначально
традиционно:  традиционно
представиться:  представился
выбрать:  выбран
ходить:  ходите
должный:  должно
квадратичный:  квадратичные
попадаться:  попадаются
трудность:  трудность
поскольку:  поскольку
гипергеометрическоераспределение:  гипергеометрическоераспределение
оба:  обоих оба
профессор:  профессор
хвост:  хвоста
раз:  раза
обратить:  обратите
рождаться:  рождаются
возможность:  возможность
подробно:  подробно
равномерный:  равномерная равномерное
треугольный:  треугольная
картина:  картина
лаконичный:  лаконичному
пожалуйста:  пожалуйста
принимать:  принимать принимает
мучиться:  мучаетесь
следовать:  следует
себя:  собой
редкий:  редкая редкий
пятёрка:  пятёрки
квадрат:  квадратов
сразу:  сразу
сомнение:  сомнений
функциюкомплексный:  функциюкомплексной
относиться:  относятся
мода:  мода
свойстваэлементарный:  свойстваэлементарных
дальний:  дальней
ворота:  ворота
калькулятор:  калькулятор калькуляторе
задачка:  задачку
научиться:  научиться
ловко:  ловко
психовать:  психуй
обойти:  обойти
удивляться:  удивляться
фихтенголец:  фихтенгольца
похоже:  похоже
явно:  явно
определённый:  определенный определенного
предлагать:  предлагаю
действительно:  действительно
экстремум:  экстремумы
приниматься:  принимается
горнера:  горнера
сравнивать:  сравнивать
открыть:  открыл
затык:  затыка
правильный:  правильной
очередной:  очередным
брать:  брать
функцийв:  функцийв
активно:  активно
бессильный:  бессилен
бессонный:  бессонные
радость:  радости
раскалываться:  раскалываются
заново:  заново
антилопа:  антилоп
три:  трёх
куст:  кустах
архив:  архив
дискретнойслучайный:  дискретнойслучайной
скромный:  скромного
корм:  корм
соответствие:  соответствии
ходьба:  ходьба
мощный:  мощная
крамер:  крамера
сослаться:  сославшись
мысленный:  мысленное мысленный
вознаграждение:  вознаграждения
малоизвестный:  малоизвестный
удивиться:  удивился
бармалей:  бармалей
начало:  начале
парабола:  парабола
строго:  строго
запретить:  запрещено
функциидвуха:  функциидвух
емелин:  емелин
завершиться:  завершилось
вычисленияопределенный:  вычисленияопределенных
невзначай:  невзначай
отлынивать:  отлынивать
задачин:  задачина
системый:  системыи
удовлетворяетлить:  удовлетворяетли
субъективный:  субъективной
камера:  камеры
пятый:  пятым
сегодня:  сегодня
приходиться:  приходится
необычный:  необычного
инструкция:  инструкцию
два:  двух
тригонометрический:  тригонометрических
незнание:  незнанию
горизонт:  горизонте
затесаться:  затесался
встречаться:  встречается
байка:  байке
исход:  исхода
заданав:  заданав
уверенно:  уверенно
что:  чём
всё:  всё
чёткий:  чёткого
тройной:  тройные
стирлинг:  стирлинга
деление:  деления
контуруформула:  контуруформула
прибегнуть:  прибегнул
график:  график
дело:  дела
весь:  весь
вне:  вне
отсутствие:  отсутствия
вспомниться:  вспомнилось
разряд:  разряду
энна:  энной
хобот:  хоботом
подтвердиться:  подтвердилось
либо:  либо
прийти:  пришёл
элементарно:  элементарно
рекомендовать:  рекомендую
эн:  эн
примерно:  примерно
независимый:  независимые
типичный:  типичный
привести:  привести
пойти:  пошло
двухходовка:  двухходовку
основать:  основанный
устраняться:  устраняться
я:  мной
фига:  фиг
корреляция:  корреляции
прежде:  прежде
глобальный:  глобальный
дойти:  дошла
заочник:  заочников
строчка:  строчки
подынтегральный:  подынтегральная
повторять:  повторяем
невыполнение:  невыполнение
